Year,GeogType,FIPSCode,BoroCode,GeogName,GeoID,Pop1,Male ,Fem,LandAcres
2020,NYC2020,3651000,0,New York City,0,8804190,4184548,4619642,192288.84
2020,Boro2020,005,2,Bronx,2,1472654,689426,783228,26989.99
2020,Boro2020,047,3,Brooklyn,3,2736074,1295763,1440311,44401.01
2020,Boro2020,061,1,Manhattan,1,1694251,794484,899767,14500.01
2020,Boro2020,081,4,Queens,4,2405464,1164469,1240995,69583.41
2020,Boro2020,085,5,Staten Island,5,495747,240406,255341,36814.42
2020,CB2020,005,2,Bronx,20001000001,0,0,0,0
2020,CB2020,005,2,Bronx,20001000002,0,0,0,0
2020,CB2020,005,2,Bronx,20001001000,171,168,3,115.92
2020,CB2020,005,2,Bronx,20001001001,1344,1156,188,128
2020,CB2020,005,2,Bronx,20001001002,367,349,18,3.25
2020,CB2020,005,2,Bronx,20001001003,1890,1887,3,167.28
2020,CB2020,005,2,Bronx,20002000001,0,0,0,0
2020,CB2020,005,2,Bronx,20002001000,310,134,176,4.73
2020,CB2020,005,2,Bronx,20002001001,274,133,141,4.67
2020,CB2020,005,2,Bronx,20002001002,306,138,168,4.64
2020,CB2020,005,2,Bronx,20002001003,276,144,132,4.67
2020,CB2020,005,2,Bronx,20002001004,164,76,88,2.87
2020,CB2020,005,2,Bronx,20002001005,0,0,0,0.41
2020,CB2020,005,2,Bronx,20002002000,195,107,88,4.34
2020,CB2020,005,2,Bronx,20002002001,220,117,103,4.66
2020,CB2020,005,2,Bronx,20002002002,242,104,138,4.6
2020,CB2020,005,2,Bronx,20002002003,221,110,111,4.51
2020,CB2020,005,2,Bronx,20002002004,166,82,84,3.24
2020,CB2020,005,2,Bronx,20002002005,63,34,29,1.63
2020,CB2020,005,2,Bronx,20002002006,784,330,454,6.81
2020,CB2020,005,2,Bronx,20002002007,112,67,45,17.32
2020,CB2020,005,2,Bronx,20002002008,54,21,33,1.2
2020,CB2020,005,2,Bronx,20002003000,156,82,74,7.84
2020,CB2020,005,2,Bronx,20002003001,147,77,70,3.07
2020,CB2020,005,2,Bronx,20002003002,57,23,34,1.62
2020,CB2020,005,2,Bronx,20002003003,34,13,21,1
2020,CB2020,005,2,Bronx,20002003004,45,27,18,1.07
2020,CB2020,005,2,Bronx,20002003005,125,56,69,4.66
2020,CB2020,005,2,Bronx,20002003006,32,27,5,0.94
2020,CB2020,005,2,Bronx,20002003007,108,32,76,1.51
2020,CB2020,005,2,Bronx,20002003008,31,20,11,1.22
2020,CB2020,005,2,Bronx,20002003009,20,3,17,1.11
2020,CB2020,005,2,Bronx,20002003010,62,27,35,1.13
2020,CB2020,005,2,Bronx,20002003011,103,43,60,1.36
2020,CB2020,005,2,Bronx,20002003012,99,54,45,1.29
2020,CB2020,005,2,Bronx,20002003013,16,12,4,0.57
2020,CB2020,005,2,Bronx,20002003014,60,51,9,2.82
2020,CB2020,005,2,Bronx,20002003015,27,14,13,1.03
2020,CB2020,005,2,Bronx,20002003016,3,2,1,0.52
2020,CB2020,005,2,Bronx,20002003017,24,6,18,0.63
2020,CB2020,005,2,Bronx,20002003018,11,4,7,1.99
2020,CB2020,005,2,Bronx,20002003019,23,9,14,0.54
2020,CB2020,005,2,Bronx,20002003020,19,9,10,0.67
2020,CB2020,005,2,Bronx,20002003021,47,18,29,0.84
2020,CB2020,005,2,Bronx,20002003022,43,10,33,0.76
2020,CB2020,005,2,Bronx,20002003023,18,9,9,1.17
2020,CB2020,005,2,Bronx,20002003024,18,11,7,0.68
2020,CB2020,005,2,Bronx,20002003025,34,17,17,1.09
2020,CB2020,005,2,Bronx,20002003026,30,26,4,0.45
2020,CB2020,005,2,Bronx,20004000001,0,0,0,0
2020,CB2020,005,2,Bronx,20004000002,0,0,0,0
2020,CB2020,005,2,Bronx,20004001000,564,258,306,4.99
2020,CB2020,005,2,Bronx,20004001001,279,125,154,4.28
2020,CB2020,005,2,Bronx,20004001002,43,29,14,1.7
2020,CB2020,005,2,Bronx,20004001003,132,77,55,4.2
2020,CB2020,005,2,Bronx,20004001004,29,19,10,0.36
2020,CB2020,005,2,Bronx,20004002000,36,12,24,19.64
2020,CB2020,005,2,Bronx,20004002001,0,0,0,0
2020,CB2020,005,2,Bronx,20004002002,587,273,314,42.19
2020,CB2020,005,2,Bronx,20004002003,251,117,134,5.25
2020,CB2020,005,2,Bronx,20004002004,137,53,84,3.69
2020,CB2020,005,2,Bronx,20004002005,172,86,86,5
2020,CB2020,005,2,Bronx,20004002006,250,146,104,5.47
2020,CB2020,005,2,Bronx,20004003000,457,232,225,17.48
2020,CB2020,005,2,Bronx,20004003001,184,106,78,5.06
2020,CB2020,005,2,Bronx,20004003002,192,86,106,5.07
2020,CB2020,005,2,Bronx,20004003003,169,85,84,3.18
2020,CB2020,005,2,Bronx,20004003004,54,19,35,1.15
2020,CB2020,005,2,Bronx,20004003005,1029,480,549,26.65
2020,CB2020,005,2,Bronx,20004003006,54,37,17,1.31
2020,CB2020,005,2,Bronx,20004003007,169,77,92,1.9
2020,CB2020,005,2,Bronx,20004003008,576,252,324,7.36
2020,CB2020,005,2,Bronx,20004003009,100,39,61,2.23
2020,CB2020,005,2,Bronx,20004003010,111,40,71,1.47
2020,CB2020,005,2,Bronx,20004004000,245,105,140,4.51
2020,CB2020,005,2,Bronx,20004004001,170,73,97,3.62
2020,CB2020,005,2,Bronx,20004004002,108,55,53,2.14
2020,CB2020,005,2,Bronx,20004004003,0,0,0,6.78
2020,CB2020,005,2,Bronx,20004004004,174,88,86,3.29
2020,CB2020,005,2,Bronx,20004004005,0,0,0,0.45
2020,CB2020,005,2,Bronx,20016001000,2455,1010,1445,19.2
2020,CB2020,005,2,Bronx,20016002000,313,152,161,4.64
2020,CB2020,005,2,Bronx,20016002001,329,143,186,4.58
2020,CB2020,005,2,Bronx,20016002002,61,30,31,3.56
2020,CB2020,005,2,Bronx,20016002003,0,0,0,0.74
2020,CB2020,005,2,Bronx,20016002004,276,136,140,3.95
2020,CB2020,005,2,Bronx,20016002005,31,18,13,1.19
2020,CB2020,005,2,Bronx,20016003000,745,273,472,5.68
2020,CB2020,005,2,Bronx,20016004000,0,0,0,10.54
2020,CB2020,005,2,Bronx,20016004001,214,118,96,5.4
2020,CB2020,005,2,Bronx,20016004002,0,0,0,5.29
2020,CB2020,005,2,Bronx,20016004003,0,0,0,10.35
2020,CB2020,005,2,Bronx,20016004004,0,0,0,10.18
2020,CB2020,005,2,Bronx,20016004005,63,37,26,5.83
2020,CB2020,005,2,Bronx,20016004006,303,119,184,5.02
2020,CB2020,005,2,Bronx,20016004007,386,209,177,9.64
2020,CB2020,005,2,Bronx,20016004008,316,144,172,4.7
2020,CB2020,005,2,Bronx,20016004009,139,64,75,4.64
2020,CB2020,005,2,Bronx,20016004010,164,60,104,4.73
2020,CB2020,005,2,Bronx,20019011000,0,0,0,0.26
2020,CB2020,005,2,Bronx,20019011001,0,0,0,0.27
2020,CB2020,005,2,Bronx,20019011002,0,0,0,1.42
2020,CB2020,005,2,Bronx,20019011003,0,0,0,0.74
2020,CB2020,005,2,Bronx,20019011004,0,0,0,1.95
2020,CB2020,005,2,Bronx,20019011005,88,52,36,1.63
2020,CB2020,005,2,Bronx,20019011006,27,14,13,2.64
2020,CB2020,005,2,Bronx,20019011007,26,10,16,1.5
2020,CB2020,005,2,Bronx,20019011008,0,0,0,0.74
2020,CB2020,005,2,Bronx,20019011009,0,0,0,2.19
2020,CB2020,005,2,Bronx,20019011010,506,284,222,4.18
2020,CB2020,005,2,Bronx,20019011011,278,147,131,4.53
2020,CB2020,005,2,Bronx,20019011012,715,331,384,4.66
2020,CB2020,005,2,Bronx,20019011013,0,0,0,4.15
2020,CB2020,005,2,Bronx,20019011014,652,317,335,19.8
2020,CB2020,005,2,Bronx,20019021000,0,0,0,0.59
2020,CB2020,005,2,Bronx,20019021001,0,0,0,0.74
2020,CB2020,005,2,Bronx,20019021002,0,0,0,5.47
2020,CB2020,005,2,Bronx,20019021003,0,0,0,3.17
2020,CB2020,005,2,Bronx,20019021004,0,0,0,1.03
2020,CB2020,005,2,Bronx,20019021005,0,0,0,0.76
2020,CB2020,005,2,Bronx,20019021006,0,0,0,0.91
2020,CB2020,005,2,Bronx,20019021007,0,0,0,0.56
2020,CB2020,005,2,Bronx,20019021008,0,0,0,0.84
2020,CB2020,005,2,Bronx,20019021009,0,0,0,0.96
2020,CB2020,005,2,Bronx,20019021010,0,0,0,2.02
2020,CB2020,005,2,Bronx,20019021011,0,0,0,0.3
2020,CB2020,005,2,Bronx,20019021012,0,0,0,2.25
2020,CB2020,005,2,Bronx,20019021013,2,2,0,3.02
2020,CB2020,005,2,Bronx,20019021014,0,0,0,1.41
2020,CB2020,005,2,Bronx,20019021015,214,152,62,4.27
2020,CB2020,005,2,Bronx,20019021016,0,0,0,3.38
2020,CB2020,005,2,Bronx,20019021017,259,116,143,3.01
2020,CB2020,005,2,Bronx,20019021018,96,52,44,2.17
2020,CB2020,005,2,Bronx,20019021019,269,149,120,4.88
2020,CB2020,005,2,Bronx,20019021020,0,0,0,4.18
2020,CB2020,005,2,Bronx,20019021021,0,0,0,2.66
2020,CB2020,005,2,Bronx,20019021022,56,42,14,2.78
2020,CB2020,005,2,Bronx,20019021023,0,0,0,0.13
2020,CB2020,005,2,Bronx,20019021024,0,0,0,1.74
2020,CB2020,005,2,Bronx,20019021025,0,0,0,0.51
2020,CB2020,005,2,Bronx,20019021026,0,0,0,1.23
2020,CB2020,005,2,Bronx,20019021027,0,0,0,2.95
2020,CB2020,005,2,Bronx,20019021028,0,0,0,1.43
2020,CB2020,005,2,Bronx,20019021029,0,0,0,2.35
2020,CB2020,005,2,Bronx,20019021030,0,0,0,3.4
2020,CB2020,005,2,Bronx,20019021031,0,0,0,1.55
2020,CB2020,005,2,Bronx,20019021032,0,0,0,2.68
2020,CB2020,005,2,Bronx,20019021033,296,149,147,5.76
2020,CB2020,005,2,Bronx,20019021034,0,0,0,5.77
2020,CB2020,005,2,Bronx,20019021035,0,0,0,1.64
2020,CB2020,005,2,Bronx,20019021036,237,99,138,1.66
2020,CB2020,005,2,Bronx,20019021037,38,25,13,3.63
2020,CB2020,005,2,Bronx,20019021038,0,0,0,0.71
2020,CB2020,005,2,Bronx,20019021039,38,26,12,1.76
2020,CB2020,005,2,Bronx,20019021040,0,0,0,5.86
2020,CB2020,005,2,Bronx,20019021041,0,0,0,0.47
2020,CB2020,005,2,Bronx,20019021042,19,12,7,3.68
2020,CB2020,005,2,Bronx,20019021043,30,16,14,5.47
2020,CB2020,005,2,Bronx,20019021044,0,0,0,0.4
2020,CB2020,005,2,Bronx,20019021045,0,0,0,0.56
2020,CB2020,005,2,Bronx,20019021046,0,0,0,2.08
2020,CB2020,005,2,Bronx,20019021047,0,0,0,0.34
2020,CB2020,005,2,Bronx,20019021048,0,0,0,0.15
2020,CB2020,005,2,Bronx,20019021049,0,0,0,2.02
2020,CB2020,005,2,Bronx,20019021050,0,0,0,2.37
2020,CB2020,005,2,Bronx,20019021051,59,27,32,2.46
2020,CB2020,005,2,Bronx,20019031000,0,0,0,2.32
2020,CB2020,005,2,Bronx,20019031001,0,0,0,2.45
2020,CB2020,005,2,Bronx,20019031002,0,0,0,2.88
2020,CB2020,005,2,Bronx,20019031003,0,0,0,2.65
2020,CB2020,005,2,Bronx,20019031004,0,0,0,2.44
2020,CB2020,005,2,Bronx,20019031005,0,0,0,2.67
2020,CB2020,005,2,Bronx,20019031006,0,0,0,2.49
2020,CB2020,005,2,Bronx,20019031007,0,0,0,2.36
2020,CB2020,005,2,Bronx,20019031008,0,0,0,2.36
2020,CB2020,005,2,Bronx,20019031009,0,0,0,2.47
2020,CB2020,005,2,Bronx,20019031010,0,0,0,2.62
2020,CB2020,005,2,Bronx,20019031011,0,0,0,2.5
2020,CB2020,005,2,Bronx,20019031012,0,0,0,2.55
2020,CB2020,005,2,Bronx,20019031013,0,0,0,2.57
2020,CB2020,005,2,Bronx,20019031014,0,0,0,2.56
2020,CB2020,005,2,Bronx,20019031015,0,0,0,2.55
2020,CB2020,005,2,Bronx,20019032000,0,0,0,0.86
2020,CB2020,005,2,Bronx,20019032001,0,0,0,2.56
2020,CB2020,005,2,Bronx,20019032002,0,0,0,2.81
2020,CB2020,005,2,Bronx,20019032003,0,0,0,7
2020,CB2020,005,2,Bronx,20019032004,0,0,0,47.96
2020,CB2020,005,2,Bronx,20019032005,0,0,0,9.85
2020,CB2020,005,2,Bronx,20019032006,0,0,0,4.7
2020,CB2020,005,2,Bronx,20019032007,0,0,0,26.91
2020,CB2020,005,2,Bronx,20019032008,0,0,0,3.77
2020,CB2020,005,2,Bronx,20019032009,0,0,0,12.74
2020,CB2020,005,2,Bronx,20019032010,0,0,0,8.48
2020,CB2020,005,2,Bronx,20019032011,0,0,0,1.49
2020,CB2020,005,2,Bronx,20019032012,2,2,0,15.04
2020,CB2020,005,2,Bronx,20019032013,0,0,0,35.57
2020,CB2020,005,2,Bronx,20019032014,0,0,0,4.39
2020,CB2020,005,2,Bronx,20019040001,0,0,0,0
2020,CB2020,005,2,Bronx,20019040002,0,0,0,0
2020,CB2020,005,2,Bronx,20019040003,0,0,0,0
2020,CB2020,005,2,Bronx,20019041000,0,0,0,2.99
2020,CB2020,005,2,Bronx,20019042000,0,0,0,17.29
2020,CB2020,005,2,Bronx,20020011000,373,158,215,6.48
2020,CB2020,005,2,Bronx,20020011001,0,0,0,3.25
2020,CB2020,005,2,Bronx,20020011002,1949,852,1097,16
2020,CB2020,005,2,Bronx,20020011003,0,0,0,3.42
2020,CB2020,005,2,Bronx,20020012000,1961,764,1197,15.43
2020,CB2020,005,2,Bronx,20020013000,724,296,428,4.71
2020,CB2020,005,2,Bronx,20020021000,117,58,59,2.41
2020,CB2020,005,2,Bronx,20020021001,422,191,231,4.49
2020,CB2020,005,2,Bronx,20020021002,442,180,262,4.65
2020,CB2020,005,2,Bronx,20020021003,416,223,193,4.85
2020,CB2020,005,2,Bronx,20020021004,68,38,30,2.36
2020,CB2020,005,2,Bronx,20020022000,355,197,158,4.63
2020,CB2020,005,2,Bronx,20020022001,224,79,145,4.66
2020,CB2020,005,2,Bronx,20020022002,337,112,225,4.66
2020,CB2020,005,2,Bronx,20020022003,1095,489,606,4.83
2020,CB2020,005,2,Bronx,20020023000,336,132,204,3.3
2020,CB2020,005,2,Bronx,20020023001,403,194,209,4.88
2020,CB2020,005,2,Bronx,20020023002,369,199,170,4.91
2020,CB2020,005,2,Bronx,20023001000,1284,586,698,6.24
2020,CB2020,005,2,Bronx,20023001001,1406,559,847,5.5
2020,CB2020,005,2,Bronx,20023001002,0,0,0,1.09
2020,CB2020,005,2,Bronx,20023002000,452,201,251,4.82
2020,CB2020,005,2,Bronx,20023003000,1600,684,916,8.21
2020,CB2020,005,2,Bronx,20024000001,0,0,0,0
2020,CB2020,005,2,Bronx,20024001000,0,0,0,0.27
2020,CB2020,005,2,Bronx,20024001001,0,0,0,0.2
2020,CB2020,005,2,Bronx,20024001002,0,0,0,0.27
2020,CB2020,005,2,Bronx,20024001003,0,0,0,0.3
2020,CB2020,005,2,Bronx,20024001004,0,0,0,0.34
2020,CB2020,005,2,Bronx,20024001005,0,0,0,8.45
2020,CB2020,005,2,Bronx,20024001006,0,0,0,0.31
2020,CB2020,005,2,Bronx,20024001007,6,3,3,158.19
2020,CB2020,005,2,Bronx,20024001008,0,0,0,0.87
2020,CB2020,005,2,Bronx,20024001009,0,0,0,1.67
2020,CB2020,005,2,Bronx,20025001000,883,482,401,3.67
2020,CB2020,005,2,Bronx,20025001001,188,89,99,1.69
2020,CB2020,005,2,Bronx,20025002000,1462,612,850,6.54
2020,CB2020,005,2,Bronx,20025003000,1064,549,515,5.78
2020,CB2020,005,2,Bronx,20025004000,964,460,504,5.37
2020,CB2020,005,2,Bronx,20025005000,356,174,182,1.54
2020,CB2020,005,2,Bronx,20025005001,124,61,63,1.54
2020,CB2020,005,2,Bronx,20025005002,401,200,201,5.37
2020,CB2020,005,2,Bronx,20027011000,42,19,23,2.37
2020,CB2020,005,2,Bronx,20027011001,1006,428,578,6.1
2020,CB2020,005,2,Bronx,20027011002,133,70,63,1
2020,CB2020,005,2,Bronx,20027012000,736,395,341,6.24
2020,CB2020,005,2,Bronx,20027012001,1163,485,678,4.46
2020,CB2020,005,2,Bronx,20027021000,0,0,0,4.56
2020,CB2020,005,2,Bronx,20027021001,1011,470,541,3.26
2020,CB2020,005,2,Bronx,20027021002,442,198,244,3.2
2020,CB2020,005,2,Bronx,20027021003,0,0,0,2.29
2020,CB2020,005,2,Bronx,20027022000,0,0,0,1.27
2020,CB2020,005,2,Bronx,20027022001,405,163,242,3.46
2020,CB2020,005,2,Bronx,20027022002,558,271,287,3.61
2020,CB2020,005,2,Bronx,20027023000,872,386,486,5.41
2020,CB2020,005,2,Bronx,20027023001,817,374,443,6.01
2020,CB2020,005,2,Bronx,20027024000,890,359,531,5.35
2020,CB2020,005,2,Bronx,20028001000,0,0,0,1.4
2020,CB2020,005,2,Bronx,20028001001,0,0,0,1.06
2020,CB2020,005,2,Bronx,20028001002,0,0,0,1.98
2020,CB2020,005,2,Bronx,20028001003,129,72,57,14.96
2020,CB2020,005,2,Bronx,20028001004,15,3,12,4.12
2020,CB2020,005,2,Bronx,20028001005,398,187,211,3.95
2020,CB2020,005,2,Bronx,20028001006,0,0,0,1.44
2020,CB2020,005,2,Bronx,20028001007,0,0,0,1.36
2020,CB2020,005,2,Bronx,20028001008,0,0,0,1.64
2020,CB2020,005,2,Bronx,20028001009,0,0,0,0.42
2020,CB2020,005,2,Bronx,20028001010,0,0,0,0.55
2020,CB2020,005,2,Bronx,20028001011,0,0,0,0.58
2020,CB2020,005,2,Bronx,20028001012,31,17,14,15.05
2020,CB2020,005,2,Bronx,20028001013,0,0,0,3.98
2020,CB2020,005,2,Bronx,20028001014,0,0,0,4.27
2020,CB2020,005,2,Bronx,20028001015,400,156,244,3.98
2020,CB2020,005,2,Bronx,20028001016,460,203,257,3.99
2020,CB2020,005,2,Bronx,20028001017,0,0,0,0
2020,CB2020,005,2,Bronx,20028002000,1894,789,1105,18.87
2020,CB2020,005,2,Bronx,20028003000,1124,504,620,9.49
2020,CB2020,005,2,Bronx,20028004000,1402,572,830,9.36
2020,CB2020,005,2,Bronx,20031001000,798,357,441,2.61
2020,CB2020,005,2,Bronx,20031001001,1070,466,604,3.34
2020,CB2020,005,2,Bronx,20031001002,0,0,0,1.54
2020,CB2020,005,2,Bronx,20031001003,553,263,290,4.47
2020,CB2020,005,2,Bronx,20031001004,417,169,248,2.48
2020,CB2020,005,2,Bronx,20031001005,53,18,35,4.42
2020,CB2020,005,2,Bronx,20031001006,73,56,17,2.58
2020,CB2020,005,2,Bronx,20031001007,0,0,0,1.82
2020,CB2020,005,2,Bronx,20031001008,0,0,0,9.11
2020,CB2020,005,2,Bronx,20031001009,0,0,0,5.87
2020,CB2020,005,2,Bronx,20033001000,59,35,24,2.5
2020,CB2020,005,2,Bronx,20033001001,0,0,0,2.28
2020,CB2020,005,2,Bronx,20033001002,132,66,66,1.92
2020,CB2020,005,2,Bronx,20033001003,140,62,78,1.82
2020,CB2020,005,2,Bronx,20033001004,300,128,172,2.51
2020,CB2020,005,2,Bronx,20033001005,209,115,94,2.53
2020,CB2020,005,2,Bronx,20033001006,0,0,0,5.78
2020,CB2020,005,2,Bronx,20033002000,272,140,132,4.33
2020,CB2020,005,2,Bronx,20033002001,1053,456,597,4.26
2020,CB2020,005,2,Bronx,20033003000,151,68,83,1.73
2020,CB2020,005,2,Bronx,20033003001,651,314,337,3.84
2020,CB2020,005,2,Bronx,20033003002,313,123,190,1.99
2020,CB2020,005,2,Bronx,20033003003,409,171,238,2.15
2020,CB2020,005,2,Bronx,20035001000,0,0,0,2.94
2020,CB2020,005,2,Bronx,20035001001,504,238,266,2.86
2020,CB2020,005,2,Bronx,20035001002,21,10,11,2.86
2020,CB2020,005,2,Bronx,20035001003,147,58,89,1.99
2020,CB2020,005,2,Bronx,20035001004,39,18,21,1.99
2020,CB2020,005,2,Bronx,20035001005,62,34,28,2.12
2020,CB2020,005,2,Bronx,20035001006,0,0,0,2.12
2020,CB2020,005,2,Bronx,20035001007,0,0,0,1.96
2020,CB2020,005,2,Bronx,20035001008,138,69,69,1.95
2020,CB2020,005,2,Bronx,20035002000,1502,626,876,4.36
2020,CB2020,005,2,Bronx,20035003000,417,209,208,3.31
2020,CB2020,005,2,Bronx,20035003001,505,265,240,3.31
2020,CB2020,005,2,Bronx,20035003002,391,201,190,3.32
2020,CB2020,005,2,Bronx,20037001000,340,163,177,41.01
2020,CB2020,005,2,Bronx,20038001000,498,225,273,4.8
2020,CB2020,005,2,Bronx,20038001001,569,257,312,4.68
2020,CB2020,005,2,Bronx,20038001002,616,280,336,4.15
2020,CB2020,005,2,Bronx,20038001003,0,0,0,1.42
2020,CB2020,005,2,Bronx,20038001004,0,0,0,0.62
2020,CB2020,005,2,Bronx,20039001000,581,301,280,6.95
2020,CB2020,005,2,Bronx,20039001001,672,328,344,3.6
2020,CB2020,005,2,Bronx,20039002000,580,241,339,8.52
2020,CB2020,005,2,Bronx,20039002001,1035,575,460,4.6
2020,CB2020,005,2,Bronx,20039003000,304,161,143,2.21
2020,CB2020,005,2,Bronx,20039003001,133,55,78,3
2020,CB2020,005,2,Bronx,20039003002,556,290,266,3.84
2020,CB2020,005,2,Bronx,20039004000,1034,500,534,6.6
2020,CB2020,005,2,Bronx,20039005000,512,264,248,6.73
2020,CB2020,005,2,Bronx,20039005001,938,447,491,7.39
2020,CB2020,005,2,Bronx,20040011000,394,200,194,5.49
2020,CB2020,005,2,Bronx,20040011001,88,34,54,5.22
2020,CB2020,005,2,Bronx,20040011002,222,102,120,4.97
2020,CB2020,005,2,Bronx,20040011003,506,198,308,4.69
2020,CB2020,005,2,Bronx,20040011004,295,187,108,5.48
2020,CB2020,005,2,Bronx,20040011005,234,137,97,4.58
2020,CB2020,005,2,Bronx,20041001000,798,357,441,3.37
2020,CB2020,005,2,Bronx,20041001001,505,239,266,3.8
2020,CB2020,005,2,Bronx,20041001002,375,172,203,4.57
2020,CB2020,005,2,Bronx,20041002000,549,281,268,6.18
2020,CB2020,005,2,Bronx,20041002001,825,365,460,6.19
2020,CB2020,005,2,Bronx,20041002002,346,191,155,6.98
2020,CB2020,005,2,Bronx,20041003000,1,0,1,0.65
2020,CB2020,005,2,Bronx,20041003001,122,64,58,1.4
2020,CB2020,005,2,Bronx,20041004000,671,279,392,4.23
2020,CB2020,005,2,Bronx,20041004001,1954,832,1122,8.29
2020,CB2020,005,2,Bronx,20042001000,725,324,401,6.45
2020,CB2020,005,2,Bronx,20042001001,0,0,0,0.63
2020,CB2020,005,2,Bronx,20042001002,28,11,17,4.5
2020,CB2020,005,2,Bronx,20042002000,2272,921,1351,17.77
2020,CB2020,005,2,Bronx,20042002001,0,0,0,0.52
2020,CB2020,005,2,Bronx,20042003000,0,0,0,1.64
2020,CB2020,005,2,Bronx,20042003001,0,0,0,1.92
2020,CB2020,005,2,Bronx,20042003002,0,0,0,0.56
2020,CB2020,005,2,Bronx,20042003003,0,0,0,0.68
2020,CB2020,005,2,Bronx,20042003004,0,0,0,1.22
2020,CB2020,005,2,Bronx,20042003005,0,0,0,1.92
2020,CB2020,005,2,Bronx,20042003006,0,0,0,2.3
2020,CB2020,005,2,Bronx,20042003007,0,0,0,1.82
2020,CB2020,005,2,Bronx,20042003008,1237,583,654,6.61
2020,CB2020,005,2,Bronx,20042003009,277,128,149,3.59
2020,CB2020,005,2,Bronx,20042003010,0,0,0,0.6
2020,CB2020,005,2,Bronx,20042004000,746,310,436,4.82
2020,CB2020,005,2,Bronx,20042004001,0,0,0,5
2020,CB2020,005,2,Bronx,20042005000,0,0,0,2.96
2020,CB2020,005,2,Bronx,20042005001,514,214,300,3.2
2020,CB2020,005,2,Bronx,20042005002,0,0,0,4.84
2020,CB2020,005,2,Bronx,20042005003,0,0,0,5.22
2020,CB2020,005,2,Bronx,20042005004,426,191,235,4.83
2020,CB2020,005,2,Bronx,20042006000,0,0,0,2.22
2020,CB2020,005,2,Bronx,20042006001,0,0,0,0.89
2020,CB2020,005,2,Bronx,20042006002,0,0,0,2.36
2020,CB2020,005,2,Bronx,20042006003,0,0,0,11.33
2020,CB2020,005,2,Bronx,20042006004,0,0,0,10.76
2020,CB2020,005,2,Bronx,20042007000,976,403,573,8.26
2020,CB2020,005,2,Bronx,20043001000,507,256,251,3.66
2020,CB2020,005,2,Bronx,20043001001,335,246,89,4.24
2020,CB2020,005,2,Bronx,20043001002,313,140,173,3.62
2020,CB2020,005,2,Bronx,20043002000,0,0,0,1.61
2020,CB2020,005,2,Bronx,20043002001,0,0,0,0.28
2020,CB2020,005,2,Bronx,20043002002,179,107,72,1.01
2020,CB2020,005,2,Bronx,20043002003,22,10,12,0.64
2020,CB2020,005,2,Bronx,20043002004,660,313,347,5.05
2020,CB2020,005,2,Bronx,20043002005,724,310,414,5.35
2020,CB2020,005,2,Bronx,20043002006,92,44,48,1.77
2020,CB2020,005,2,Bronx,20043002007,95,39,56,1.8
2020,CB2020,005,2,Bronx,20043002008,65,14,51,0.76
2020,CB2020,005,2,Bronx,20043002009,24,8,16,3.33
2020,CB2020,005,2,Bronx,20043002010,550,263,287,3.59
2020,CB2020,005,2,Bronx,20043003000,746,329,417,3.59
2020,CB2020,005,2,Bronx,20043003001,427,187,240,5.97
2020,CB2020,005,2,Bronx,20043004000,481,205,276,2.39
2020,CB2020,005,2,Bronx,20043004001,345,149,196,3.63
2020,CB2020,005,2,Bronx,20043004002,119,56,63,2.19
2020,CB2020,005,2,Bronx,20043004003,199,88,111,1.21
2020,CB2020,005,2,Bronx,20044001000,1286,515,771,14.4
2020,CB2020,005,2,Bronx,20044001001,0,0,0,1.26
2020,CB2020,005,2,Bronx,20044002000,643,253,390,5.49
2020,CB2020,005,2,Bronx,20044003000,313,157,156,6.68
2020,CB2020,005,2,Bronx,20044003001,414,170,244,4.95
2020,CB2020,005,2,Bronx,20044003002,1004,428,576,14.52
2020,CB2020,005,2,Bronx,20044004000,908,347,561,9.26
2020,CB2020,005,2,Bronx,20044004001,74,39,35,8.38
2020,CB2020,005,2,Bronx,20044004002,0,0,0,0.68
2020,CB2020,005,2,Bronx,20046001000,24,8,16,0.41
2020,CB2020,005,2,Bronx,20046001001,0,0,0,0.61
2020,CB2020,005,2,Bronx,20046001002,0,0,0,0.67
2020,CB2020,005,2,Bronx,20046001003,162,81,81,0.97
2020,CB2020,005,2,Bronx,20046001004,0,0,0,2.58
2020,CB2020,005,2,Bronx,20046001005,319,186,133,2.99
2020,CB2020,005,2,Bronx,20046001006,586,275,311,4.17
2020,CB2020,005,2,Bronx,20046001007,302,113,189,5.89
2020,CB2020,005,2,Bronx,20046001008,194,67,127,4.04
2020,CB2020,005,2,Bronx,20046001009,95,52,43,4.58
2020,CB2020,005,2,Bronx,20046001010,0,0,0,1.61
2020,CB2020,005,2,Bronx,20046001011,294,131,163,4.92
2020,CB2020,005,2,Bronx,20048001000,0,0,0,0.97
2020,CB2020,005,2,Bronx,20048001001,0,0,0,7.69
2020,CB2020,005,2,Bronx,20048001002,0,0,0,0.95
2020,CB2020,005,2,Bronx,20048001003,1727,860,867,5.87
2020,CB2020,005,2,Bronx,20048001004,222,113,109,0.64
2020,CB2020,005,2,Bronx,20048002000,1129,580,549,5.21
2020,CB2020,005,2,Bronx,20048002001,309,131,178,0.64
2020,CB2020,005,2,Bronx,20048002002,715,355,360,4.83
2020,CB2020,005,2,Bronx,20048002003,82,42,40,5.08
2020,CB2020,005,2,Bronx,20048002004,0,0,0,4.83
2020,CB2020,005,2,Bronx,20048002005,0,0,0,0.58
2020,CB2020,005,2,Bronx,20050011000,839,419,420,4.84
2020,CB2020,005,2,Bronx,20050011001,387,179,208,4.8
2020,CB2020,005,2,Bronx,20050012000,1498,710,788,4.85
2020,CB2020,005,2,Bronx,20050013000,1168,504,664,4.86
2020,CB2020,005,2,Bronx,20050014000,1068,533,535,4.85
2020,CB2020,005,2,Bronx,20050021000,1271,645,626,5.58
2020,CB2020,005,2,Bronx,20050021001,1335,701,634,5.7
2020,CB2020,005,2,Bronx,20050022000,1266,586,680,5.8
2020,CB2020,005,2,Bronx,20050023000,1249,651,598,5.51
2020,CB2020,005,2,Bronx,20050024000,1397,610,787,5.55
2020,CB2020,005,2,Bronx,20051001000,0,0,0,4.51
2020,CB2020,005,2,Bronx,20051001001,158,87,71,5.08
2020,CB2020,005,2,Bronx,20051001002,77,44,33,7.8
2020,CB2020,005,2,Bronx,20051001003,0,0,0,3.11
2020,CB2020,005,2,Bronx,20051001004,0,0,0,3.5
2020,CB2020,005,2,Bronx,20051001005,0,0,0,6.3
2020,CB2020,005,2,Bronx,20051001006,0,0,0,1.1
2020,CB2020,005,2,Bronx,20051001007,0,0,0,2.75
2020,CB2020,005,2,Bronx,20051001008,0,0,0,2.77
2020,CB2020,005,2,Bronx,20051001009,0,0,0,0.3
2020,CB2020,005,2,Bronx,20051001010,0,0,0,1.82
2020,CB2020,005,2,Bronx,20051001011,4,1,3,2.92
2020,CB2020,005,2,Bronx,20051001012,0,0,0,0.3
2020,CB2020,005,2,Bronx,20051001013,0,0,0,3.79
2020,CB2020,005,2,Bronx,20051001014,108,57,51,14.48
2020,CB2020,005,2,Bronx,20051001015,0,0,0,1.21
2020,CB2020,005,2,Bronx,20051001016,27,16,11,2.49
2020,CB2020,005,2,Bronx,20051001017,0,0,0,2.3
2020,CB2020,005,2,Bronx,20051001018,0,0,0,1.12
2020,CB2020,005,2,Bronx,20051001019,0,0,0,0.63
2020,CB2020,005,2,Bronx,20051002000,0,0,0,0.47
2020,CB2020,005,2,Bronx,20051002001,494,237,257,1.92
2020,CB2020,005,2,Bronx,20051002002,42,19,23,2.12
2020,CB2020,005,2,Bronx,20051002003,0,0,0,3.01
2020,CB2020,005,2,Bronx,20051002004,6,5,1,2.9
2020,CB2020,005,2,Bronx,20051002005,0,0,0,1.88
2020,CB2020,005,2,Bronx,20051002006,35,16,19,4.55
2020,CB2020,005,2,Bronx,20051002007,2581,1066,1515,11.75
2020,CB2020,005,2,Bronx,20051002008,106,54,52,2.79
2020,CB2020,005,2,Bronx,20051002009,34,13,21,4.04
2020,CB2020,005,2,Bronx,20051002010,198,79,119,1.97
2020,CB2020,005,2,Bronx,20051002011,0,0,0,3.14
2020,CB2020,005,2,Bronx,20051002012,168,74,94,0.54
2020,CB2020,005,2,Bronx,20051003000,2234,893,1341,14.21
2020,CB2020,005,2,Bronx,20051003001,187,98,89,2.59
2020,CB2020,005,2,Bronx,20052001000,292,140,152,6.13
2020,CB2020,005,2,Bronx,20052001001,26,14,12,4.71
2020,CB2020,005,2,Bronx,20052001002,0,0,0,13.91
2020,CB2020,005,2,Bronx,20052001003,0,0,0,5.07
2020,CB2020,005,2,Bronx,20052001004,507,224,283,9.43
2020,CB2020,005,2,Bronx,20052002000,1305,551,754,5.91
2020,CB2020,005,2,Bronx,20053001000,2162,949,1213,4.62
2020,CB2020,005,2,Bronx,20053001001,0,0,0,2.56
2020,CB2020,005,2,Bronx,20053001002,0,0,0,0.88
2020,CB2020,005,2,Bronx,20053001003,0,0,0,1.07
2020,CB2020,005,2,Bronx,20053002000,2209,990,1219,7.63
2020,CB2020,005,2,Bronx,20053002001,0,0,0,0.52
2020,CB2020,005,2,Bronx,20053002002,0,0,0,0.52
2020,CB2020,005,2,Bronx,20054001000,356,177,179,5.73
2020,CB2020,005,2,Bronx,20054001001,1055,508,547,5.8
2020,CB2020,005,2,Bronx,20054002000,899,500,399,5.7
2020,CB2020,005,2,Bronx,20054002001,1016,507,509,5.63
2020,CB2020,005,2,Bronx,20054002002,945,462,483,5.99
2020,CB2020,005,2,Bronx,20054003000,538,263,275,7.25
2020,CB2020,005,2,Bronx,20054003001,103,56,47,1.85
2020,CB2020,005,2,Bronx,20054003002,423,214,209,5.16
2020,CB2020,005,2,Bronx,20054004000,1469,728,741,5.46
2020,CB2020,005,2,Bronx,20056001000,924,410,514,4.72
2020,CB2020,005,2,Bronx,20056001001,22,10,12,10.06
2020,CB2020,005,2,Bronx,20056002000,823,402,421,5.08
2020,CB2020,005,2,Bronx,20056003000,0,0,0,0.69
2020,CB2020,005,2,Bronx,20056003001,157,57,100,1.97
2020,CB2020,005,2,Bronx,20056003002,417,232,185,6.21
2020,CB2020,005,2,Bronx,20056003003,408,192,216,3.6
2020,CB2020,005,2,Bronx,20056003004,112,55,57,1.33
2020,CB2020,005,2,Bronx,20059021000,360,180,180,2.51
2020,CB2020,005,2,Bronx,20059021001,0,0,0,0.5
2020,CB2020,005,2,Bronx,20059021002,537,250,287,2.46
2020,CB2020,005,2,Bronx,20059022000,1092,504,588,6.21
2020,CB2020,005,2,Bronx,20059022001,588,286,302,5.7
2020,CB2020,005,2,Bronx,20060001000,0,0,0,2.26
2020,CB2020,005,2,Bronx,20060001001,216,92,124,2.7
2020,CB2020,005,2,Bronx,20060001002,336,159,177,3.2
2020,CB2020,005,2,Bronx,20060001003,0,0,0,0.61
2020,CB2020,005,2,Bronx,20060001004,574,276,298,2.76
2020,CB2020,005,2,Bronx,20060001005,0,0,0,1.92
2020,CB2020,005,2,Bronx,20060001006,133,72,61,2.39
2020,CB2020,005,2,Bronx,20060001007,0,0,0,1.87
2020,CB2020,005,2,Bronx,20060001008,0,0,0,5.27
2020,CB2020,005,2,Bronx,20060001009,0,0,0,0.9
2020,CB2020,005,2,Bronx,20060002000,0,0,0,10.06
2020,CB2020,005,2,Bronx,20060002001,0,0,0,0.52
2020,CB2020,005,2,Bronx,20060002002,0,0,0,0.23
2020,CB2020,005,2,Bronx,20060002003,0,0,0,0.77
2020,CB2020,005,2,Bronx,20060002004,3,2,1,15.88
2020,CB2020,005,2,Bronx,20060002005,0,0,0,4.13
2020,CB2020,005,2,Bronx,20060002006,0,0,0,13.86
2020,CB2020,005,2,Bronx,20060002007,0,0,0,0.76
2020,CB2020,005,2,Bronx,20060002008,0,0,0,3.96
2020,CB2020,005,2,Bronx,20060002009,0,0,0,5.06
2020,CB2020,005,2,Bronx,20060002010,0,0,0,0.32
2020,CB2020,005,2,Bronx,20060002011,0,0,0,0.52
2020,CB2020,005,2,Bronx,20060002012,0,0,0,1.4
2020,CB2020,005,2,Bronx,20060002013,0,0,0,1.8
2020,CB2020,005,2,Bronx,20061001000,31,16,15,12.06
2020,CB2020,005,2,Bronx,20061002000,1106,437,669,1.48
2020,CB2020,005,2,Bronx,20061002001,1082,453,629,4.58
2020,CB2020,005,2,Bronx,20061003000,1158,473,685,4.78
2020,CB2020,005,2,Bronx,20061004000,4,3,1,18.07
2020,CB2020,005,2,Bronx,20061004001,0,0,0,7.33
2020,CB2020,005,2,Bronx,20061004002,0,0,0,6.37
2020,CB2020,005,2,Bronx,20061004003,37,16,21,3.13
2020,CB2020,005,2,Bronx,20061004004,26,14,12,2.19
2020,CB2020,005,2,Bronx,20062001000,0,0,0,0.56
2020,CB2020,005,2,Bronx,20062001001,148,79,69,4.05
2020,CB2020,005,2,Bronx,20062001002,0,0,0,2.55
2020,CB2020,005,2,Bronx,20062001003,0,0,0,0.7
2020,CB2020,005,2,Bronx,20062001004,605,276,329,4.96
2020,CB2020,005,2,Bronx,20062001005,622,291,331,4.95
2020,CB2020,005,2,Bronx,20062002000,1528,646,882,8.56
2020,CB2020,005,2,Bronx,20062003000,1898,788,1110,8.93
2020,CB2020,005,2,Bronx,20062004000,1296,647,649,5.34
2020,CB2020,005,2,Bronx,20062005000,0,0,0,0.68
2020,CB2020,005,2,Bronx,20062005001,0,0,0,2
2020,CB2020,005,2,Bronx,20062005002,672,339,333,4.67
2020,CB2020,005,2,Bronx,20063011000,0,0,0,0.52
2020,CB2020,005,2,Bronx,20063011001,0,0,0,0.35
2020,CB2020,005,2,Bronx,20063011002,0,0,0,0.42
2020,CB2020,005,2,Bronx,20063011003,452,245,207,2.85
2020,CB2020,005,2,Bronx,20063011004,453,216,237,2.6
2020,CB2020,005,2,Bronx,20063011005,0,0,0,4.82
2020,CB2020,005,2,Bronx,20063012000,371,172,199,2.01
2020,CB2020,005,2,Bronx,20063012001,795,376,419,2.41
2020,CB2020,005,2,Bronx,20063013000,1114,539,575,5.27
2020,CB2020,005,2,Bronx,20063013001,0,0,0,1.7
2020,CB2020,005,2,Bronx,20063013002,0,0,0,1.42
2020,CB2020,005,2,Bronx,20063014000,22,12,10,19.81
2020,CB2020,005,2,Bronx,20063014001,1638,730,908,5.43
2020,CB2020,005,2,Bronx,20063014002,0,0,0,1.54
2020,CB2020,005,2,Bronx,20063014003,21,4,17,1.33
2020,CB2020,005,2,Bronx,20063014004,295,160,135,1.83
2020,CB2020,005,2,Bronx,20063015000,18,8,10,4.5
2020,CB2020,005,2,Bronx,20063015001,0,0,0,3.44
2020,CB2020,005,2,Bronx,20063015002,316,148,168,2.81
2020,CB2020,005,2,Bronx,20063015003,310,124,186,0.9
2020,CB2020,005,2,Bronx,20063015004,0,0,0,0.37
2020,CB2020,005,2,Bronx,20063015005,0,0,0,0.97
2020,CB2020,005,2,Bronx,20063015006,0,0,0,16.84
2020,CB2020,005,2,Bronx,20063015007,0,0,0,0.89
2020,CB2020,005,2,Bronx,20063015008,0,0,0,1.07
2020,CB2020,005,2,Bronx,20063015009,0,0,0,3.45
2020,CB2020,005,2,Bronx,20063015010,0,0,0,1.73
2020,CB2020,005,2,Bronx,20063015011,0,0,0,3.97
2020,CB2020,005,2,Bronx,20063015012,0,0,0,3.64
2020,CB2020,005,2,Bronx,20063015013,28,10,18,2.81
2020,CB2020,005,2,Bronx,20063015014,29,12,17,2.59
2020,CB2020,005,2,Bronx,20063016000,0,0,0,1.03
2020,CB2020,005,2,Bronx,20063016001,0,0,0,2.78
2020,CB2020,005,2,Bronx,20063016002,0,0,0,1.84
2020,CB2020,005,2,Bronx,20063016003,0,0,0,11.45
2020,CB2020,005,2,Bronx,20063016004,0,0,0,17.47
2020,CB2020,005,2,Bronx,20063016005,0,0,0,0.24
2020,CB2020,005,2,Bronx,20063016006,0,0,0,1.74
2020,CB2020,005,2,Bronx,20063016007,0,0,0,20.74
2020,CB2020,005,2,Bronx,20063016008,0,0,0,7.16
2020,CB2020,005,2,Bronx,20063016009,0,0,0,6.05
2020,CB2020,005,2,Bronx,20063016010,127,108,19,5.26
2020,CB2020,005,2,Bronx,20063016011,278,95,183,3.48
2020,CB2020,005,2,Bronx,20063016012,61,26,35,2.01
2020,CB2020,005,2,Bronx,20063016013,0,0,0,0.72
2020,CB2020,005,2,Bronx,20063016014,153,80,73,2.54
2020,CB2020,005,2,Bronx,20063016015,86,55,31,2.14
2020,CB2020,005,2,Bronx,20063016016,0,0,0,2.32
2020,CB2020,005,2,Bronx,20063021000,0,0,0,14.1
2020,CB2020,005,2,Bronx,20063021001,0,0,0,7.32
2020,CB2020,005,2,Bronx,20063021002,0,0,0,2.55
2020,CB2020,005,2,Bronx,20063021003,19,14,5,16.41
2020,CB2020,005,2,Bronx,20063021004,0,0,0,1.02
2020,CB2020,005,2,Bronx,20063021005,0,0,0,0.54
2020,CB2020,005,2,Bronx,20063021006,0,0,0,9.02
2020,CB2020,005,2,Bronx,20063021007,0,0,0,1.19
2020,CB2020,005,2,Bronx,20063021008,0,0,0,12.24
2020,CB2020,005,2,Bronx,20063021009,0,0,0,0.57
2020,CB2020,005,2,Bronx,20064001000,536,241,295,4.97
2020,CB2020,005,2,Bronx,20064001001,500,246,254,3.66
2020,CB2020,005,2,Bronx,20064001002,512,244,268,3.93
2020,CB2020,005,2,Bronx,20064001003,292,152,140,4.57
2020,CB2020,005,2,Bronx,20064001004,0,0,0,2.24
2020,CB2020,005,2,Bronx,20064002000,746,352,394,4.93
2020,CB2020,005,2,Bronx,20064003000,591,281,310,5.02
2020,CB2020,005,2,Bronx,20064003001,0,0,0,2.39
2020,CB2020,005,2,Bronx,20064004000,379,154,225,2.76
2020,CB2020,005,2,Bronx,20064004001,483,245,238,3.07
2020,CB2020,005,2,Bronx,20064004002,147,82,65,3.78
2020,CB2020,005,2,Bronx,20065001000,35,25,10,2.93
2020,CB2020,005,2,Bronx,20065001001,422,263,159,5.78
2020,CB2020,005,2,Bronx,20065001002,49,29,20,11.87
2020,CB2020,005,2,Bronx,20065001003,0,0,0,1.81
2020,CB2020,005,2,Bronx,20065001004,80,44,36,1.99
2020,CB2020,005,2,Bronx,20065001005,651,340,311,3.53
2020,CB2020,005,2,Bronx,20065002000,568,254,314,2.58
2020,CB2020,005,2,Bronx,20065002001,1335,584,751,5.57
2020,CB2020,005,2,Bronx,20065002002,1532,625,907,7.89
2020,CB2020,005,2,Bronx,20065003000,853,479,374,6.23
2020,CB2020,005,2,Bronx,20065004000,0,0,0,1.81
2020,CB2020,005,2,Bronx,20065004001,152,69,83,2.81
2020,CB2020,005,2,Bronx,20065004002,151,76,75,0.63
2020,CB2020,005,2,Bronx,20065004003,0,0,0,0.72
2020,CB2020,005,2,Bronx,20065004004,23,11,12,3.04
2020,CB2020,005,2,Bronx,20065004005,400,213,187,5.5
2020,CB2020,005,2,Bronx,20067001000,116,60,56,1.07
2020,CB2020,005,2,Bronx,20067001001,370,173,197,2.76
2020,CB2020,005,2,Bronx,20067001002,328,159,169,2.72
2020,CB2020,005,2,Bronx,20067001003,0,0,0,0.81
2020,CB2020,005,2,Bronx,20067001004,234,123,111,2.78
2020,CB2020,005,2,Bronx,20067001005,132,82,50,2.49
2020,CB2020,005,2,Bronx,20067002000,687,360,327,3.08
2020,CB2020,005,2,Bronx,20067002001,208,103,105,5.62
2020,CB2020,005,2,Bronx,20067002002,151,57,94,6.06
2020,CB2020,005,2,Bronx,20067003000,706,268,438,4.88
2020,CB2020,005,2,Bronx,20067003001,318,149,169,1.23
2020,CB2020,005,2,Bronx,20067004000,720,343,377,5.77
2020,CB2020,005,2,Bronx,20067004001,324,109,215,1.32
2020,CB2020,005,2,Bronx,20067004002,718,311,407,2.59
2020,CB2020,005,2,Bronx,20067005000,783,381,402,3.32
2020,CB2020,005,2,Bronx,20067006000,393,203,190,2.46
2020,CB2020,005,2,Bronx,20067006001,115,54,61,0.59
2020,CB2020,005,2,Bronx,20067006002,590,312,278,2.94
2020,CB2020,005,2,Bronx,20068001000,452,246,206,3.67
2020,CB2020,005,2,Bronx,20068001001,408,189,219,3.35
2020,CB2020,005,2,Bronx,20068001002,471,201,270,2.92
2020,CB2020,005,2,Bronx,20068002000,0,0,0,2.63
2020,CB2020,005,2,Bronx,20068002001,0,0,0,2.5
2020,CB2020,005,2,Bronx,20068002002,34,23,11,3.82
2020,CB2020,005,2,Bronx,20068002003,684,316,368,4.94
2020,CB2020,005,2,Bronx,20068003000,0,0,0,4.89
2020,CB2020,005,2,Bronx,20068003001,636,303,333,4.72
2020,CB2020,005,2,Bronx,20068003002,734,371,363,4.7
2020,CB2020,005,2,Bronx,20069001000,336,132,204,1.87
2020,CB2020,005,2,Bronx,20069001001,275,125,150,2.79
2020,CB2020,005,2,Bronx,20069001002,688,337,351,2.79
2020,CB2020,005,2,Bronx,20069001003,476,255,221,2.9
2020,CB2020,005,2,Bronx,20069001004,194,90,104,0.63
2020,CB2020,005,2,Bronx,20069001005,253,101,152,1.94
2020,CB2020,005,2,Bronx,20069001006,148,61,87,1.75
2020,CB2020,005,2,Bronx,20069001007,80,37,43,1.38
2020,CB2020,005,2,Bronx,20069001008,302,181,121,2.76
2020,CB2020,005,2,Bronx,20069002000,141,62,79,1.94
2020,CB2020,005,2,Bronx,20069002001,642,336,306,2.69
2020,CB2020,005,2,Bronx,20069002002,401,172,229,2.96
2020,CB2020,005,2,Bronx,20069002003,496,231,265,2.94
2020,CB2020,005,2,Bronx,20069002004,73,37,36,4.18
2020,CB2020,005,2,Bronx,20069002005,91,49,42,2.44
2020,CB2020,005,2,Bronx,20069002006,52,30,22,0.55
2020,CB2020,005,2,Bronx,20069003000,654,299,355,2.14
2020,CB2020,005,2,Bronx,20069003001,686,274,412,2.42
2020,CB2020,005,2,Bronx,20069004000,976,416,560,5.39
2020,CB2020,005,2,Bronx,20070001000,432,202,230,4.72
2020,CB2020,005,2,Bronx,20070001001,529,277,252,4.7
2020,CB2020,005,2,Bronx,20070001002,163,73,90,4.71
2020,CB2020,005,2,Bronx,20070001003,670,328,342,4.7
2020,CB2020,005,2,Bronx,20070001004,570,335,235,4.7
2020,CB2020,005,2,Bronx,20070001005,299,134,165,4.87
2020,CB2020,005,2,Bronx,20070002000,499,266,233,4.16
2020,CB2020,005,2,Bronx,20070002001,475,252,223,3.84
2020,CB2020,005,2,Bronx,20070003000,501,236,265,5.06
2020,CB2020,005,2,Bronx,20070003001,369,202,167,4.73
2020,CB2020,005,2,Bronx,20070003002,514,254,260,4.44
2020,CB2020,005,2,Bronx,20071001000,0,0,0,3.17
2020,CB2020,005,2,Bronx,20071001001,0,0,0,3.18
2020,CB2020,005,2,Bronx,20071001002,233,105,128,1.44
2020,CB2020,005,2,Bronx,20071001003,128,73,55,0.88
2020,CB2020,005,2,Bronx,20071001004,155,73,82,1.55
2020,CB2020,005,2,Bronx,20071001005,75,26,49,0.66
2020,CB2020,005,2,Bronx,20071001006,111,49,62,0.83
2020,CB2020,005,2,Bronx,20071001007,102,56,46,1.14
2020,CB2020,005,2,Bronx,20071001008,47,15,32,0.4
2020,CB2020,005,2,Bronx,20071002000,285,124,161,1.85
2020,CB2020,005,2,Bronx,20071002001,0,0,0,1.48
2020,CB2020,005,2,Bronx,20071002002,96,50,46,0.98
2020,CB2020,005,2,Bronx,20071002003,197,86,111,0.97
2020,CB2020,005,2,Bronx,20071002004,0,0,0,4.71
2020,CB2020,005,2,Bronx,20071002005,1195,528,667,8.77
2020,CB2020,005,2,Bronx,20071002006,0,0,0,0.65
2020,CB2020,005,2,Bronx,20071002007,158,84,74,2.66
2020,CB2020,005,2,Bronx,20071002008,0,0,0,2.74
2020,CB2020,005,2,Bronx,20071002009,0,0,0,2.49
2020,CB2020,005,2,Bronx,20071002010,0,0,0,7.58
2020,CB2020,005,2,Bronx,20071002011,0,0,0,1.94
2020,CB2020,005,2,Bronx,20071002012,0,0,0,4.82
2020,CB2020,005,2,Bronx,20071002013,0,0,0,1.84
2020,CB2020,005,2,Bronx,20071002014,7,3,4,8.55
2020,CB2020,005,2,Bronx,20072001000,0,0,0,0.71
2020,CB2020,005,2,Bronx,20072001001,556,308,248,6
2020,CB2020,005,2,Bronx,20072001002,496,244,252,5.37
2020,CB2020,005,2,Bronx,20072001003,969,441,528,5.72
2020,CB2020,005,2,Bronx,20072002000,1424,700,724,7.4
2020,CB2020,005,2,Bronx,20072002001,427,235,192,4.15
2020,CB2020,005,2,Bronx,20072002002,412,201,211,4.71
2020,CB2020,005,2,Bronx,20072003000,28,19,9,1.63
2020,CB2020,005,2,Bronx,20072003001,46,27,19,1.66
2020,CB2020,005,2,Bronx,20072003002,0,0,0,0.27
2020,CB2020,005,2,Bronx,20072003003,0,0,0,0.41
2020,CB2020,005,2,Bronx,20072003004,970,430,540,8.62
2020,CB2020,005,2,Bronx,20072004000,963,477,486,5.98
2020,CB2020,005,2,Bronx,20073001000,446,245,201,2.15
2020,CB2020,005,2,Bronx,20073001001,323,173,150,2.16
2020,CB2020,005,2,Bronx,20073001002,161,51,110,4.25
2020,CB2020,005,2,Bronx,20073001003,261,126,135,2.39
2020,CB2020,005,2,Bronx,20073001004,330,153,177,1.79
2020,CB2020,005,2,Bronx,20073002000,512,247,265,3.2
2020,CB2020,005,2,Bronx,20073002001,669,310,359,3.27
2020,CB2020,005,2,Bronx,20073003000,868,328,540,5.58
2020,CB2020,005,2,Bronx,20073003001,635,315,320,4.83
2020,CB2020,005,2,Bronx,20073003002,0,0,0,5.02
2020,CB2020,005,2,Bronx,20074001000,388,170,218,5.49
2020,CB2020,005,2,Bronx,20074001001,383,190,193,4.7
2020,CB2020,005,2,Bronx,20074001002,418,151,267,5.28
2020,CB2020,005,2,Bronx,20074002000,192,90,102,5.53
2020,CB2020,005,2,Bronx,20074002001,289,137,152,4.75
2020,CB2020,005,2,Bronx,20074002002,780,338,442,5.33
2020,CB2020,005,2,Bronx,20074003000,1086,462,624,15.17
2020,CB2020,005,2,Bronx,20075001000,1086,478,608,7.52
2020,CB2020,005,2,Bronx,20075001001,670,315,355,6.85
2020,CB2020,005,2,Bronx,20075002000,104,52,52,1.61
2020,CB2020,005,2,Bronx,20075002001,223,113,110,1.89
2020,CB2020,005,2,Bronx,20075002002,418,196,222,4.63
2020,CB2020,005,2,Bronx,20075002003,1597,685,912,4.68
2020,CB2020,005,2,Bronx,20075002004,0,0,0,3.42
2020,CB2020,005,2,Bronx,20075002005,245,107,138,3.21
2020,CB2020,005,2,Bronx,20075002006,118,55,63,2.52
2020,CB2020,005,2,Bronx,20075002007,183,83,100,2.18
2020,CB2020,005,2,Bronx,20075002008,278,145,133,2.82
2020,CB2020,005,2,Bronx,20075003000,985,419,566,8.89
2020,CB2020,005,2,Bronx,20075004000,27,16,11,1.16
2020,CB2020,005,2,Bronx,20075004001,815,351,464,4.87
2020,CB2020,005,2,Bronx,20076001000,98,46,52,1.74
2020,CB2020,005,2,Bronx,20076001001,522,262,260,2.37
2020,CB2020,005,2,Bronx,20076002000,586,287,299,4.86
2020,CB2020,005,2,Bronx,20076002001,576,283,293,5.1
2020,CB2020,005,2,Bronx,20076003000,589,282,307,3.22
2020,CB2020,005,2,Bronx,20076003001,308,159,149,3.51
2020,CB2020,005,2,Bronx,20076004000,36,21,15,0.55
2020,CB2020,005,2,Bronx,20076004001,92,62,30,1.18
2020,CB2020,005,2,Bronx,20076004002,504,239,265,4.62
2020,CB2020,005,2,Bronx,20076004003,643,341,302,4.93
2020,CB2020,005,2,Bronx,20076004004,0,0,0,2.59
2020,CB2020,005,2,Bronx,20076004005,422,170,252,2.79
2020,CB2020,005,2,Bronx,20076005000,150,87,63,2.24
2020,CB2020,005,2,Bronx,20076005001,348,172,176,3.51
2020,CB2020,005,2,Bronx,20076005002,495,257,238,4.15
2020,CB2020,005,2,Bronx,20076005003,0,0,0,0.44
2020,CB2020,005,2,Bronx,20076005004,32,20,12,1.29
2020,CB2020,005,2,Bronx,20076005005,281,152,129,4.59
2020,CB2020,005,2,Bronx,20077001000,228,113,115,2.73
2020,CB2020,005,2,Bronx,20077001001,137,66,71,2.24
2020,CB2020,005,2,Bronx,20077001002,220,130,90,2.26
2020,CB2020,005,2,Bronx,20077001003,100,54,46,1.58
2020,CB2020,005,2,Bronx,20077001004,294,138,156,2.08
2020,CB2020,005,2,Bronx,20077001005,130,77,53,3.01
2020,CB2020,005,2,Bronx,20077001006,175,83,92,1.5
2020,CB2020,005,2,Bronx,20077001007,119,57,62,1.5
2020,CB2020,005,2,Bronx,20077001008,21,10,11,2.39
2020,CB2020,005,2,Bronx,20077001009,66,37,29,2.04
2020,CB2020,005,2,Bronx,20077001010,0,0,0,3.9
2020,CB2020,005,2,Bronx,20077001011,264,93,171,1.96
2020,CB2020,005,2,Bronx,20077001012,220,96,124,0.67
2020,CB2020,005,2,Bronx,20078001000,0,0,0,0.24
2020,CB2020,005,2,Bronx,20078001001,44,23,21,3.51
2020,CB2020,005,2,Bronx,20078001002,340,171,169,5.12
2020,CB2020,005,2,Bronx,20078001003,433,216,217,5.26
2020,CB2020,005,2,Bronx,20078001004,474,217,257,5.25
2020,CB2020,005,2,Bronx,20078001005,423,226,197,5.27
2020,CB2020,005,2,Bronx,20078002000,0,0,0,2.51
2020,CB2020,005,2,Bronx,20078002001,0,0,0,1.78
2020,CB2020,005,2,Bronx,20078002002,306,151,155,4.42
2020,CB2020,005,2,Bronx,20078002003,698,329,369,5.27
2020,CB2020,005,2,Bronx,20078002004,496,249,247,5.26
2020,CB2020,005,2,Bronx,20078002005,302,164,138,5.38
2020,CB2020,005,2,Bronx,20078002006,649,314,335,5.37
2020,CB2020,005,2,Bronx,20078002007,518,270,248,5.37
2020,CB2020,005,2,Bronx,20078003000,370,183,187,5.71
2020,CB2020,005,2,Bronx,20078003001,858,436,422,3.12
2020,CB2020,005,2,Bronx,20078004000,225,112,113,2.98
2020,CB2020,005,2,Bronx,20078004001,901,441,460,5.26
2020,CB2020,005,2,Bronx,20079001000,539,270,269,5.27
2020,CB2020,005,2,Bronx,20079001001,133,73,60,2.34
2020,CB2020,005,2,Bronx,20079001002,574,260,314,3.23
2020,CB2020,005,2,Bronx,20079001003,288,115,173,1.99
2020,CB2020,005,2,Bronx,20079002000,526,280,246,2.65
2020,CB2020,005,2,Bronx,20079002001,278,159,119,3.03
2020,CB2020,005,2,Bronx,20079003000,260,108,152,2.23
2020,CB2020,005,2,Bronx,20079003001,633,320,313,2.47
2020,CB2020,005,2,Bronx,20079003002,185,109,76,1.88
2020,CB2020,005,2,Bronx,20079004000,378,171,207,4.58
2020,CB2020,005,2,Bronx,20079004001,799,410,389,2.15
2020,CB2020,005,2,Bronx,20079004002,224,122,102,2.41
2020,CB2020,005,2,Bronx,20079004003,137,63,74,1.81
2020,CB2020,005,2,Bronx,20079004004,70,24,46,1.81
2020,CB2020,005,2,Bronx,20079005000,852,347,505,3.08
2020,CB2020,005,2,Bronx,20079006000,950,398,552,7.97
2020,CB2020,005,2,Bronx,20083001000,409,214,195,2.95
2020,CB2020,005,2,Bronx,20083001001,480,229,251,5.07
2020,CB2020,005,2,Bronx,20083001002,188,88,100,0.93
2020,CB2020,005,2,Bronx,20083002000,369,183,186,4.4
2020,CB2020,005,2,Bronx,20083002001,316,133,183,2.48
2020,CB2020,005,2,Bronx,20083003000,993,412,581,4.41
2020,CB2020,005,2,Bronx,20083003001,276,130,146,4.21
2020,CB2020,005,2,Bronx,20083004000,472,225,247,4.42
2020,CB2020,005,2,Bronx,20083004001,783,387,396,5.82
2020,CB2020,005,2,Bronx,20083005000,911,392,519,4.84
2020,CB2020,005,2,Bronx,20083006000,552,283,269,4.71
2020,CB2020,005,2,Bronx,20083006001,373,141,232,5.6
2020,CB2020,005,2,Bronx,20083006002,0,0,0,0.52
2020,CB2020,005,2,Bronx,20083006003,0,0,0,2.51
2020,CB2020,005,2,Bronx,20084001000,335,167,168,5.07
2020,CB2020,005,2,Bronx,20084001001,510,245,265,4.98
2020,CB2020,005,2,Bronx,20084002000,262,116,146,3.34
2020,CB2020,005,2,Bronx,20084002001,278,167,111,4.91
2020,CB2020,005,2,Bronx,20084002002,299,132,167,5.25
2020,CB2020,005,2,Bronx,20084002003,340,184,156,5.22
2020,CB2020,005,2,Bronx,20084002004,322,135,187,4.89
2020,CB2020,005,2,Bronx,20084002005,35,19,16,0.95
2020,CB2020,005,2,Bronx,20084002006,206,96,110,4.13
2020,CB2020,005,2,Bronx,20085001000,27,14,13,4.1
2020,CB2020,005,2,Bronx,20085001001,0,0,0,3.89
2020,CB2020,005,2,Bronx,20085001002,957,435,522,4.2
2020,CB2020,005,2,Bronx,20085002000,98,41,57,0.92
2020,CB2020,005,2,Bronx,20085002001,232,114,118,3.06
2020,CB2020,005,2,Bronx,20085002002,749,347,402,3.81
2020,CB2020,005,2,Bronx,20085002003,225,111,114,1.84
2020,CB2020,005,2,Bronx,20085002004,0,0,0,0.89
2020,CB2020,005,2,Bronx,20085002005,607,271,336,2.9
2020,CB2020,005,2,Bronx,20085003000,312,157,155,1.92
2020,CB2020,005,2,Bronx,20085003001,329,157,172,2.33
2020,CB2020,005,2,Bronx,20085003002,42,13,29,2.94
2020,CB2020,005,2,Bronx,20085003003,368,170,198,4.01
2020,CB2020,005,2,Bronx,20085004000,906,424,482,3.82
2020,CB2020,005,2,Bronx,20085005000,1042,445,597,4.25
2020,CB2020,005,2,Bronx,20086001000,379,171,208,5.54
2020,CB2020,005,2,Bronx,20086001001,376,166,210,4.73
2020,CB2020,005,2,Bronx,20086001002,204,107,97,5.35
2020,CB2020,005,2,Bronx,20086002000,1602,660,942,14.85
2020,CB2020,005,2,Bronx,20086003000,1584,703,881,15.91
2020,CB2020,005,2,Bronx,20087001000,0,0,0,0.77
2020,CB2020,005,2,Bronx,20087001001,346,161,185,4.97
2020,CB2020,005,2,Bronx,20087001002,596,251,345,5.42
2020,CB2020,005,2,Bronx,20087001003,0,0,0,1.24
2020,CB2020,005,2,Bronx,20087001004,262,133,129,3.2
2020,CB2020,005,2,Bronx,20087001005,0,0,0,6.24
2020,CB2020,005,2,Bronx,20087001006,0,0,0,4.93
2020,CB2020,005,2,Bronx,20087002000,342,131,211,1.34
2020,CB2020,005,2,Bronx,20087002001,524,247,277,3.87
2020,CB2020,005,2,Bronx,20087002002,622,261,361,4.43
2020,CB2020,005,2,Bronx,20087003000,119,48,71,2.54
2020,CB2020,005,2,Bronx,20087003001,741,358,383,4.11
2020,CB2020,005,2,Bronx,20087004000,529,227,302,2.35
2020,CB2020,005,2,Bronx,20087004001,446,194,252,2.18
2020,CB2020,005,2,Bronx,20087005000,987,473,514,3.23
2020,CB2020,005,2,Bronx,20087005001,462,213,249,1.94
2020,CB2020,005,2,Bronx,20089001000,646,314,332,4.21
2020,CB2020,005,2,Bronx,20089001001,392,173,219,4.55
2020,CB2020,005,2,Bronx,20089001002,404,172,232,3.08
2020,CB2020,005,2,Bronx,20089001003,264,86,178,3.13
2020,CB2020,005,2,Bronx,20089002000,128,75,53,2.88
2020,CB2020,005,2,Bronx,20089002001,692,382,310,6.03
2020,CB2020,005,2,Bronx,20089002002,592,280,312,3.38
2020,CB2020,005,2,Bronx,20090000001,0,0,0,0
2020,CB2020,005,2,Bronx,20090000002,0,0,0,0
2020,CB2020,005,2,Bronx,20090000003,0,0,0,0
2020,CB2020,005,2,Bronx,20090001000,0,0,0,0.26
2020,CB2020,005,2,Bronx,20090001001,0,0,0,1.27
2020,CB2020,005,2,Bronx,20090001002,0,0,0,0.26
2020,CB2020,005,2,Bronx,20090001003,0,0,0,2.31
2020,CB2020,005,2,Bronx,20090001004,30,18,12,45.93
2020,CB2020,005,2,Bronx,20090001005,14,9,5,9.19
2020,CB2020,005,2,Bronx,20090001006,32,13,19,10.28
2020,CB2020,005,2,Bronx,20090001007,0,0,0,5.34
2020,CB2020,005,2,Bronx,20090001008,0,0,0,15.36
2020,CB2020,005,2,Bronx,20090001009,63,33,30,2.97
2020,CB2020,005,2,Bronx,20090001010,97,35,62,5.52
2020,CB2020,005,2,Bronx,20090002000,0,0,0,0.22
2020,CB2020,005,2,Bronx,20090002001,0,0,0,0.91
2020,CB2020,005,2,Bronx,20090002002,0,0,0,0.25
2020,CB2020,005,2,Bronx,20090002003,0,0,0,1.2
2020,CB2020,005,2,Bronx,20090002004,0,0,0,2.55
2020,CB2020,005,2,Bronx,20090002005,0,0,0,1.28
2020,CB2020,005,2,Bronx,20090002006,0,0,0,1.96
2020,CB2020,005,2,Bronx,20090002007,0,0,0,0.8
2020,CB2020,005,2,Bronx,20090002008,0,0,0,0.82
2020,CB2020,005,2,Bronx,20090002009,0,0,0,0
2020,CB2020,005,2,Bronx,20090002010,0,0,0,0.45
2020,CB2020,005,2,Bronx,20090002011,0,0,0,0.33
2020,CB2020,005,2,Bronx,20090002012,0,0,0,0.3
2020,CB2020,005,2,Bronx,20090002013,0,0,0,27.58
2020,CB2020,005,2,Bronx,20090002014,0,0,0,1.48
2020,CB2020,005,2,Bronx,20090002015,33,16,17,13.76
2020,CB2020,005,2,Bronx,20090002016,61,28,33,2.31
2020,CB2020,005,2,Bronx,20090002017,124,62,62,2.48
2020,CB2020,005,2,Bronx,20090002018,20,10,10,27.49
2020,CB2020,005,2,Bronx,20090002019,308,136,172,17.23
2020,CB2020,005,2,Bronx,20090002020,0,0,0,4.73
2020,CB2020,005,2,Bronx,20090003000,734,290,444,9.32
2020,CB2020,005,2,Bronx,20090003001,0,0,0,1.07
2020,CB2020,005,2,Bronx,20090004000,160,83,77,5.52
2020,CB2020,005,2,Bronx,20090004001,251,116,135,4.74
2020,CB2020,005,2,Bronx,20090004002,197,103,94,5.34
2020,CB2020,005,2,Bronx,20090004003,278,130,148,5.51
2020,CB2020,005,2,Bronx,20090005000,1509,630,879,14.87
2020,CB2020,005,2,Bronx,20092001000,1067,485,582,7.12
2020,CB2020,005,2,Bronx,20092001001,0,0,0,2.03
2020,CB2020,005,2,Bronx,20092001002,0,0,0,1.13
2020,CB2020,005,2,Bronx,20092001003,269,128,141,3.71
2020,CB2020,005,2,Bronx,20092001004,49,23,26,2.21
2020,CB2020,005,2,Bronx,20092001005,0,0,0,1.05
2020,CB2020,005,2,Bronx,20092001006,0,0,0,1
2020,CB2020,005,2,Bronx,20092001007,0,0,0,0.37
2020,CB2020,005,2,Bronx,20092002000,443,245,198,5.26
2020,CB2020,005,2,Bronx,20092002001,423,206,217,5.24
2020,CB2020,005,2,Bronx,20092003000,416,212,204,6.36
2020,CB2020,005,2,Bronx,20092003001,471,239,232,5.26
2020,CB2020,005,2,Bronx,20092003002,754,378,376,4.97
2020,CB2020,005,2,Bronx,20092003003,252,123,129,3.97
2020,CB2020,005,2,Bronx,20092003004,0,0,0,1.62
2020,CB2020,005,2,Bronx,20092003005,62,26,36,1.08
2020,CB2020,005,2,Bronx,20092003006,0,0,0,0.96
2020,CB2020,005,2,Bronx,20092004000,468,247,221,5.91
2020,CB2020,005,2,Bronx,20092004001,573,261,312,5.28
2020,CB2020,005,2,Bronx,20092005000,695,342,353,5.02
2020,CB2020,005,2,Bronx,20092005001,329,165,164,3.93
2020,CB2020,005,2,Bronx,20092005002,0,0,0,1.4
2020,CB2020,005,2,Bronx,20092005003,0,0,0,1.09
2020,CB2020,005,2,Bronx,20092005004,0,0,0,0.76
2020,CB2020,005,2,Bronx,20093011000,218,120,98,4.91
2020,CB2020,005,2,Bronx,20093011001,346,187,159,5.06
2020,CB2020,005,2,Bronx,20093011002,517,282,235,5.09
2020,CB2020,005,2,Bronx,20093011003,27,10,17,2.57
2020,CB2020,005,2,Bronx,20093012000,603,271,332,5.09
2020,CB2020,005,2,Bronx,20093012001,420,200,220,5.06
2020,CB2020,005,2,Bronx,20093012002,391,179,212,5.26
2020,CB2020,005,2,Bronx,20093013000,773,397,376,3.5
2020,CB2020,005,2,Bronx,20093013001,741,336,405,5.42
2020,CB2020,005,2,Bronx,20093013002,36,26,10,16.36
2020,CB2020,005,2,Bronx,20093013003,76,39,37,0.61
2020,CB2020,005,2,Bronx,20093014000,0,0,0,0.39
2020,CB2020,005,2,Bronx,20093014001,0,0,0,0.36
2020,CB2020,005,2,Bronx,20093014002,0,0,0,0.76
2020,CB2020,005,2,Bronx,20093014003,0,0,0,0.65
2020,CB2020,005,2,Bronx,20093014004,0,0,0,4.08
2020,CB2020,005,2,Bronx,20093014005,0,0,0,3.27
2020,CB2020,005,2,Bronx,20093014006,0,0,0,0.44
2020,CB2020,005,2,Bronx,20093014007,0,0,0,0.42
2020,CB2020,005,2,Bronx,20093014008,0,0,0,0.3
2020,CB2020,005,2,Bronx,20093014009,0,0,0,0.36
2020,CB2020,005,2,Bronx,20093014010,166,102,64,3.46
2020,CB2020,005,2,Bronx,20093014011,962,437,525,6.31
2020,CB2020,005,2,Bronx,20093014012,0,0,0,5.77
2020,CB2020,005,2,Bronx,20093015000,0,0,0,0.6
2020,CB2020,005,2,Bronx,20093015001,0,0,0,0.63
2020,CB2020,005,2,Bronx,20093015002,0,0,0,0.4
2020,CB2020,005,2,Bronx,20093015003,0,0,0,0.95
2020,CB2020,005,2,Bronx,20093015004,0,0,0,3.76
2020,CB2020,005,2,Bronx,20093015005,0,0,0,0.93
2020,CB2020,005,2,Bronx,20093015006,0,0,0,3.44
2020,CB2020,005,2,Bronx,20093015007,51,27,24,3.15
2020,CB2020,005,2,Bronx,20093015008,0,0,0,0.35
2020,CB2020,005,2,Bronx,20093015009,0,0,0,0.36
2020,CB2020,005,2,Bronx,20093015010,27,15,12,1.81
2020,CB2020,005,2,Bronx,20093015011,57,27,30,3.11
2020,CB2020,005,2,Bronx,20093015012,0,0,0,2.04
2020,CB2020,005,2,Bronx,20093015013,0,0,0,0.52
2020,CB2020,005,2,Bronx,20093016000,0,0,0,3.46
2020,CB2020,005,2,Bronx,20093016001,0,0,0,4.14
2020,CB2020,005,2,Bronx,20093016002,0,0,0,4.21
2020,CB2020,005,2,Bronx,20093016003,38,24,14,4.18
2020,CB2020,005,2,Bronx,20093016004,35,15,20,4.18
2020,CB2020,005,2,Bronx,20093016005,38,25,13,4.15
2020,CB2020,005,2,Bronx,20093016006,29,17,12,4.2
2020,CB2020,005,2,Bronx,20093016007,0,0,0,4.34
2020,CB2020,005,2,Bronx,20093016008,0,0,0,0.63
2020,CB2020,005,2,Bronx,20093020001,0,0,0,0
2020,CB2020,005,2,Bronx,20093020002,0,0,0,0
2020,CB2020,005,2,Bronx,20093021000,0,0,0,3.8
2020,CB2020,005,2,Bronx,20093021001,0,0,0,3.54
2020,CB2020,005,2,Bronx,20093021002,17,9,8,3.62
2020,CB2020,005,2,Bronx,20093021003,0,0,0,3.58
2020,CB2020,005,2,Bronx,20093021004,0,0,0,3.59
2020,CB2020,005,2,Bronx,20093021005,0,0,0,3.57
2020,CB2020,005,2,Bronx,20093021006,0,0,0,3.59
2020,CB2020,005,2,Bronx,20093021007,0,0,0,3.73
2020,CB2020,005,2,Bronx,20093021008,0,0,0,4.39
2020,CB2020,005,2,Bronx,20093021009,0,0,0,4.19
2020,CB2020,005,2,Bronx,20093021010,0,0,0,4.18
2020,CB2020,005,2,Bronx,20093021011,3,3,0,4.17
2020,CB2020,005,2,Bronx,20093021012,10,5,5,4.18
2020,CB2020,005,2,Bronx,20093021013,0,0,0,4.17
2020,CB2020,005,2,Bronx,20093021014,0,0,0,4.2
2020,CB2020,005,2,Bronx,20093021015,0,0,0,4.18
2020,CB2020,005,2,Bronx,20093021016,0,0,0,4.34
2020,CB2020,005,2,Bronx,20093021017,0,0,0,4.2
2020,CB2020,005,2,Bronx,20093021018,0,0,0,4.16
2020,CB2020,005,2,Bronx,20093021019,0,0,0,4.16
2020,CB2020,005,2,Bronx,20093021020,0,0,0,4.24
2020,CB2020,005,2,Bronx,20093021021,0,0,0,8.46
2020,CB2020,005,2,Bronx,20093021022,0,0,0,3.9
2020,CB2020,005,2,Bronx,20093021023,0,0,0,4.12
2020,CB2020,005,2,Bronx,20093021024,0,0,0,4.23
2020,CB2020,005,2,Bronx,20093021025,0,0,0,4.56
2020,CB2020,005,2,Bronx,20093021026,0,0,0,60.2
2020,CB2020,005,2,Bronx,20093021027,473,473,0,45.81
2020,CB2020,005,2,Bronx,20093022000,0,0,0,0.43
2020,CB2020,005,2,Bronx,20093022001,0,0,0,0.48
2020,CB2020,005,2,Bronx,20093022002,0,0,0,0.44
2020,CB2020,005,2,Bronx,20093022003,0,0,0,0.89
2020,CB2020,005,2,Bronx,20093022004,3,2,1,7.19
2020,CB2020,005,2,Bronx,20093022005,0,0,0,3.91
2020,CB2020,005,2,Bronx,20093022006,0,0,0,1.94
2020,CB2020,005,2,Bronx,20093022007,0,0,0,2.08
2020,CB2020,005,2,Bronx,20093022008,0,0,0,3.02
2020,CB2020,005,2,Bronx,20093022009,0,0,0,2.44
2020,CB2020,005,2,Bronx,20093022010,0,0,0,0.75
2020,CB2020,005,2,Bronx,20093022011,0,0,0,0.4
2020,CB2020,005,2,Bronx,20093022012,0,0,0,0.54
2020,CB2020,005,2,Bronx,20093022013,0,0,0,0.62
2020,CB2020,005,2,Bronx,20093022014,0,0,0,1.21
2020,CB2020,005,2,Bronx,20093022015,0,0,0,1.81
2020,CB2020,005,2,Bronx,20093022016,0,0,0,0.91
2020,CB2020,005,2,Bronx,20093022017,0,0,0,2.47
2020,CB2020,005,2,Bronx,20093022018,0,0,0,3.52
2020,CB2020,005,2,Bronx,20093022019,0,0,0,3.65
2020,CB2020,005,2,Bronx,20093022020,0,0,0,4.29
2020,CB2020,005,2,Bronx,20093022021,0,0,0,0.51
2020,CB2020,005,2,Bronx,20093022022,0,0,0,2.94
2020,CB2020,005,2,Bronx,20093022023,6,5,1,3.6
2020,CB2020,005,2,Bronx,20093022024,0,0,0,3.95
2020,CB2020,005,2,Bronx,20093022025,0,0,0,2.01
2020,CB2020,005,2,Bronx,20093022026,0,0,0,139.93
2020,CB2020,005,2,Bronx,20093022027,0,0,0,4.32
2020,CB2020,005,2,Bronx,20093022028,0,0,0,4.38
2020,CB2020,005,2,Bronx,20093022029,0,0,0,5.21
2020,CB2020,005,2,Bronx,20093022030,0,0,0,4.15
2020,CB2020,005,2,Bronx,20093022031,0,0,0,6.72
2020,CB2020,005,2,Bronx,20096001000,341,182,159,5.45
2020,CB2020,005,2,Bronx,20096001001,395,187,208,5.24
2020,CB2020,005,2,Bronx,20096001002,343,182,161,5.27
2020,CB2020,005,2,Bronx,20096001003,318,167,151,5.24
2020,CB2020,005,2,Bronx,20096001004,355,137,218,5.32
2020,CB2020,005,2,Bronx,20096001005,325,109,216,14.07
2020,CB2020,005,2,Bronx,20096001006,0,0,0,1.59
2020,CB2020,005,2,Bronx,20096001007,0,0,0,0.18
2020,CB2020,005,2,Bronx,20096001008,0,0,0,0.71
2020,CB2020,005,2,Bronx,20096002000,33,13,20,39.25
2020,CB2020,005,2,Bronx,20096002001,30,15,15,3.06
2020,CB2020,005,2,Bronx,20096002002,0,0,0,0.52
2020,CB2020,005,2,Bronx,20096002003,0,0,0,3.83
2020,CB2020,005,2,Bronx,20096002004,0,0,0,2.52
2020,CB2020,005,2,Bronx,20096002005,0,0,0,2.31
2020,CB2020,005,2,Bronx,20096002006,0,0,0,9.47
2020,CB2020,005,2,Bronx,20096002007,0,0,0,4.56
2020,CB2020,005,2,Bronx,20096002008,0,0,0,0.8
2020,CB2020,005,2,Bronx,20096002009,0,0,0,5.56
2020,CB2020,005,2,Bronx,20096002010,0,0,0,5.54
2020,CB2020,005,2,Bronx,20096002011,0,0,0,5.79
2020,CB2020,005,2,Bronx,20096002012,127,59,68,4.32
2020,CB2020,005,2,Bronx,20096002013,152,83,69,10.21
2020,CB2020,005,2,Bronx,20096002014,0,0,0,2.42
2020,CB2020,005,2,Bronx,20096002015,0,0,0,4.15
2020,CB2020,005,2,Bronx,20096002016,0,0,0,0
2020,CB2020,005,2,Bronx,20096002017,0,0,0,0.22
2020,CB2020,005,2,Bronx,20096002018,0,0,0,0.19
2020,CB2020,005,2,Bronx,20096002019,0,0,0,0.51
2020,CB2020,005,2,Bronx,20096002020,349,177,172,2.45
2020,CB2020,005,2,Bronx,20096002021,0,0,0,10.02
2020,CB2020,005,2,Bronx,20096002022,178,86,92,2.79
2020,CB2020,005,2,Bronx,20096002023,0,0,0,3.81
2020,CB2020,005,2,Bronx,20096002024,0,0,0,0.79
2020,CB2020,005,2,Bronx,20096002025,0,0,0,5.66
2020,CB2020,005,2,Bronx,20098001000,311,147,164,5.23
2020,CB2020,005,2,Bronx,20098001001,405,194,211,5.29
2020,CB2020,005,2,Bronx,20098001002,227,106,121,5.26
2020,CB2020,005,2,Bronx,20098001003,233,128,105,5.24
2020,CB2020,005,2,Bronx,20098001004,120,51,69,5.54
2020,CB2020,005,2,Bronx,20098002000,307,183,124,5.25
2020,CB2020,005,2,Bronx,20098002001,255,87,168,5.27
2020,CB2020,005,2,Bronx,20098002002,257,113,144,5.24
2020,CB2020,005,2,Bronx,20098002003,222,119,103,5.53
2020,CB2020,005,2,Bronx,20098003000,0,0,0,0.75
2020,CB2020,005,2,Bronx,20098003001,0,0,0,2.4
2020,CB2020,005,2,Bronx,20098003002,0,0,0,1.54
2020,CB2020,005,2,Bronx,20098003003,0,0,0,0.33
2020,CB2020,005,2,Bronx,20098003004,0,0,0,0.68
2020,CB2020,005,2,Bronx,20098003005,0,0,0,5.53
2020,CB2020,005,2,Bronx,20098003006,305,145,160,5.28
2020,CB2020,005,2,Bronx,20098003007,187,71,116,5.15
2020,CB2020,005,2,Bronx,20098003008,226,110,116,5.25
2020,CB2020,005,2,Bronx,20098003009,155,69,86,5.29
2020,CB2020,005,2,Bronx,20098003010,63,34,29,5.12
2020,CB2020,005,2,Bronx,20098003011,191,114,77,5.63
2020,CB2020,005,2,Bronx,20098004000,337,160,177,5.26
2020,CB2020,005,2,Bronx,20098004001,242,110,132,5.26
2020,CB2020,005,2,Bronx,20098004002,268,129,139,5.53
2020,CB2020,005,2,Bronx,20098005000,0,0,0,4.14
2020,CB2020,005,2,Bronx,20098005001,0,0,0,1.86
2020,CB2020,005,2,Bronx,20098005002,0,0,0,4.2
2020,CB2020,005,2,Bronx,20098005003,0,0,0,0.15
2020,CB2020,005,2,Bronx,20098005004,0,0,0,0.19
2020,CB2020,005,2,Bronx,20098005005,1592,708,884,10.45
2020,CB2020,005,2,Bronx,20110000001,0,0,0,0
2020,CB2020,005,2,Bronx,20110000002,0,0,0,0
2020,CB2020,005,2,Bronx,20110001000,0,0,0,2.26
2020,CB2020,005,2,Bronx,20110001001,0,0,0,4.34
2020,CB2020,005,2,Bronx,20110001002,0,0,0,3.92
2020,CB2020,005,2,Bronx,20110001003,0,0,0,20.38
2020,CB2020,005,2,Bronx,20110001004,0,0,0,356.47
2020,CB2020,005,2,Bronx,20110001005,0,0,0,0.74
2020,CB2020,005,2,Bronx,20110001006,0,0,0,2.53
2020,CB2020,005,2,Bronx,20110001007,0,0,0,2.71
2020,CB2020,005,2,Bronx,20110001008,0,0,0,14.91
2020,CB2020,005,2,Bronx,20110001009,0,0,0,97.05
2020,CB2020,005,2,Bronx,20110001010,0,0,0,2.72
2020,CB2020,005,2,Bronx,20110001011,0,0,0,3.27
2020,CB2020,005,2,Bronx,20115021000,0,0,0,0.41
2020,CB2020,005,2,Bronx,20115021001,0,0,0,0.97
2020,CB2020,005,2,Bronx,20115021002,0,0,0,0.82
2020,CB2020,005,2,Bronx,20115021003,0,0,0,1.22
2020,CB2020,005,2,Bronx,20115021004,0,0,0,0.8
2020,CB2020,005,2,Bronx,20115021005,0,0,0,4.03
2020,CB2020,005,2,Bronx,20115021006,0,0,0,2.1
2020,CB2020,005,2,Bronx,20115021007,25,11,14,5.63
2020,CB2020,005,2,Bronx,20115021008,0,0,0,2.21
2020,CB2020,005,2,Bronx,20115021009,0,0,0,6.74
2020,CB2020,005,2,Bronx,20115021010,0,0,0,0
2020,CB2020,005,2,Bronx,20115021011,144,64,80,2.14
2020,CB2020,005,2,Bronx,20115021012,602,291,311,3.15
2020,CB2020,005,2,Bronx,20115021013,515,273,242,4.2
2020,CB2020,005,2,Bronx,20115021014,604,266,338,4.41
2020,CB2020,005,2,Bronx,20115021015,0,0,0,4.59
2020,CB2020,005,2,Bronx,20115021016,45,19,26,4.43
2020,CB2020,005,2,Bronx,20115021017,0,0,0,1.28
2020,CB2020,005,2,Bronx,20115021018,0,0,0,1.13
2020,CB2020,005,2,Bronx,20115021019,0,0,0,0.44
2020,CB2020,005,2,Bronx,20115022000,699,353,346,4.59
2020,CB2020,005,2,Bronx,20115022001,478,230,248,3.05
2020,CB2020,005,2,Bronx,20115022002,290,137,153,3.02
2020,CB2020,005,2,Bronx,20115023000,0,0,0,0
2020,CB2020,005,2,Bronx,20115023001,0,0,0,7.95
2020,CB2020,005,2,Bronx,20115023002,0,0,0,4.68
2020,CB2020,005,2,Bronx,20115023003,30,20,10,4.56
2020,CB2020,005,2,Bronx,20115023004,964,440,524,4.57
2020,CB2020,005,2,Bronx,20117011000,40,20,20,5.13
2020,CB2020,005,2,Bronx,20117011001,0,0,0,5.06
2020,CB2020,005,2,Bronx,20117011002,384,173,211,5.08
2020,CB2020,005,2,Bronx,20117011003,868,405,463,4.44
2020,CB2020,005,2,Bronx,20117011004,256,108,148,1.56
2020,CB2020,005,2,Bronx,20117012000,0,0,0,4.01
2020,CB2020,005,2,Bronx,20117012001,0,0,0,5.48
2020,CB2020,005,2,Bronx,20117012002,0,0,0,5.1
2020,CB2020,005,2,Bronx,20117012003,0,0,0,4.93
2020,CB2020,005,2,Bronx,20117012004,0,0,0,2.79
2020,CB2020,005,2,Bronx,20117012005,0,0,0,3.52
2020,CB2020,005,2,Bronx,20117012006,0,0,0,4.38
2020,CB2020,005,2,Bronx,20117012007,6,4,2,2.55
2020,CB2020,005,2,Bronx,20117012008,0,0,0,0.77
2020,CB2020,005,2,Bronx,20117020001,0,0,0,0
2020,CB2020,005,2,Bronx,20117020002,0,0,0,0
2020,CB2020,005,2,Bronx,20117020003,0,0,0,0
2020,CB2020,005,2,Bronx,20117021000,0,0,0,83.21
2020,CB2020,005,2,Bronx,20117021001,0,0,0,12.8
2020,CB2020,005,2,Bronx,20117021002,0,0,0,20.21
2020,CB2020,005,2,Bronx,20117021003,0,0,0,3.81
2020,CB2020,005,2,Bronx,20117021004,0,0,0,3.78
2020,CB2020,005,2,Bronx,20117021005,0,0,0,3.77
2020,CB2020,005,2,Bronx,20117021006,0,0,0,1.62
2020,CB2020,005,2,Bronx,20117021007,0,0,0,3.62
2020,CB2020,005,2,Bronx,20117021008,0,0,0,1.75
2020,CB2020,005,2,Bronx,20117021009,0,0,0,1.01
2020,CB2020,005,2,Bronx,20117021010,0,0,0,1.83
2020,CB2020,005,2,Bronx,20117021011,0,0,0,3.78
2020,CB2020,005,2,Bronx,20117021012,0,0,0,3.92
2020,CB2020,005,2,Bronx,20117021013,0,0,0,1.62
2020,CB2020,005,2,Bronx,20117021014,0,0,0,3.72
2020,CB2020,005,2,Bronx,20117021015,0,0,0,3.9
2020,CB2020,005,2,Bronx,20117021016,0,0,0,3.97
2020,CB2020,005,2,Bronx,20117021017,0,0,0,98.86
2020,CB2020,005,2,Bronx,20117021018,0,0,0,10.72
2020,CB2020,005,2,Bronx,20117021019,0,0,0,1.72
2020,CB2020,005,2,Bronx,20117021020,0,0,0,3.7
2020,CB2020,005,2,Bronx,20117021021,0,0,0,3.8
2020,CB2020,005,2,Bronx,20117021022,0,0,0,3.79
2020,CB2020,005,2,Bronx,20118000001,0,0,0,0
2020,CB2020,005,2,Bronx,20118000002,0,0,0,0
2020,CB2020,005,2,Bronx,20118000003,0,0,0,0
2020,CB2020,005,2,Bronx,20118000004,0,0,0,0
2020,CB2020,005,2,Bronx,20118000005,0,0,0,0
2020,CB2020,005,2,Bronx,20118001000,69,47,22,7.3
2020,CB2020,005,2,Bronx,20118001001,190,88,102,8.18
2020,CB2020,005,2,Bronx,20118001002,140,75,65,6.7
2020,CB2020,005,2,Bronx,20118001003,289,128,161,21.11
2020,CB2020,005,2,Bronx,20118001004,459,214,245,23.27
2020,CB2020,005,2,Bronx,20118001005,111,62,49,3.18
2020,CB2020,005,2,Bronx,20118001006,1128,884,244,5.4
2020,CB2020,005,2,Bronx,20118001007,0,0,0,5.53
2020,CB2020,005,2,Bronx,20118001008,0,0,0,1.12
2020,CB2020,005,2,Bronx,20118001009,0,0,0,11.14
2020,CB2020,005,2,Bronx,20118001010,0,0,0,7.43
2020,CB2020,005,2,Bronx,20118001011,0,0,0,1.88
2020,CB2020,005,2,Bronx,20118001012,238,199,39,19.16
2020,CB2020,005,2,Bronx,20118001013,0,0,0,6.31
2020,CB2020,005,2,Bronx,20118001014,16,6,10,5.97
2020,CB2020,005,2,Bronx,20118001015,0,0,0,7.16
2020,CB2020,005,2,Bronx,20118002000,0,0,0,2.09
2020,CB2020,005,2,Bronx,20118002001,24,19,5,0.89
2020,CB2020,005,2,Bronx,20118002002,49,25,24,1.97
2020,CB2020,005,2,Bronx,20118002003,60,35,25,2.75
2020,CB2020,005,2,Bronx,20118002004,87,26,61,3.14
2020,CB2020,005,2,Bronx,20118002005,0,0,0,1.42
2020,CB2020,005,2,Bronx,20118002006,31,15,16,4.03
2020,CB2020,005,2,Bronx,20118002007,67,18,49,1.33
2020,CB2020,005,2,Bronx,20118002008,37,12,25,1.28
2020,CB2020,005,2,Bronx,20118002009,43,26,17,1.03
2020,CB2020,005,2,Bronx,20118002010,184,83,101,11.56
2020,CB2020,005,2,Bronx,20118002011,39,10,29,1
2020,CB2020,005,2,Bronx,20118002012,21,21,0,1.01
2020,CB2020,005,2,Bronx,20118002013,34,20,14,1
2020,CB2020,005,2,Bronx,20118002014,45,22,23,1
2020,CB2020,005,2,Bronx,20118002015,41,35,6,1.1
2020,CB2020,005,2,Bronx,20118002016,48,10,38,1.38
2020,CB2020,005,2,Bronx,20118002017,76,41,35,1.76
2020,CB2020,005,2,Bronx,20118002018,33,18,15,1.08
2020,CB2020,005,2,Bronx,20118002019,41,25,16,2.68
2020,CB2020,005,2,Bronx,20118002020,20,17,3,0.91
2020,CB2020,005,2,Bronx,20118002021,45,25,20,1.14
2020,CB2020,005,2,Bronx,20118002022,30,8,22,0.9
2020,CB2020,005,2,Bronx,20118002023,31,10,21,0.78
2020,CB2020,005,2,Bronx,20118002024,21,4,17,0.57
2020,CB2020,005,2,Bronx,20118002025,0,0,0,1.09
2020,CB2020,005,2,Bronx,20118002026,21,7,14,2.36
2020,CB2020,005,2,Bronx,20118002027,59,39,20,1.79
2020,CB2020,005,2,Bronx,20118002028,39,21,18,1.79
2020,CB2020,005,2,Bronx,20118002029,0,0,0,0.35
2020,CB2020,005,2,Bronx,20118003000,207,110,97,7.92
2020,CB2020,005,2,Bronx,20118003001,121,71,50,4.12
2020,CB2020,005,2,Bronx,20118003002,195,96,99,3.61
2020,CB2020,005,2,Bronx,20118003003,156,60,96,4
2020,CB2020,005,2,Bronx,20118003004,108,52,56,2.57
2020,CB2020,005,2,Bronx,20118003005,99,47,52,3.18
2020,CB2020,005,2,Bronx,20118003006,151,80,71,2.96
2020,CB2020,005,2,Bronx,20118003007,129,64,65,2.9
2020,CB2020,005,2,Bronx,20118003008,35,14,21,3.63
2020,CB2020,005,2,Bronx,20118003009,0,0,0,3.8
2020,CB2020,005,2,Bronx,20118003010,86,30,56,3.09
2020,CB2020,005,2,Bronx,20118003011,104,40,64,3.03
2020,CB2020,005,2,Bronx,20118003012,67,20,47,3.68
2020,CB2020,005,2,Bronx,20119001000,876,476,400,5.84
2020,CB2020,005,2,Bronx,20119001001,1223,583,640,6.92
2020,CB2020,005,2,Bronx,20119001002,0,0,0,1.22
2020,CB2020,005,2,Bronx,20119002000,622,301,321,4.24
2020,CB2020,005,2,Bronx,20119002001,321,138,183,3.29
2020,CB2020,005,2,Bronx,20119002002,0,0,0,2.22
2020,CB2020,005,2,Bronx,20119002003,101,23,78,0.52
2020,CB2020,005,2,Bronx,20119003000,746,370,376,4.23
2020,CB2020,005,2,Bronx,20119004000,853,405,448,4.44
2020,CB2020,005,2,Bronx,20119005000,267,135,132,4.13
2020,CB2020,005,2,Bronx,20119005001,694,294,400,4.23
2020,CB2020,005,2,Bronx,20121011000,185,85,100,3.85
2020,CB2020,005,2,Bronx,20121011001,743,370,373,3.8
2020,CB2020,005,2,Bronx,20121011002,151,57,94,0.74
2020,CB2020,005,2,Bronx,20121011003,383,159,224,3.52
2020,CB2020,005,2,Bronx,20121012000,0,0,0,0.25
2020,CB2020,005,2,Bronx,20121012001,240,114,126,1.88
2020,CB2020,005,2,Bronx,20121012002,225,114,111,2.61
2020,CB2020,005,2,Bronx,20121012003,297,173,124,3.22
2020,CB2020,005,2,Bronx,20121012004,522,260,262,4.04
2020,CB2020,005,2,Bronx,20121012005,215,98,117,3.08
2020,CB2020,005,2,Bronx,20121012006,358,154,204,1.58
2020,CB2020,005,2,Bronx,20121021000,315,150,165,4.3
2020,CB2020,005,2,Bronx,20121021001,655,276,379,2.84
2020,CB2020,005,2,Bronx,20121021002,381,181,200,1.9
2020,CB2020,005,2,Bronx,20121021003,86,53,33,1.19
2020,CB2020,005,2,Bronx,20121021004,179,90,89,2.03
2020,CB2020,005,2,Bronx,20123001000,428,237,191,5.52
2020,CB2020,005,2,Bronx,20123001001,1044,496,548,5.48
2020,CB2020,005,2,Bronx,20123001002,520,215,305,3.78
2020,CB2020,005,2,Bronx,20123002000,429,187,242,3.87
2020,CB2020,005,2,Bronx,20123002001,418,204,214,4.02
2020,CB2020,005,2,Bronx,20123002002,156,93,63,0.71
2020,CB2020,005,2,Bronx,20123002003,531,247,284,3.47
2020,CB2020,005,2,Bronx,20123003000,392,157,235,5.32
2020,CB2020,005,2,Bronx,20123003001,801,326,475,2.88
2020,CB2020,005,2,Bronx,20123004000,0,0,0,2.18
2020,CB2020,005,2,Bronx,20123005000,18,9,9,4.17
2020,CB2020,005,2,Bronx,20123005001,0,0,0,1.27
2020,CB2020,005,2,Bronx,20123005002,0,0,0,1.22
2020,CB2020,005,2,Bronx,20123005003,0,0,0,0.86
2020,CB2020,005,2,Bronx,20123005004,0,0,0,2.81
2020,CB2020,005,2,Bronx,20123006000,29,15,14,14.1
2020,CB2020,005,2,Bronx,20123006001,0,0,0,5.06
2020,CB2020,005,2,Bronx,20123006002,0,0,0,2.49
2020,CB2020,005,2,Bronx,20123006003,0,0,0,1.6
2020,CB2020,005,2,Bronx,20123006004,0,0,0,0.14
2020,CB2020,005,2,Bronx,20123006005,0,0,0,4.02
2020,CB2020,005,2,Bronx,20125001000,204,119,85,3.61
2020,CB2020,005,2,Bronx,20125001001,749,360,389,3.83
2020,CB2020,005,2,Bronx,20125001002,391,176,215,4.03
2020,CB2020,005,2,Bronx,20125001003,265,114,151,4.2
2020,CB2020,005,2,Bronx,20125001004,357,191,166,2.95
2020,CB2020,005,2,Bronx,20125001005,156,62,94,1.99
2020,CB2020,005,2,Bronx,20125001006,408,179,229,3.4
2020,CB2020,005,2,Bronx,20125001007,25,15,10,0.89
2020,CB2020,005,2,Bronx,20125002000,144,67,77,3.49
2020,CB2020,005,2,Bronx,20125002001,393,169,224,3.55
2020,CB2020,005,2,Bronx,20125002002,65,30,35,0.71
2020,CB2020,005,2,Bronx,20125002003,448,226,222,3.02
2020,CB2020,005,2,Bronx,20125002004,340,153,187,4.34
2020,CB2020,005,2,Bronx,20125002005,194,106,88,1.91
2020,CB2020,005,2,Bronx,20127011000,0,0,0,0.56
2020,CB2020,005,2,Bronx,20127011001,848,353,495,3.9
2020,CB2020,005,2,Bronx,20127011002,122,57,65,1.08
2020,CB2020,005,2,Bronx,20127011003,248,121,127,3.89
2020,CB2020,005,2,Bronx,20127011004,0,0,0,0.67
2020,CB2020,005,2,Bronx,20127012000,228,105,123,5.6
2020,CB2020,005,2,Bronx,20127012001,410,230,180,5.74
2020,CB2020,005,2,Bronx,20127012002,328,149,179,5.42
2020,CB2020,005,2,Bronx,20129011000,0,0,0,0.28
2020,CB2020,005,2,Bronx,20129011001,29,12,17,1.29
2020,CB2020,005,2,Bronx,20129011002,154,65,89,2.33
2020,CB2020,005,2,Bronx,20129011003,331,193,138,3.09
2020,CB2020,005,2,Bronx,20129011004,75,36,39,0.42
2020,CB2020,005,2,Bronx,20129011005,325,132,193,4.12
2020,CB2020,005,2,Bronx,20129011006,462,242,220,6.63
2020,CB2020,005,2,Bronx,20129011007,426,221,205,1.53
2020,CB2020,005,2,Bronx,20129012000,591,252,339,6.83
2020,CB2020,005,2,Bronx,20129012001,1067,485,582,4.88
2020,CB2020,005,2,Bronx,20129012002,517,236,281,2.73
2020,CB2020,005,2,Bronx,20129012003,946,457,489,4.54
2020,CB2020,005,2,Bronx,20130001000,51,23,28,1.1
2020,CB2020,005,2,Bronx,20130001001,119,47,72,2.41
2020,CB2020,005,2,Bronx,20130001002,241,101,140,4.55
2020,CB2020,005,2,Bronx,20130001003,286,140,146,5.88
2020,CB2020,005,2,Bronx,20130001004,0,0,0,0.75
2020,CB2020,005,2,Bronx,20130001005,113,65,48,2.2
2020,CB2020,005,2,Bronx,20130001006,59,31,28,2.75
2020,CB2020,005,2,Bronx,20130001007,32,13,19,2.27
2020,CB2020,005,2,Bronx,20130001008,93,51,42,2.49
2020,CB2020,005,2,Bronx,20130001009,204,99,105,4.31
2020,CB2020,005,2,Bronx,20131001000,468,225,243,6.91
2020,CB2020,005,2,Bronx,20131001001,419,186,233,2.84
2020,CB2020,005,2,Bronx,20131001002,346,150,196,4.28
2020,CB2020,005,2,Bronx,20131001003,211,102,109,1.67
2020,CB2020,005,2,Bronx,20131001004,0,0,0,0.35
2020,CB2020,005,2,Bronx,20131002000,628,267,361,4.35
2020,CB2020,005,2,Bronx,20131002001,230,92,138,4.93
2020,CB2020,005,2,Bronx,20131002002,292,129,163,2.62
2020,CB2020,005,2,Bronx,20131002003,89,34,55,5.54
2020,CB2020,005,2,Bronx,20131003000,382,188,194,3.47
2020,CB2020,005,2,Bronx,20131003001,1110,544,566,6.54
2020,CB2020,005,2,Bronx,20131003002,0,0,0,0.78
2020,CB2020,005,2,Bronx,20131003003,0,0,0,0.38
2020,CB2020,005,2,Bronx,20131003004,212,119,93,2.43
2020,CB2020,005,2,Bronx,20131004000,495,232,263,5
2020,CB2020,005,2,Bronx,20131004001,508,238,270,4.98
2020,CB2020,005,2,Bronx,20132000001,0,0,0,0
2020,CB2020,005,2,Bronx,20132001000,277,135,142,4.67
2020,CB2020,005,2,Bronx,20132001001,223,92,131,4.53
2020,CB2020,005,2,Bronx,20132001002,308,129,179,4.58
2020,CB2020,005,2,Bronx,20132001003,337,163,174,4.6
2020,CB2020,005,2,Bronx,20132002000,110,56,54,4.92
2020,CB2020,005,2,Bronx,20132002001,129,42,87,2.35
2020,CB2020,005,2,Bronx,20132002002,90,50,40,2.37
2020,CB2020,005,2,Bronx,20132002003,125,58,67,2.41
2020,CB2020,005,2,Bronx,20132002004,78,25,53,2.41
2020,CB2020,005,2,Bronx,20132002005,125,79,46,2.39
2020,CB2020,005,2,Bronx,20132002006,260,125,135,4.49
2020,CB2020,005,2,Bronx,20132002007,63,36,27,3.09
2020,CB2020,005,2,Bronx,20132002008,62,28,34,2.44
2020,CB2020,005,2,Bronx,20132003000,198,74,124,4.13
2020,CB2020,005,2,Bronx,20132003001,208,96,112,3.29
2020,CB2020,005,2,Bronx,20132003002,181,92,89,2.6
2020,CB2020,005,2,Bronx,20132003003,108,58,50,2.94
2020,CB2020,005,2,Bronx,20132003004,138,74,64,2.67
2020,CB2020,005,2,Bronx,20132003005,139,71,68,3.32
2020,CB2020,005,2,Bronx,20132003006,158,55,103,4.12
2020,CB2020,005,2,Bronx,20132003007,0,0,0,3.05
2020,CB2020,005,2,Bronx,20132003008,90,60,30,2.4
2020,CB2020,005,2,Bronx,20132003009,23,12,11,4.63
2020,CB2020,005,2,Bronx,20132003010,44,24,20,6.84
2020,CB2020,005,2,Bronx,20132003011,165,96,69,2.47
2020,CB2020,005,2,Bronx,20132004000,84,51,33,3.75
2020,CB2020,005,2,Bronx,20132004001,135,51,84,3.67
2020,CB2020,005,2,Bronx,20132004002,194,77,117,3.81
2020,CB2020,005,2,Bronx,20132004003,152,62,90,3.99
2020,CB2020,005,2,Bronx,20132004004,157,74,83,2.64
2020,CB2020,005,2,Bronx,20132004005,125,59,66,2.64
2020,CB2020,005,2,Bronx,20132004006,218,90,128,3.01
2020,CB2020,005,2,Bronx,20132004007,187,87,100,3.75
2020,CB2020,005,2,Bronx,20132004008,195,133,62,4.54
2020,CB2020,005,2,Bronx,20132005000,148,79,69,2.58
2020,CB2020,005,2,Bronx,20132005001,109,47,62,2.57
2020,CB2020,005,2,Bronx,20132005002,176,83,93,2.79
2020,CB2020,005,2,Bronx,20132005003,319,145,174,4.89
2020,CB2020,005,2,Bronx,20132005004,106,48,58,2.43
2020,CB2020,005,2,Bronx,20132005005,167,86,81,2.69
2020,CB2020,005,2,Bronx,20132005006,118,58,60,2.3
2020,CB2020,005,2,Bronx,20132005007,84,14,70,2.14
2020,CB2020,005,2,Bronx,20132005008,142,72,70,2.41
2020,CB2020,005,2,Bronx,20132005009,98,24,74,2.38
2020,CB2020,005,2,Bronx,20132005010,99,54,45,2.64
2020,CB2020,005,2,Bronx,20133001000,2070,866,1204,12.87
2020,CB2020,005,2,Bronx,20133002000,368,199,169,2.09
2020,CB2020,005,2,Bronx,20133002001,453,241,212,3.63
2020,CB2020,005,2,Bronx,20133002002,95,35,60,0.66
2020,CB2020,005,2,Bronx,20133002003,160,87,73,4.07
2020,CB2020,005,2,Bronx,20133002004,602,263,339,5.73
2020,CB2020,005,2,Bronx,20133003000,958,388,570,4.57
2020,CB2020,005,2,Bronx,20133004000,1358,565,793,6.2
2020,CB2020,005,2,Bronx,20135001000,363,149,214,4.83
2020,CB2020,005,2,Bronx,20135001001,418,206,212,3.29
2020,CB2020,005,2,Bronx,20135001002,0,0,0,4.64
2020,CB2020,005,2,Bronx,20135002000,323,134,189,4.52
2020,CB2020,005,2,Bronx,20135002001,1428,589,839,10.66
2020,CB2020,005,2,Bronx,20135003000,635,334,301,3.15
2020,CB2020,005,2,Bronx,20135003001,0,0,0,3.41
2020,CB2020,005,2,Bronx,20135003002,611,278,333,3.52
2020,CB2020,005,2,Bronx,20135003003,223,116,107,2.49
2020,CB2020,005,2,Bronx,20135003004,0,0,0,0.86
2020,CB2020,005,2,Bronx,20138000001,0,0,0,0
2020,CB2020,005,2,Bronx,20138001000,113,43,70,7.03
2020,CB2020,005,2,Bronx,20138001001,49,13,36,1.28
2020,CB2020,005,2,Bronx,20138001002,25,9,16,0.65
2020,CB2020,005,2,Bronx,20138001003,104,54,50,2.68
2020,CB2020,005,2,Bronx,20138001004,30,14,16,0.72
2020,CB2020,005,2,Bronx,20138001005,178,107,71,20.88
2020,CB2020,005,2,Bronx,20138001006,0,0,0,12.74
2020,CB2020,005,2,Bronx,20138001007,0,0,0,8.33
2020,CB2020,005,2,Bronx,20138001008,0,0,0,1.12
2020,CB2020,005,2,Bronx,20138001009,0,0,0,11.09
2020,CB2020,005,2,Bronx,20138001010,0,0,0,7.06
2020,CB2020,005,2,Bronx,20138001011,0,0,0,3.26
2020,CB2020,005,2,Bronx,20138001012,0,0,0,4.58
2020,CB2020,005,2,Bronx,20138001013,0,0,0,0.17
2020,CB2020,005,2,Bronx,20138001014,153,77,76,8.86
2020,CB2020,005,2,Bronx,20138001015,0,0,0,1.87
2020,CB2020,005,2,Bronx,20138001016,34,6,28,1.91
2020,CB2020,005,2,Bronx,20138001017,11,4,7,0.33
2020,CB2020,005,2,Bronx,20138001018,47,29,18,1.52
2020,CB2020,005,2,Bronx,20138001019,42,27,15,0.98
2020,CB2020,005,2,Bronx,20138001020,57,40,17,1.26
2020,CB2020,005,2,Bronx,20138001021,81,45,36,1.41
2020,CB2020,005,2,Bronx,20138001022,17,3,14,0.27
2020,CB2020,005,2,Bronx,20138001023,54,19,35,1.34
2020,CB2020,005,2,Bronx,20138001024,86,40,46,2.29
2020,CB2020,005,2,Bronx,20138001025,92,32,60,2.42
2020,CB2020,005,2,Bronx,20138001026,63,34,29,1.89
2020,CB2020,005,2,Bronx,20138001027,79,24,55,1.34
2020,CB2020,005,2,Bronx,20138001028,296,144,152,6.6
2020,CB2020,005,2,Bronx,20138001029,73,36,37,1.37
2020,CB2020,005,2,Bronx,20138001030,83,41,42,1.58
2020,CB2020,005,2,Bronx,20138001031,20,18,2,0.35
2020,CB2020,005,2,Bronx,20138001032,0,0,0,0.28
2020,CB2020,005,2,Bronx,20138001033,0,0,0,3.12
2020,CB2020,005,2,Bronx,20138001034,0,0,0,13.92
2020,CB2020,005,2,Bronx,20138001035,0,0,0,1.47
2020,CB2020,005,2,Bronx,20138001036,0,0,0,5.23
2020,CB2020,005,2,Bronx,20138001037,19,6,13,2.07
2020,CB2020,005,2,Bronx,20138001038,0,0,0,4.34
2020,CB2020,005,2,Bronx,20138001039,56,32,24,0.9
2020,CB2020,005,2,Bronx,20138002000,475,225,250,12.05
2020,CB2020,005,2,Bronx,20138002001,137,64,73,3.83
2020,CB2020,005,2,Bronx,20138002002,27,19,8,0.68
2020,CB2020,005,2,Bronx,20138002003,53,20,33,1.92
2020,CB2020,005,2,Bronx,20138002004,82,41,41,2.18
2020,CB2020,005,2,Bronx,20138002005,0,0,0,0.62
2020,CB2020,005,2,Bronx,20138002006,0,0,0,5.93
2020,CB2020,005,2,Bronx,20138002007,0,0,0,0.14
2020,CB2020,005,2,Bronx,20138002008,176,82,94,4.61
2020,CB2020,005,2,Bronx,20138002009,120,54,66,3.72
2020,CB2020,005,2,Bronx,20138002010,128,69,59,2.32
2020,CB2020,005,2,Bronx,20138002011,0,0,0,0.61
2020,CB2020,005,2,Bronx,20141001000,260,105,155,4.16
2020,CB2020,005,2,Bronx,20141001001,717,345,372,3.18
2020,CB2020,005,2,Bronx,20141001002,723,316,407,2.45
2020,CB2020,005,2,Bronx,20141001003,348,153,195,2.28
2020,CB2020,005,2,Bronx,20141001004,0,0,0,1.75
2020,CB2020,005,2,Bronx,20141002000,480,233,247,2.52
2020,CB2020,005,2,Bronx,20141002001,192,102,90,2.18
2020,CB2020,005,2,Bronx,20141002002,1709,713,996,4.95
2020,CB2020,005,2,Bronx,20141002003,0,0,0,0.27
2020,CB2020,005,2,Bronx,20141002004,0,0,0,0.44
2020,CB2020,005,2,Bronx,20141002005,0,0,0,1.3
2020,CB2020,005,2,Bronx,20141003000,235,106,129,2.31
2020,CB2020,005,2,Bronx,20141003001,83,41,42,1.72
2020,CB2020,005,2,Bronx,20141003002,700,293,407,2.75
2020,CB2020,005,2,Bronx,20141003003,497,245,252,2.79
2020,CB2020,005,2,Bronx,20141003004,453,192,261,1.15
2020,CB2020,005,2,Bronx,20141003005,91,47,44,2.78
2020,CB2020,005,2,Bronx,20141003006,313,131,182,2.93
2020,CB2020,005,2,Bronx,20141003007,543,313,230,1.87
2020,CB2020,005,2,Bronx,20143001000,0,0,0,3.51
2020,CB2020,005,2,Bronx,20143001001,0,0,0,2.33
2020,CB2020,005,2,Bronx,20143001002,420,195,225,3.77
2020,CB2020,005,2,Bronx,20143001003,391,221,170,2.82
2020,CB2020,005,2,Bronx,20143001004,0,0,0,0.46
2020,CB2020,005,2,Bronx,20143001005,0,0,0,1.63
2020,CB2020,005,2,Bronx,20143001006,0,0,0,0.63
2020,CB2020,005,2,Bronx,20143001007,137,81,56,5.96
2020,CB2020,005,2,Bronx,20143001008,86,48,38,7.81
2020,CB2020,005,2,Bronx,20143001009,139,108,31,1.33
2020,CB2020,005,2,Bronx,20143001010,725,334,391,1.81
2020,CB2020,005,2,Bronx,20144001000,298,116,182,7.04
2020,CB2020,005,2,Bronx,20144002000,0,0,0,0.76
2020,CB2020,005,2,Bronx,20144002001,0,0,0,1.49
2020,CB2020,005,2,Bronx,20144002002,886,361,525,14.66
2020,CB2020,005,2,Bronx,20144003000,661,286,375,12.03
2020,CB2020,005,2,Bronx,20144004000,1071,436,635,11.99
2020,CB2020,005,2,Bronx,20144005000,1089,462,627,13.51
2020,CB2020,005,2,Bronx,20144005001,271,139,132,4.16
2020,CB2020,005,2,Bronx,20144005002,253,132,121,4.04
2020,CB2020,005,2,Bronx,20144005003,413,189,224,4.11
2020,CB2020,005,2,Bronx,20144006000,0,0,0,1.23
2020,CB2020,005,2,Bronx,20144006001,0,0,0,1.99
2020,CB2020,005,2,Bronx,20144006002,0,0,0,0.51
2020,CB2020,005,2,Bronx,20144006003,235,123,112,3.31
2020,CB2020,005,2,Bronx,20144006004,287,128,159,4.39
2020,CB2020,005,2,Bronx,20144006005,138,59,79,4.6
2020,CB2020,005,2,Bronx,20144006006,0,0,0,0.31
2020,CB2020,005,2,Bronx,20144006007,177,78,99,4.48
2020,CB2020,005,2,Bronx,20144006008,267,125,142,4.55
2020,CB2020,005,2,Bronx,20145001000,1276,603,673,6.59
2020,CB2020,005,2,Bronx,20145001001,1231,510,721,5.09
2020,CB2020,005,2,Bronx,20145002000,1694,698,996,7.19
2020,CB2020,005,2,Bronx,20145003000,545,309,236,4.3
2020,CB2020,005,2,Bronx,20145003001,618,274,344,5.33
2020,CB2020,005,2,Bronx,20145004000,1139,493,646,4.59
2020,CB2020,005,2,Bronx,20145004001,344,198,146,5.18
2020,CB2020,005,2,Bronx,20145004002,129,54,75,3.17
2020,CB2020,005,2,Bronx,20145004003,79,34,45,3.51
2020,CB2020,005,2,Bronx,20147011000,2301,997,1304,10.19
2020,CB2020,005,2,Bronx,20147012000,762,363,399,10.45
2020,CB2020,005,2,Bronx,20147012001,1613,699,914,6.3
2020,CB2020,005,2,Bronx,20147013000,1685,697,988,7.28
2020,CB2020,005,2,Bronx,20147021000,943,380,563,4.74
2020,CB2020,005,2,Bronx,20147022000,291,139,152,1.03
2020,CB2020,005,2,Bronx,20147022001,681,290,391,3.89
2020,CB2020,005,2,Bronx,20147022002,381,175,206,2.71
2020,CB2020,005,2,Bronx,20147022003,0,0,0,2.58
2020,CB2020,005,2,Bronx,20147022004,328,159,169,4.08
2020,CB2020,005,2,Bronx,20147023000,826,365,461,3.25
2020,CB2020,005,2,Bronx,20147024000,1631,716,915,6.46
2020,CB2020,005,2,Bronx,20149001000,222,101,121,2.64
2020,CB2020,005,2,Bronx,20149001001,419,188,231,3.83
2020,CB2020,005,2,Bronx,20149001002,1090,540,550,10.93
2020,CB2020,005,2,Bronx,20149002000,521,234,287,2
2020,CB2020,005,2,Bronx,20149002001,822,382,440,6.28
2020,CB2020,005,2,Bronx,20149003000,0,0,0,0.32
2020,CB2020,005,2,Bronx,20149003001,1021,479,542,6.88
2020,CB2020,005,2,Bronx,20149003002,628,335,293,5.66
2020,CB2020,005,2,Bronx,20151001000,442,244,198,3.3
2020,CB2020,005,2,Bronx,20151001001,126,66,60,1.41
2020,CB2020,005,2,Bronx,20151001002,180,92,88,2.32
2020,CB2020,005,2,Bronx,20151001003,221,88,133,1.33
2020,CB2020,005,2,Bronx,20151002000,435,239,196,2.84
2020,CB2020,005,2,Bronx,20151002001,503,242,261,2.55
2020,CB2020,005,2,Bronx,20151002002,0,0,0,4.19
2020,CB2020,005,2,Bronx,20151002003,372,170,202,2.33
2020,CB2020,005,2,Bronx,20151002004,379,170,209,1.73
2020,CB2020,005,2,Bronx,20151003000,485,263,222,5.24
2020,CB2020,005,2,Bronx,20151003001,310,172,138,2.78
2020,CB2020,005,2,Bronx,20151003002,107,50,57,0.85
2020,CB2020,005,2,Bronx,20151003003,952,454,498,5.76
2020,CB2020,005,2,Bronx,20151004000,358,162,196,2.51
2020,CB2020,005,2,Bronx,20151004001,266,135,131,3.45
2020,CB2020,005,2,Bronx,20151004002,321,156,165,3.77
2020,CB2020,005,2,Bronx,20151004003,175,64,111,2.75
2020,CB2020,005,2,Bronx,20151004004,189,76,113,1.42
2020,CB2020,005,2,Bronx,20151004005,136,79,57,1.09
2020,CB2020,005,2,Bronx,20152001000,227,114,113,4.83
2020,CB2020,005,2,Bronx,20152001001,223,114,109,4.84
2020,CB2020,005,2,Bronx,20152001002,125,78,47,8.28
2020,CB2020,005,2,Bronx,20152001003,0,0,0,4.56
2020,CB2020,005,2,Bronx,20152001004,125,36,89,2.6
2020,CB2020,005,2,Bronx,20152001005,307,133,174,4.5
2020,CB2020,005,2,Bronx,20152002000,190,72,118,6.05
2020,CB2020,005,2,Bronx,20152002001,228,95,133,4.85
2020,CB2020,005,2,Bronx,20152002002,332,175,157,4.71
2020,CB2020,005,2,Bronx,20152002003,196,119,77,4.45
2020,CB2020,005,2,Bronx,20152002004,127,67,60,2.84
2020,CB2020,005,2,Bronx,20152002005,113,54,59,2.47
2020,CB2020,005,2,Bronx,20152002006,114,65,49,1.9
2020,CB2020,005,2,Bronx,20152002007,88,58,30,3.18
2020,CB2020,005,2,Bronx,20152002008,133,62,71,3.23
2020,CB2020,005,2,Bronx,20152002009,0,0,0,4.17
2020,CB2020,005,2,Bronx,20152002010,65,17,48,2.8
2020,CB2020,005,2,Bronx,20153001000,37,30,7,3.76
2020,CB2020,005,2,Bronx,20153001001,127,49,78,4.18
2020,CB2020,005,2,Bronx,20153001002,123,58,65,1.55
2020,CB2020,005,2,Bronx,20153001003,48,24,24,3.6
2020,CB2020,005,2,Bronx,20153001004,143,49,94,5.13
2020,CB2020,005,2,Bronx,20153001005,153,85,68,3.05
2020,CB2020,005,2,Bronx,20153001006,463,210,253,6.09
2020,CB2020,005,2,Bronx,20153001007,503,252,251,2.32
2020,CB2020,005,2,Bronx,20153001008,79,37,42,0.74
2020,CB2020,005,2,Bronx,20153001009,231,115,116,1.12
2020,CB2020,005,2,Bronx,20153001010,44,23,21,2.56
2020,CB2020,005,2,Bronx,20153001011,60,39,21,3.01
2020,CB2020,005,2,Bronx,20153002000,449,239,210,2.32
2020,CB2020,005,2,Bronx,20153002001,386,176,210,3.83
2020,CB2020,005,2,Bronx,20153003000,386,185,201,7.81
2020,CB2020,005,2,Bronx,20153003001,473,253,220,3.32
2020,CB2020,005,2,Bronx,20153003002,553,242,311,4.15
2020,CB2020,005,2,Bronx,20155001000,1899,871,1028,7.82
2020,CB2020,005,2,Bronx,20155002000,375,179,196,2.25
2020,CB2020,005,2,Bronx,20155002001,180,105,75,4.5
2020,CB2020,005,2,Bronx,20155002002,32,19,13,3.29
2020,CB2020,005,2,Bronx,20155002003,91,47,44,2.88
2020,CB2020,005,2,Bronx,20155002004,53,22,31,3.45
2020,CB2020,005,2,Bronx,20155002005,261,97,164,4.23
2020,CB2020,005,2,Bronx,20157001000,0,0,0,11.89
2020,CB2020,005,2,Bronx,20157001001,0,0,0,15.26
2020,CB2020,005,2,Bronx,20157001002,0,0,0,2.09
2020,CB2020,005,2,Bronx,20157002000,0,0,0,1.96
2020,CB2020,005,2,Bronx,20157002001,726,283,443,3.64
2020,CB2020,005,2,Bronx,20157002002,221,83,138,3.98
2020,CB2020,005,2,Bronx,20157002003,478,227,251,3.95
2020,CB2020,005,2,Bronx,20157002004,557,272,285,3.93
2020,CB2020,005,2,Bronx,20157003000,0,0,0,0.88
2020,CB2020,005,2,Bronx,20157003001,572,265,307,3.03
2020,CB2020,005,2,Bronx,20157003002,260,95,165,2.13
2020,CB2020,005,2,Bronx,20157003003,410,229,181,3.94
2020,CB2020,005,2,Bronx,20157003004,742,381,361,3.94
2020,CB2020,005,2,Bronx,20157003005,0,0,0,1.83
2020,CB2020,005,2,Bronx,20157004000,424,166,258,3.94
2020,CB2020,005,2,Bronx,20157004001,121,49,72,4.25
2020,CB2020,005,2,Bronx,20157004002,362,190,172,4.26
2020,CB2020,005,2,Bronx,20157004003,669,278,391,3.93
2020,CB2020,005,2,Bronx,20158001000,0,0,0,6.62
2020,CB2020,005,2,Bronx,20158001001,306,144,162,5.02
2020,CB2020,005,2,Bronx,20158001002,212,135,77,4.73
2020,CB2020,005,2,Bronx,20158001003,108,33,75,4.52
2020,CB2020,005,2,Bronx,20158001004,123,61,62,4.11
2020,CB2020,005,2,Bronx,20158001005,117,69,48,5.59
2020,CB2020,005,2,Bronx,20158001006,386,158,228,5.65
2020,CB2020,005,2,Bronx,20158001007,190,70,120,2.46
2020,CB2020,005,2,Bronx,20158001008,0,0,0,0.88
2020,CB2020,005,2,Bronx,20158001009,0,0,0,0.49
2020,CB2020,005,2,Bronx,20159001000,934,430,504,8.97
2020,CB2020,005,2,Bronx,20159001001,1036,429,607,6.76
2020,CB2020,005,2,Bronx,20159002000,243,106,137,5.61
2020,CB2020,005,2,Bronx,20159002001,268,129,139,4.27
2020,CB2020,005,2,Bronx,20160000001,0,0,0,0
2020,CB2020,005,2,Bronx,20160001000,86,28,58,4.52
2020,CB2020,005,2,Bronx,20160001001,197,65,132,9.39
2020,CB2020,005,2,Bronx,20160001002,94,37,57,3.86
2020,CB2020,005,2,Bronx,20160001003,241,114,127,4.11
2020,CB2020,005,2,Bronx,20160001004,209,109,100,4.34
2020,CB2020,005,2,Bronx,20160001005,240,107,133,4.63
2020,CB2020,005,2,Bronx,20160001006,145,75,70,4.8
2020,CB2020,005,2,Bronx,20160001007,162,69,93,4.77
2020,CB2020,005,2,Bronx,20160001008,212,127,85,4.76
2020,CB2020,005,2,Bronx,20160002000,195,118,77,2.99
2020,CB2020,005,2,Bronx,20160002001,225,89,136,3.07
2020,CB2020,005,2,Bronx,20160002002,145,71,74,2.68
2020,CB2020,005,2,Bronx,20160002003,0,0,0,3.6
2020,CB2020,005,2,Bronx,20160002004,44,11,33,0.94
2020,CB2020,005,2,Bronx,20160002005,17,7,10,1.59
2020,CB2020,005,2,Bronx,20160002006,0,0,0,4.89
2020,CB2020,005,2,Bronx,20160002007,0,0,0,2.23
2020,CB2020,005,2,Bronx,20160002008,20,16,4,4.87
2020,CB2020,005,2,Bronx,20160002009,0,0,0,3.46
2020,CB2020,005,2,Bronx,20160002010,119,59,60,2.61
2020,CB2020,005,2,Bronx,20160002011,135,69,66,2.94
2020,CB2020,005,2,Bronx,20160003000,111,65,46,5.52
2020,CB2020,005,2,Bronx,20160003001,194,91,103,4.6
2020,CB2020,005,2,Bronx,20160003002,128,66,62,4.65
2020,CB2020,005,2,Bronx,20160003003,226,95,131,4.76
2020,CB2020,005,2,Bronx,20160003004,128,70,58,4.04
2020,CB2020,005,2,Bronx,20160003005,74,49,25,2.1
2020,CB2020,005,2,Bronx,20160004000,105,47,58,2.93
2020,CB2020,005,2,Bronx,20160004001,122,77,45,3.01
2020,CB2020,005,2,Bronx,20160004002,127,56,71,3.04
2020,CB2020,005,2,Bronx,20160004003,101,49,52,2.49
2020,CB2020,005,2,Bronx,20160004004,111,58,53,2.28
2020,CB2020,005,2,Bronx,20160004005,90,32,58,1.73
2020,CB2020,005,2,Bronx,20161001000,0,0,0,0.19
2020,CB2020,005,2,Bronx,20161001001,0,0,0,0.51
2020,CB2020,005,2,Bronx,20161001002,37,9,28,0.91
2020,CB2020,005,2,Bronx,20161001003,217,100,117,10.48
2020,CB2020,005,2,Bronx,20161001004,603,277,326,5.63
2020,CB2020,005,2,Bronx,20161001005,322,176,146,4.65
2020,CB2020,005,2,Bronx,20161001006,189,94,95,2.06
2020,CB2020,005,2,Bronx,20161001007,0,0,0,0.8
2020,CB2020,005,2,Bronx,20161001008,159,50,109,3.31
2020,CB2020,005,2,Bronx,20161001009,185,81,104,1.75
2020,CB2020,005,2,Bronx,20161001010,92,64,28,3.78
2020,CB2020,005,2,Bronx,20161002000,0,0,0,4.68
2020,CB2020,005,2,Bronx,20161002001,523,233,290,4
2020,CB2020,005,2,Bronx,20161002002,511,245,266,4
2020,CB2020,005,2,Bronx,20161003000,1116,496,620,3.98
2020,CB2020,005,2,Bronx,20161004000,816,328,488,4
2020,CB2020,005,2,Bronx,20161004001,473,204,269,4.36
2020,CB2020,005,2,Bronx,20162001000,369,147,222,5.21
2020,CB2020,005,2,Bronx,20162001001,255,123,132,5.23
2020,CB2020,005,2,Bronx,20162001002,177,89,88,4.78
2020,CB2020,005,2,Bronx,20162001003,206,103,103,6.1
2020,CB2020,005,2,Bronx,20162002000,267,148,119,5.36
2020,CB2020,005,2,Bronx,20162002001,193,107,86,5.36
2020,CB2020,005,2,Bronx,20162002002,163,71,92,4.87
2020,CB2020,005,2,Bronx,20162002003,104,37,67,2.78
2020,CB2020,005,2,Bronx,20162002004,73,29,44,2.47
2020,CB2020,005,2,Bronx,20162002005,101,37,64,2.48
2020,CB2020,005,2,Bronx,20163001000,0,0,0,4.82
2020,CB2020,005,2,Bronx,20163001001,34,17,17,73.96
2020,CB2020,005,2,Bronx,20163001002,0,0,0,42.62
2020,CB2020,005,2,Bronx,20163001003,0,0,0,14.61
2020,CB2020,005,2,Bronx,20163001004,0,0,0,8.8
2020,CB2020,005,2,Bronx,20164001000,153,72,81,4
2020,CB2020,005,2,Bronx,20164001001,162,87,75,3.9
2020,CB2020,005,2,Bronx,20164001002,45,24,21,1.86
2020,CB2020,005,2,Bronx,20164001003,9,7,2,1.54
2020,CB2020,005,2,Bronx,20164001004,107,41,66,2.7
2020,CB2020,005,2,Bronx,20164001005,102,54,48,3.06
2020,CB2020,005,2,Bronx,20164001006,80,35,45,3.53
2020,CB2020,005,2,Bronx,20164001007,88,29,59,3.46
2020,CB2020,005,2,Bronx,20164001008,142,61,81,3.79
2020,CB2020,005,2,Bronx,20164001009,107,31,76,3.81
2020,CB2020,005,2,Bronx,20164001010,75,43,32,3.11
2020,CB2020,005,2,Bronx,20164001011,78,43,35,2.68
2020,CB2020,005,2,Bronx,20164001012,73,47,26,3.24
2020,CB2020,005,2,Bronx,20165001000,0,0,0,0.83
2020,CB2020,005,2,Bronx,20165001001,0,0,0,0.38
2020,CB2020,005,2,Bronx,20165001002,0,0,0,0.38
2020,CB2020,005,2,Bronx,20165001003,0,0,0,0.42
2020,CB2020,005,2,Bronx,20165001004,0,0,0,0.53
2020,CB2020,005,2,Bronx,20165001005,0,0,0,0.72
2020,CB2020,005,2,Bronx,20165001006,0,0,0,1.3
2020,CB2020,005,2,Bronx,20165001007,0,0,0,0.26
2020,CB2020,005,2,Bronx,20165001008,0,0,0,0.26
2020,CB2020,005,2,Bronx,20165001009,77,45,32,3.4
2020,CB2020,005,2,Bronx,20165001010,0,0,0,1.72
2020,CB2020,005,2,Bronx,20165001011,0,0,0,1.47
2020,CB2020,005,2,Bronx,20165001012,47,21,26,3.89
2020,CB2020,005,2,Bronx,20165001013,0,0,0,2.03
2020,CB2020,005,2,Bronx,20165001014,46,21,25,1.51
2020,CB2020,005,2,Bronx,20165001015,279,132,147,1.34
2020,CB2020,005,2,Bronx,20165001016,0,0,0,3.64
2020,CB2020,005,2,Bronx,20165001017,0,0,0,3.06
2020,CB2020,005,2,Bronx,20165001018,0,0,0,3.66
2020,CB2020,005,2,Bronx,20165001019,173,87,86,4.45
2020,CB2020,005,2,Bronx,20165001020,0,0,0,2.59
2020,CB2020,005,2,Bronx,20165001021,475,209,266,3.65
2020,CB2020,005,2,Bronx,20165001022,0,0,0,3.35
2020,CB2020,005,2,Bronx,20165001023,0,0,0,3.81
2020,CB2020,005,2,Bronx,20166001000,109,60,49,5.36
2020,CB2020,005,2,Bronx,20166001001,448,190,258,4.8
2020,CB2020,005,2,Bronx,20166001002,270,137,133,4.62
2020,CB2020,005,2,Bronx,20166001003,182,72,110,4.44
2020,CB2020,005,2,Bronx,20166001004,172,88,84,4.27
2020,CB2020,005,2,Bronx,20166001005,152,87,65,3.52
2020,CB2020,005,2,Bronx,20166001006,133,60,73,3.52
2020,CB2020,005,2,Bronx,20166001007,97,41,56,3.95
2020,CB2020,005,2,Bronx,20166001008,122,62,60,3.53
2020,CB2020,005,2,Bronx,20166002000,214,90,124,4.11
2020,CB2020,005,2,Bronx,20166002001,207,98,109,4.59
2020,CB2020,005,2,Bronx,20166002002,0,0,0,9.93
2020,CB2020,005,2,Bronx,20166002003,169,70,99,3.56
2020,CB2020,005,2,Bronx,20166002004,117,62,55,3.51
2020,CB2020,005,2,Bronx,20166002005,0,0,0,2.81
2020,CB2020,005,2,Bronx,20166002006,0,0,0,0.51
2020,CB2020,005,2,Bronx,20166002007,233,117,116,3.57
2020,CB2020,005,2,Bronx,20167001000,670,315,355,5.2
2020,CB2020,005,2,Bronx,20167001001,263,118,145,2.92
2020,CB2020,005,2,Bronx,20167002000,345,164,181,14.02
2020,CB2020,005,2,Bronx,20167002001,237,95,142,2.71
2020,CB2020,005,2,Bronx,20167002002,0,0,0,0.31
2020,CB2020,005,2,Bronx,20167002003,0,0,0,2.71
2020,CB2020,005,2,Bronx,20167002004,97,61,36,4.39
2020,CB2020,005,2,Bronx,20167002005,38,24,14,4.35
2020,CB2020,005,2,Bronx,20167002006,0,0,0,3.56
2020,CB2020,005,2,Bronx,20167002007,0,0,0,3.3
2020,CB2020,005,2,Bronx,20167002008,1640,744,896,3.65
2020,CB2020,005,2,Bronx,20167002009,83,45,38,3.74
2020,CB2020,005,2,Bronx,20169001000,162,90,72,3.98
2020,CB2020,005,2,Bronx,20169001001,210,80,130,2.44
2020,CB2020,005,2,Bronx,20169001002,37,10,27,2.67
2020,CB2020,005,2,Bronx,20169001003,339,168,171,4.7
2020,CB2020,005,2,Bronx,20169001004,190,98,92,4.07
2020,CB2020,005,2,Bronx,20169001005,370,199,171,2.08
2020,CB2020,005,2,Bronx,20169001006,278,133,145,3.02
2020,CB2020,005,2,Bronx,20171001000,10,4,6,42.52
2020,CB2020,005,2,Bronx,20171001001,0,0,0,0.62
2020,CB2020,005,2,Bronx,20173001000,55,32,23,3.38
2020,CB2020,005,2,Bronx,20173001001,141,59,82,1.87
2020,CB2020,005,2,Bronx,20173001002,446,226,220,2.18
2020,CB2020,005,2,Bronx,20173001003,260,123,137,2.13
2020,CB2020,005,2,Bronx,20173001004,348,159,189,2.52
2020,CB2020,005,2,Bronx,20173002000,450,230,220,2.59
2020,CB2020,005,2,Bronx,20173002001,521,260,261,3.86
2020,CB2020,005,2,Bronx,20173003000,0,0,0,0.95
2020,CB2020,005,2,Bronx,20173003001,945,455,490,4.45
2020,CB2020,005,2,Bronx,20173003002,988,477,511,5.51
2020,CB2020,005,2,Bronx,20173004000,1080,498,582,1.35
2020,CB2020,005,2,Bronx,20173004001,560,233,327,7.08
2020,CB2020,005,2,Bronx,20173004002,601,238,363,2.96
2020,CB2020,005,2,Bronx,20175001000,682,311,371,3.09
2020,CB2020,005,2,Bronx,20175001001,758,387,371,2.92
2020,CB2020,005,2,Bronx,20175002000,498,223,275,2.94
2020,CB2020,005,2,Bronx,20175002001,522,244,278,2.91
2020,CB2020,005,2,Bronx,20175003000,369,165,204,5.55
2020,CB2020,005,2,Bronx,20175003001,886,439,447,3.83
2020,CB2020,005,2,Bronx,20175004000,207,114,93,4.56
2020,CB2020,005,2,Bronx,20175004001,979,497,482,3.67
2020,CB2020,005,2,Bronx,20175004002,451,230,221,1.81
2020,CB2020,005,2,Bronx,20175005000,756,332,424,2.91
2020,CB2020,005,2,Bronx,20175006000,880,408,472,3.26
2020,CB2020,005,2,Bronx,20177011000,250,165,85,3.82
2020,CB2020,005,2,Bronx,20177011001,602,254,348,3.82
2020,CB2020,005,2,Bronx,20177011002,882,439,443,3.75
2020,CB2020,005,2,Bronx,20177012000,1084,477,607,3.95
2020,CB2020,005,2,Bronx,20177013000,770,383,387,3.41
2020,CB2020,005,2,Bronx,20177013001,715,389,326,3.82
2020,CB2020,005,2,Bronx,20177013002,451,231,220,3.78
2020,CB2020,005,2,Bronx,20177021000,879,443,436,5.64
2020,CB2020,005,2,Bronx,20177022000,88,42,46,1.11
2020,CB2020,005,2,Bronx,20177022001,1212,564,648,10.65
2020,CB2020,005,2,Bronx,20177023000,534,278,256,5.4
2020,CB2020,005,2,Bronx,20177023001,1037,523,514,6.11
2020,CB2020,005,2,Bronx,20177024000,1229,563,666,5.91
2020,CB2020,005,2,Bronx,20179011000,885,403,482,4.97
2020,CB2020,005,2,Bronx,20179011001,1763,846,917,5.41
2020,CB2020,005,2,Bronx,20179012000,579,267,312,1.72
2020,CB2020,005,2,Bronx,20179012001,0,0,0,0.28
2020,CB2020,005,2,Bronx,20179013000,673,324,349,2.36
2020,CB2020,005,2,Bronx,20179013001,1224,586,638,3.67
2020,CB2020,005,2,Bronx,20179013002,0,0,0,0.57
2020,CB2020,005,2,Bronx,20179021000,479,220,259,6.4
2020,CB2020,005,2,Bronx,20179021001,908,445,463,5.12
2020,CB2020,005,2,Bronx,20179022000,1095,518,577,3.16
2020,CB2020,005,2,Bronx,20179022001,0,0,0,0.6
2020,CB2020,005,2,Bronx,20179023000,0,0,0,0.28
2020,CB2020,005,2,Bronx,20179023001,0,0,0,0.7
2020,CB2020,005,2,Bronx,20179023002,965,438,527,2.9
2020,CB2020,005,2,Bronx,20181011000,323,182,141,2.93
2020,CB2020,005,2,Bronx,20181011001,485,230,255,2.83
2020,CB2020,005,2,Bronx,20181011002,565,284,281,2.75
2020,CB2020,005,2,Bronx,20181011003,305,160,145,3.03
2020,CB2020,005,2,Bronx,20181012000,861,408,453,3.86
2020,CB2020,005,2,Bronx,20181013000,760,368,392,3.69
2020,CB2020,005,2,Bronx,20181021000,28,20,8,2.83
2020,CB2020,005,2,Bronx,20181021001,772,386,386,2.07
2020,CB2020,005,2,Bronx,20181021002,204,105,99,2.29
2020,CB2020,005,2,Bronx,20181021003,0,0,0,0.52
2020,CB2020,005,2,Bronx,20181022000,835,410,425,2.64
2020,CB2020,005,2,Bronx,20181022001,740,359,381,1.84
2020,CB2020,005,2,Bronx,20181022002,229,122,107,2.29
2020,CB2020,005,2,Bronx,20181022003,0,0,0,0.42
2020,CB2020,005,2,Bronx,20181023000,1196,595,601,3.53
2020,CB2020,005,2,Bronx,20181024000,1506,734,772,4.74
2020,CB2020,005,2,Bronx,20181024001,0,0,0,0.64
2020,CB2020,005,2,Bronx,20183011000,1073,505,568,3.41
2020,CB2020,005,2,Bronx,20183011001,0,0,0,0.31
2020,CB2020,005,2,Bronx,20183011002,0,0,0,0.28
2020,CB2020,005,2,Bronx,20183011003,559,244,315,2.79
2020,CB2020,005,2,Bronx,20183011004,0,0,0,0.39
2020,CB2020,005,2,Bronx,20183012000,494,229,265,1.29
2020,CB2020,005,2,Bronx,20183012001,669,328,341,2.71
2020,CB2020,005,2,Bronx,20183012002,0,0,0,0.29
2020,CB2020,005,2,Bronx,20183013000,0,0,0,0.55
2020,CB2020,005,2,Bronx,20183013001,612,314,298,1.52
2020,CB2020,005,2,Bronx,20183013002,1016,443,573,2.83
2020,CB2020,005,2,Bronx,20183013003,0,0,0,0.41
2020,CB2020,005,2,Bronx,20183021000,967,462,505,3.29
2020,CB2020,005,2,Bronx,20183021001,524,266,258,4
2020,CB2020,005,2,Bronx,20183022000,5,2,3,2.99
2020,CB2020,005,2,Bronx,20183022001,887,407,480,2.95
2020,CB2020,005,2,Bronx,20183022002,0,0,0,6.32
2020,CB2020,005,2,Bronx,20183022003,42,20,22,1.87
2020,CB2020,005,2,Bronx,20183023000,281,135,146,2.27
2020,CB2020,005,2,Bronx,20183023001,437,196,241,2.13
2020,CB2020,005,2,Bronx,20183023002,543,268,275,1.93
2020,CB2020,005,2,Bronx,20184001000,106,39,67,3.06
2020,CB2020,005,2,Bronx,20184001001,161,90,71,2.68
2020,CB2020,005,2,Bronx,20184001002,150,80,70,2.45
2020,CB2020,005,2,Bronx,20184001003,128,68,60,2.27
2020,CB2020,005,2,Bronx,20184001004,159,88,71,3.06
2020,CB2020,005,2,Bronx,20184001005,155,50,105,3.84
2020,CB2020,005,2,Bronx,20184001006,117,41,76,2.66
2020,CB2020,005,2,Bronx,20184002000,78,26,52,2.68
2020,CB2020,005,2,Bronx,20184002001,158,71,87,4.17
2020,CB2020,005,2,Bronx,20184002002,254,139,115,5.07
2020,CB2020,005,2,Bronx,20184002003,156,94,62,3.18
2020,CB2020,005,2,Bronx,20184002004,191,125,66,4.48
2020,CB2020,005,2,Bronx,20184002005,276,97,179,6.02
2020,CB2020,005,2,Bronx,20184002006,118,33,85,6.43
2020,CB2020,005,2,Bronx,20184002007,0,0,0,1.29
2020,CB2020,005,2,Bronx,20184002008,0,0,0,0.64
2020,CB2020,005,2,Bronx,20184002009,0,0,0,0.79
2020,CB2020,005,2,Bronx,20184002010,0,0,0,0.67
2020,CB2020,005,2,Bronx,20184003000,117,65,52,1.95
2020,CB2020,005,2,Bronx,20184003001,335,151,184,5.98
2020,CB2020,005,2,Bronx,20184003002,134,70,64,5.08
2020,CB2020,005,2,Bronx,20184003003,71,35,36,3.36
2020,CB2020,005,2,Bronx,20184003004,154,60,94,4.33
2020,CB2020,005,2,Bronx,20184003005,126,65,61,3.2
2020,CB2020,005,2,Bronx,20184003006,86,35,51,2.07
2020,CB2020,005,2,Bronx,20184003007,20,15,5,1.75
2020,CB2020,005,2,Bronx,20184004000,132,58,74,2.32
2020,CB2020,005,2,Bronx,20184004001,94,53,41,2.19
2020,CB2020,005,2,Bronx,20184004002,175,102,73,3.8
2020,CB2020,005,2,Bronx,20184004003,109,44,65,3.15
2020,CB2020,005,2,Bronx,20184004004,72,20,52,2.57
2020,CB2020,005,2,Bronx,20184004005,136,61,75,2.62
2020,CB2020,005,2,Bronx,20184004006,107,64,43,2.74
2020,CB2020,005,2,Bronx,20184004007,0,0,0,2.91
2020,CB2020,005,2,Bronx,20184004008,106,44,62,2.35
2020,CB2020,005,2,Bronx,20184004009,148,81,67,2.75
2020,CB2020,005,2,Bronx,20185011000,589,256,333,5.51
2020,CB2020,005,2,Bronx,20185011001,102,64,38,2.44
2020,CB2020,005,2,Bronx,20185011002,149,62,87,3.86
2020,CB2020,005,2,Bronx,20185011003,281,136,145,6.93
2020,CB2020,005,2,Bronx,20185011004,386,184,202,6.69
2020,CB2020,005,2,Bronx,20185011005,521,252,269,2.06
2020,CB2020,005,2,Bronx,20185011006,466,225,241,4.94
2020,CB2020,005,2,Bronx,20185011007,344,235,109,2.98
2020,CB2020,005,2,Bronx,20185011008,225,83,142,5.79
2020,CB2020,005,2,Bronx,20185011009,13,10,3,4.28
2020,CB2020,005,2,Bronx,20185021000,1184,624,560,6.58
2020,CB2020,005,2,Bronx,20185021001,234,96,138,3.28
2020,CB2020,005,2,Bronx,20185022000,677,262,415,4.35
2020,CB2020,005,2,Bronx,20185022001,0,0,0,1
2020,CB2020,005,2,Bronx,20185022002,69,40,29,2.58
2020,CB2020,005,2,Bronx,20185022003,211,93,118,2.06
2020,CB2020,005,2,Bronx,20185022004,1379,823,556,7.11
2020,CB2020,005,2,Bronx,20185022005,168,71,97,1.78
2020,CB2020,005,2,Bronx,20185023000,250,114,136,1.88
2020,CB2020,005,2,Bronx,20185023001,437,193,244,2.4
2020,CB2020,005,2,Bronx,20185023002,586,254,332,5.86
2020,CB2020,005,2,Bronx,20185024000,741,384,357,4.04
2020,CB2020,005,2,Bronx,20185024001,187,67,120,5.06
2020,CB2020,005,2,Bronx,20185024002,29,10,19,4.13
2020,CB2020,005,2,Bronx,20185024003,290,153,137,4.13
2020,CB2020,005,2,Bronx,20189001000,757,363,394,7.14
2020,CB2020,005,2,Bronx,20189001001,534,221,313,1.66
2020,CB2020,005,2,Bronx,20189001002,0,0,0,2.69
2020,CB2020,005,2,Bronx,20189001003,0,0,0,2.67
2020,CB2020,005,2,Bronx,20189001004,0,0,0,9.65
2020,CB2020,005,2,Bronx,20189001005,11,8,3,12.2
2020,CB2020,005,2,Bronx,20189001006,0,0,0,1.14
2020,CB2020,005,2,Bronx,20189001007,0,0,0,2.38
2020,CB2020,005,2,Bronx,20189001008,502,250,252,2.37
2020,CB2020,005,2,Bronx,20189001009,0,0,0,1.72
2020,CB2020,005,2,Bronx,20189001010,0,0,0,0.61
2020,CB2020,005,2,Bronx,20189001011,0,0,0,2.79
2020,CB2020,005,2,Bronx,20189001012,38,20,18,4.89
2020,CB2020,005,2,Bronx,20189002000,852,417,435,3.51
2020,CB2020,005,2,Bronx,20189002001,1538,735,803,7.8
2020,CB2020,005,2,Bronx,20189003000,141,58,83,2.21
2020,CB2020,005,2,Bronx,20189003001,625,309,316,3.06
2020,CB2020,005,2,Bronx,20189003002,381,193,188,1.98
2020,CB2020,005,2,Bronx,20189003003,723,350,373,2.76
2020,CB2020,005,2,Bronx,20189003004,297,163,134,2.5
2020,CB2020,005,2,Bronx,20189004000,692,314,378,3.06
2020,CB2020,005,2,Bronx,20189004001,329,165,164,2.76
2020,CB2020,005,2,Bronx,20189004002,479,221,258,3.39
2020,CB2020,005,2,Bronx,20189004003,461,224,237,2.9
2020,CB2020,005,2,Bronx,20193001000,831,422,409,3.26
2020,CB2020,005,2,Bronx,20193001001,573,227,346,2.85
2020,CB2020,005,2,Bronx,20193001002,681,359,322,2.08
2020,CB2020,005,2,Bronx,20193002000,1661,683,978,7.16
2020,CB2020,005,2,Bronx,20193003000,0,0,0,3.59
2020,CB2020,005,2,Bronx,20193003001,0,0,0,2.51
2020,CB2020,005,2,Bronx,20193003002,0,0,0,7.02
2020,CB2020,005,2,Bronx,20193003003,0,0,0,11.74
2020,CB2020,005,2,Bronx,20193003004,1024,461,563,8.49
2020,CB2020,005,2,Bronx,20193004000,225,91,134,2.68
2020,CB2020,005,2,Bronx,20193004001,535,232,303,2.67
2020,CB2020,005,2,Bronx,20193004002,127,56,71,2.76
2020,CB2020,005,2,Bronx,20193004003,363,167,196,2.81
2020,CB2020,005,2,Bronx,20194001000,0,0,0,0.73
2020,CB2020,005,2,Bronx,20194001001,0,0,0,45.24
2020,CB2020,005,2,Bronx,20194001002,0,0,0,0.3
2020,CB2020,005,2,Bronx,20194001003,0,0,0,4.08
2020,CB2020,005,2,Bronx,20194001004,0,0,0,2.21
2020,CB2020,005,2,Bronx,20194001005,0,0,0,36.53
2020,CB2020,005,2,Bronx,20194001006,368,174,194,11.24
2020,CB2020,005,2,Bronx,20194001007,108,57,51,2.45
2020,CB2020,005,2,Bronx,20194001008,245,131,114,3.96
2020,CB2020,005,2,Bronx,20194001009,312,150,162,5.72
2020,CB2020,005,2,Bronx,20194001010,132,49,83,3.34
2020,CB2020,005,2,Bronx,20194001011,385,185,200,4.64
2020,CB2020,005,2,Bronx,20194001012,0,0,0,13.48
2020,CB2020,005,2,Bronx,20194001013,349,156,193,44.18
2020,CB2020,005,2,Bronx,20194001014,0,0,0,3.04
2020,CB2020,005,2,Bronx,20194001015,123,62,61,3.61
2020,CB2020,005,2,Bronx,20194001016,0,0,0,0.65
2020,CB2020,005,2,Bronx,20194001017,0,0,0,0.69
2020,CB2020,005,2,Bronx,20194001018,0,0,0,3.46
2020,CB2020,005,2,Bronx,20194001019,0,0,0,0.37
2020,CB2020,005,2,Bronx,20194001020,0,0,0,3.03
2020,CB2020,005,2,Bronx,20194001021,0,0,0,0.44
2020,CB2020,005,2,Bronx,20194001022,0,0,0,5.7
2020,CB2020,005,2,Bronx,20194001023,0,0,0,2.12
2020,CB2020,005,2,Bronx,20194001024,0,0,0,0.42
2020,CB2020,005,2,Bronx,20194001025,0,0,0,1.26
2020,CB2020,005,2,Bronx,20194001026,0,0,0,0.79
2020,CB2020,005,2,Bronx,20194001027,0,0,0,0.36
2020,CB2020,005,2,Bronx,20194001028,0,0,0,1.84
2020,CB2020,005,2,Bronx,20194001029,0,0,0,0.63
2020,CB2020,005,2,Bronx,20194001030,0,0,0,0.69
2020,CB2020,005,2,Bronx,20194001031,0,0,0,0.42
2020,CB2020,005,2,Bronx,20195001000,1199,578,621,5.99
2020,CB2020,005,2,Bronx,20195001001,295,133,162,3.53
2020,CB2020,005,2,Bronx,20195001002,945,437,508,3.07
2020,CB2020,005,2,Bronx,20195002000,0,0,0,0.66
2020,CB2020,005,2,Bronx,20195002001,531,248,283,1.81
2020,CB2020,005,2,Bronx,20195002002,215,107,108,1.88
2020,CB2020,005,2,Bronx,20195002003,62,35,27,7.92
2020,CB2020,005,2,Bronx,20195002004,1387,643,744,6.41
2020,CB2020,005,2,Bronx,20195002005,0,0,0,4.48
2020,CB2020,005,2,Bronx,20195002006,218,111,107,3.01
2020,CB2020,005,2,Bronx,20195002007,0,0,0,0.4
2020,CB2020,005,2,Bronx,20195002008,0,0,0,0.36
2020,CB2020,005,2,Bronx,20195002009,0,0,0,0.47
2020,CB2020,005,2,Bronx,20195002010,0,0,0,1.47
2020,CB2020,005,2,Bronx,20195003000,1844,847,997,5.25
2020,CB2020,005,2,Bronx,20195004000,0,0,0,0.68
2020,CB2020,005,2,Bronx,20195004001,36,13,23,3.5
2020,CB2020,005,2,Bronx,20195004002,777,389,388,2.86
2020,CB2020,005,2,Bronx,20195004003,0,0,0,0.58
2020,CB2020,005,2,Bronx,20197001000,0,0,0,0.78
2020,CB2020,005,2,Bronx,20197001001,662,316,346,2.19
2020,CB2020,005,2,Bronx,20197001002,1302,654,648,3.96
2020,CB2020,005,2,Bronx,20197001003,0,0,0,0.26
2020,CB2020,005,2,Bronx,20197002000,379,152,227,3.73
2020,CB2020,005,2,Bronx,20197002001,214,121,93,3.86
2020,CB2020,005,2,Bronx,20197002002,1013,450,563,3.72
2020,CB2020,005,2,Bronx,20197003000,26,10,16,2.69
2020,CB2020,005,2,Bronx,20197003001,1058,534,524,4.48
2020,CB2020,005,2,Bronx,20197003002,676,324,352,4.27
2020,CB2020,005,2,Bronx,20197004000,0,0,0,0.42
2020,CB2020,005,2,Bronx,20197004001,0,0,0,0.34
2020,CB2020,005,2,Bronx,20197004002,825,411,414,2.79
2020,CB2020,005,2,Bronx,20197005000,0,0,0,0.42
2020,CB2020,005,2,Bronx,20197005001,1058,542,516,2.67
2020,CB2020,005,2,Bronx,20199001000,883,418,465,5.74
2020,CB2020,005,2,Bronx,20199002000,1674,766,908,4.6
2020,CB2020,005,2,Bronx,20199003000,320,104,216,3.15
2020,CB2020,005,2,Bronx,20199003001,329,148,181,3.28
2020,CB2020,005,2,Bronx,20199004000,715,339,376,2.84
2020,CB2020,005,2,Bronx,20199004001,312,144,168,1.18
2020,CB2020,005,2,Bronx,20199004002,1051,478,573,4.9
2020,CB2020,005,2,Bronx,20199004003,321,146,175,3.37
2020,CB2020,005,2,Bronx,20199005000,1168,550,618,4.49
2020,CB2020,005,2,Bronx,20199006000,598,263,335,5.24
2020,CB2020,005,2,Bronx,20199006001,538,242,296,4.96
2020,CB2020,005,2,Bronx,20200001000,88,43,45,1.52
2020,CB2020,005,2,Bronx,20200001001,185,71,114,2.99
2020,CB2020,005,2,Bronx,20200001002,325,160,165,4.1
2020,CB2020,005,2,Bronx,20200001003,302,132,170,3.08
2020,CB2020,005,2,Bronx,20200001004,410,182,228,2.53
2020,CB2020,005,2,Bronx,20200002000,1402,703,699,3.41
2020,CB2020,005,2,Bronx,20200002001,831,412,419,3.32
2020,CB2020,005,2,Bronx,20200003000,0,0,0,5.64
2020,CB2020,005,2,Bronx,20200003001,0,0,0,7.06
2020,CB2020,005,2,Bronx,20200003002,17,6,11,2.27
2020,CB2020,005,2,Bronx,20200003003,0,0,0,2.07
2020,CB2020,005,2,Bronx,20200004000,24,14,10,3.16
2020,CB2020,005,2,Bronx,20200004001,227,95,132,5.15
2020,CB2020,005,2,Bronx,20200004002,60,35,25,2.78
2020,CB2020,005,2,Bronx,20200004003,159,66,93,2.68
2020,CB2020,005,2,Bronx,20200004004,54,32,22,1.32
2020,CB2020,005,2,Bronx,20200004005,215,71,144,1.03
2020,CB2020,005,2,Bronx,20200004006,125,60,65,1.77
2020,CB2020,005,2,Bronx,20200004007,264,137,127,3.55
2020,CB2020,005,2,Bronx,20200004008,161,94,67,4.02
2020,CB2020,005,2,Bronx,20200004009,0,0,0,2
2020,CB2020,005,2,Bronx,20200004010,53,26,27,2.78
2020,CB2020,005,2,Bronx,20200004011,66,39,27,2.45
2020,CB2020,005,2,Bronx,20200004012,170,76,94,3.07
2020,CB2020,005,2,Bronx,20200004013,21,9,12,0.29
2020,CB2020,005,2,Bronx,20200004014,13,9,4,2.29
2020,CB2020,005,2,Bronx,20200004015,31,14,17,2.3
2020,CB2020,005,2,Bronx,20200004016,0,0,0,1.99
2020,CB2020,005,2,Bronx,20200004017,17,4,13,1.4
2020,CB2020,005,2,Bronx,20200004018,15,9,6,2.47
2020,CB2020,005,2,Bronx,20201001000,0,0,0,0.35
2020,CB2020,005,2,Bronx,20201001001,0,0,0,0.52
2020,CB2020,005,2,Bronx,20201001002,0,0,0,0.25
2020,CB2020,005,2,Bronx,20201001003,395,210,185,3.34
2020,CB2020,005,2,Bronx,20201001004,0,0,0,4.12
2020,CB2020,005,2,Bronx,20201001005,0,0,0,4.84
2020,CB2020,005,2,Bronx,20201001006,0,0,0,0.78
2020,CB2020,005,2,Bronx,20201001007,459,227,232,14.32
2020,CB2020,005,2,Bronx,20201001008,663,263,400,2.2
2020,CB2020,005,2,Bronx,20201001009,0,0,0,1.39
2020,CB2020,005,2,Bronx,20201001010,0,0,0,0.85
2020,CB2020,005,2,Bronx,20201001011,0,0,0,0.35
2020,CB2020,005,2,Bronx,20201001012,0,0,0,1.47
2020,CB2020,005,2,Bronx,20201001013,0,0,0,0.46
2020,CB2020,005,2,Bronx,20201001014,0,0,0,1.24
2020,CB2020,005,2,Bronx,20201001015,0,0,0,5.82
2020,CB2020,005,2,Bronx,20201001016,0,0,0,4.52
2020,CB2020,005,2,Bronx,20201001017,0,0,0,5.27
2020,CB2020,005,2,Bronx,20201002000,385,173,212,2.77
2020,CB2020,005,2,Bronx,20201002001,250,117,133,1.93
2020,CB2020,005,2,Bronx,20201002002,871,409,462,3.2
2020,CB2020,005,2,Bronx,20201003000,1322,595,727,7.99
2020,CB2020,005,2,Bronx,20201003001,0,0,0,1.65
2020,CB2020,005,2,Bronx,20202001000,156,90,66,2.29
2020,CB2020,005,2,Bronx,20202001001,155,57,98,2.31
2020,CB2020,005,2,Bronx,20202001002,272,137,135,2.61
2020,CB2020,005,2,Bronx,20202001003,178,69,109,2.6
2020,CB2020,005,2,Bronx,20202001004,137,53,84,1.48
2020,CB2020,005,2,Bronx,20202001005,296,140,156,2.7
2020,CB2020,005,2,Bronx,20202002000,346,182,164,3.22
2020,CB2020,005,2,Bronx,20202002001,214,119,95,3.58
2020,CB2020,005,2,Bronx,20202002002,96,39,57,3.21
2020,CB2020,005,2,Bronx,20202002003,240,114,126,2.74
2020,CB2020,005,2,Bronx,20202002004,233,132,101,0.84
2020,CB2020,005,2,Bronx,20202002005,466,198,268,3.26
2020,CB2020,005,2,Bronx,20204001000,475,236,239,4.78
2020,CB2020,005,2,Bronx,20204001001,228,119,109,1.51
2020,CB2020,005,2,Bronx,20204001002,182,84,98,1.37
2020,CB2020,005,2,Bronx,20204002000,66,20,46,2.64
2020,CB2020,005,2,Bronx,20204002001,196,86,110,1.06
2020,CB2020,005,2,Bronx,20204002002,238,110,128,3.39
2020,CB2020,005,2,Bronx,20204002003,154,79,75,1.54
2020,CB2020,005,2,Bronx,20204002004,81,43,38,0.53
2020,CB2020,005,2,Bronx,20204002005,115,57,58,2.28
2020,CB2020,005,2,Bronx,20204003000,364,181,183,3.87
2020,CB2020,005,2,Bronx,20204003001,388,213,175,3.2
2020,CB2020,005,2,Bronx,20204003002,292,115,177,2.98
2020,CB2020,005,2,Bronx,20204003003,303,153,150,3.71
2020,CB2020,005,2,Bronx,20204003004,47,32,15,0.33
2020,CB2020,005,2,Bronx,20205011000,0,0,0,0.64
2020,CB2020,005,2,Bronx,20205011001,0,0,0,0.29
2020,CB2020,005,2,Bronx,20205011002,0,0,0,1.26
2020,CB2020,005,2,Bronx,20205011003,0,0,0,0.45
2020,CB2020,005,2,Bronx,20205011004,0,0,0,0.36
2020,CB2020,005,2,Bronx,20205011005,0,0,0,3.13
2020,CB2020,005,2,Bronx,20205011006,0,0,0,0.47
2020,CB2020,005,2,Bronx,20205011007,0,0,0,1.51
2020,CB2020,005,2,Bronx,20205011008,0,0,0,0.22
2020,CB2020,005,2,Bronx,20205011009,0,0,0,0.15
2020,CB2020,005,2,Bronx,20205011010,0,0,0,0.21
2020,CB2020,005,2,Bronx,20205011011,0,0,0,0.51
2020,CB2020,005,2,Bronx,20205012000,0,0,0,4.4
2020,CB2020,005,2,Bronx,20205012001,0,0,0,2.3
2020,CB2020,005,2,Bronx,20205012002,0,0,0,6.68
2020,CB2020,005,2,Bronx,20205012003,0,0,0,4.89
2020,CB2020,005,2,Bronx,20205012004,1378,653,725,6.72
2020,CB2020,005,2,Bronx,20205013000,2045,913,1132,8.16
2020,CB2020,005,2,Bronx,20205014000,404,156,248,3.21
2020,CB2020,005,2,Bronx,20205014001,734,327,407,2.97
2020,CB2020,005,2,Bronx,20205014002,784,390,394,3.01
2020,CB2020,005,2,Bronx,20205015000,702,306,396,2.99
2020,CB2020,005,2,Bronx,20205015001,1812,741,1071,11.79
2020,CB2020,005,2,Bronx,20205015002,0,0,0,0.41
2020,CB2020,005,2,Bronx,20205021000,453,197,256,4.14
2020,CB2020,005,2,Bronx,20205021001,714,311,403,4.98
2020,CB2020,005,2,Bronx,20205022000,365,156,209,7.65
2020,CB2020,005,2,Bronx,20205023000,172,75,97,2.02
2020,CB2020,005,2,Bronx,20205023001,758,360,398,6.36
2020,CB2020,005,2,Bronx,20206011000,362,183,179,3.88
2020,CB2020,005,2,Bronx,20206011001,259,116,143,3.21
2020,CB2020,005,2,Bronx,20206011002,552,275,277,4.23
2020,CB2020,005,2,Bronx,20206011003,279,125,154,5.2
2020,CB2020,005,2,Bronx,20206012000,158,49,109,2.79
2020,CB2020,005,2,Bronx,20206012001,198,108,90,1.78
2020,CB2020,005,2,Bronx,20206012002,148,94,54,1.78
2020,CB2020,005,2,Bronx,20206012003,233,100,133,2.56
2020,CB2020,005,2,Bronx,20206012004,93,51,42,1.24
2020,CB2020,005,2,Bronx,20206012005,283,143,140,3.3
2020,CB2020,005,2,Bronx,20206012006,218,101,117,2.22
2020,CB2020,005,2,Bronx,20206012007,216,125,91,2.28
2020,CB2020,005,2,Bronx,20206012008,261,142,119,2.57
2020,CB2020,005,2,Bronx,20206012009,17,13,4,0.4
2020,CB2020,005,2,Bronx,20209001000,20,9,11,3.24
2020,CB2020,005,2,Bronx,20209001001,374,241,133,2.73
2020,CB2020,005,2,Bronx,20209001002,0,0,0,0.41
2020,CB2020,005,2,Bronx,20209001003,22,4,18,2.95
2020,CB2020,005,2,Bronx,20209001004,261,116,145,4.34
2020,CB2020,005,2,Bronx,20209002000,972,455,517,5.37
2020,CB2020,005,2,Bronx,20209003000,1311,594,717,5
2020,CB2020,005,2,Bronx,20209004000,0,0,0,0.45
2020,CB2020,005,2,Bronx,20209004001,491,258,233,2.07
2020,CB2020,005,2,Bronx,20209004002,724,356,368,2.4
2020,CB2020,005,2,Bronx,20209004003,648,302,346,2.75
2020,CB2020,005,2,Bronx,20209004004,0,0,0,0.33
2020,CB2020,005,2,Bronx,20209004005,0,0,0,0.34
2020,CB2020,005,2,Bronx,20209004006,0,0,0,0.34
2020,CB2020,005,2,Bronx,20210011000,351,158,193,6.06
2020,CB2020,005,2,Bronx,20210011001,502,244,258,3.04
2020,CB2020,005,2,Bronx,20210012000,1407,629,778,4.95
2020,CB2020,005,2,Bronx,20210012001,283,133,150,0.58
2020,CB2020,005,2,Bronx,20210013000,888,397,491,4.06
2020,CB2020,005,2,Bronx,20210014000,754,342,412,2.82
2020,CB2020,005,2,Bronx,20210014001,312,140,172,1.5
2020,CB2020,005,2,Bronx,20210015000,797,370,427,9.16
2020,CB2020,005,2,Bronx,20210016000,767,359,408,3.83
2020,CB2020,005,2,Bronx,20210016001,311,156,155,1.02
2020,CB2020,005,2,Bronx,20210017000,2574,1187,1387,10.26
2020,CB2020,005,2,Bronx,20210017001,0,0,0,0.28
2020,CB2020,005,2,Bronx,20210021000,1761,780,981,5.81
2020,CB2020,005,2,Bronx,20210022000,632,284,348,7.45
2020,CB2020,005,2,Bronx,20210023000,723,338,385,5.68
2020,CB2020,005,2,Bronx,20210024000,337,176,161,1.33
2020,CB2020,005,2,Bronx,20210024001,910,425,485,3.49
2020,CB2020,005,2,Bronx,20210024002,0,0,0,0.98
2020,CB2020,005,2,Bronx,20210025000,777,363,414,2.7
2020,CB2020,005,2,Bronx,20210025001,0,0,0,3.04
2020,CB2020,005,2,Bronx,20210026000,892,393,499,4.85
2020,CB2020,005,2,Bronx,20210027000,782,372,410,2.81
2020,CB2020,005,2,Bronx,20210027001,44,20,24,0.56
2020,CB2020,005,2,Bronx,20210028000,997,414,583,3.81
2020,CB2020,005,2,Bronx,20211001000,385,188,197,2.05
2020,CB2020,005,2,Bronx,20211001001,444,223,221,3.11
2020,CB2020,005,2,Bronx,20211001002,337,115,222,2.41
2020,CB2020,005,2,Bronx,20211001003,316,155,161,2.3
2020,CB2020,005,2,Bronx,20211002000,0,0,0,0.42
2020,CB2020,005,2,Bronx,20211002001,1062,525,537,6.39
2020,CB2020,005,2,Bronx,20211002002,621,276,345,3.3
2020,CB2020,005,2,Bronx,20211003000,382,179,203,4.99
2020,CB2020,005,2,Bronx,20211003001,1055,449,606,5.45
2020,CB2020,005,2,Bronx,20211004000,99,52,47,0.68
2020,CB2020,005,2,Bronx,20211004001,815,378,437,3.4
2020,CB2020,005,2,Bronx,20211004002,306,137,169,2.74
2020,CB2020,005,2,Bronx,20211004003,0,0,0,0.25
2020,CB2020,005,2,Bronx,20212001000,496,214,282,2.54
2020,CB2020,005,2,Bronx,20212001001,235,107,128,1.38
2020,CB2020,005,2,Bronx,20212001002,301,153,148,1.34
2020,CB2020,005,2,Bronx,20212002000,1362,588,774,4.52
2020,CB2020,005,2,Bronx,20212003000,2059,991,1068,4.57
2020,CB2020,005,2,Bronx,20212004000,653,297,356,2.72
2020,CB2020,005,2,Bronx,20212004001,891,423,468,2.11
2020,CB2020,005,2,Bronx,20212005000,599,271,328,5.79
2020,CB2020,005,2,Bronx,20213011000,329,138,191,2.94
2020,CB2020,005,2,Bronx,20213011001,0,0,0,1.85
2020,CB2020,005,2,Bronx,20213011002,0,0,0,0.37
2020,CB2020,005,2,Bronx,20213012000,186,85,101,2.34
2020,CB2020,005,2,Bronx,20213012001,351,175,176,2.24
2020,CB2020,005,2,Bronx,20213012002,398,165,233,4.27
2020,CB2020,005,2,Bronx,20213012003,0,0,0,0.68
2020,CB2020,005,2,Bronx,20213012004,0,0,0,0.64
2020,CB2020,005,2,Bronx,20213021000,2211,1011,1200,13.24
2020,CB2020,005,2,Bronx,20213022000,277,133,144,6.46
2020,CB2020,005,2,Bronx,20213022001,165,76,89,4.63
2020,CB2020,005,2,Bronx,20213022002,492,199,293,4.3
2020,CB2020,005,2,Bronx,20213023000,823,372,451,6.37
2020,CB2020,005,2,Bronx,20213024000,791,361,430,3.09
2020,CB2020,005,2,Bronx,20213024001,1071,504,567,3.74
2020,CB2020,005,2,Bronx,20215011000,804,336,468,5.89
2020,CB2020,005,2,Bronx,20215011001,688,314,374,3.68
2020,CB2020,005,2,Bronx,20215012000,1260,567,693,6.44
2020,CB2020,005,2,Bronx,20215013000,667,295,372,3.72
2020,CB2020,005,2,Bronx,20215013001,659,279,380,3
2020,CB2020,005,2,Bronx,20215021000,717,320,397,3.48
2020,CB2020,005,2,Bronx,20215021001,123,75,48,5.03
2020,CB2020,005,2,Bronx,20215021002,495,220,275,3.32
2020,CB2020,005,2,Bronx,20215022000,608,249,359,2.64
2020,CB2020,005,2,Bronx,20215022001,637,327,310,2.72
2020,CB2020,005,2,Bronx,20215023000,782,374,408,4.43
2020,CB2020,005,2,Bronx,20215023001,395,201,194,2.55
2020,CB2020,005,2,Bronx,20215023002,326,164,162,1.93
2020,CB2020,005,2,Bronx,20215024000,713,307,406,5.19
2020,CB2020,005,2,Bronx,20215025000,1564,717,847,7.2
2020,CB2020,005,2,Bronx,20216011000,470,231,239,2.09
2020,CB2020,005,2,Bronx,20216011001,452,196,256,2.69
2020,CB2020,005,2,Bronx,20216011002,785,355,430,4.27
2020,CB2020,005,2,Bronx,20216011003,0,0,0,3.72
2020,CB2020,005,2,Bronx,20216012000,312,161,151,2.61
2020,CB2020,005,2,Bronx,20216012001,442,218,224,2.67
2020,CB2020,005,2,Bronx,20216012002,688,332,356,5.26
2020,CB2020,005,2,Bronx,20216012003,62,33,29,1.42
2020,CB2020,005,2,Bronx,20216012004,99,41,58,2.33
2020,CB2020,005,2,Bronx,20216012005,0,0,0,2.66
2020,CB2020,005,2,Bronx,20216012006,0,0,0,0.79
2020,CB2020,005,2,Bronx,20216012007,0,0,0,2.06
2020,CB2020,005,2,Bronx,20216013000,603,279,324,2.59
2020,CB2020,005,2,Bronx,20216014000,211,123,88,2.29
2020,CB2020,005,2,Bronx,20216014001,195,77,118,0.43
2020,CB2020,005,2,Bronx,20216014002,382,165,217,2.65
2020,CB2020,005,2,Bronx,20216021000,0,0,0,2.85
2020,CB2020,005,2,Bronx,20216021001,280,129,151,3.25
2020,CB2020,005,2,Bronx,20216022000,753,357,396,6.93
2020,CB2020,005,2,Bronx,20216023000,463,193,270,2.83
2020,CB2020,005,2,Bronx,20216023001,0,0,0,1.76
2020,CB2020,005,2,Bronx,20216023002,315,164,151,1.83
2020,CB2020,005,2,Bronx,20216023003,0,0,0,0.37
2020,CB2020,005,2,Bronx,20216023004,0,0,0,1.47
2020,CB2020,005,2,Bronx,20216024000,565,235,330,3.15
2020,CB2020,005,2,Bronx,20216024001,541,240,301,3.38
2020,CB2020,005,2,Bronx,20216024002,581,284,297,1.99
2020,CB2020,005,2,Bronx,20216025000,301,135,166,0.6
2020,CB2020,005,2,Bronx,20216025001,1430,627,803,6.22
2020,CB2020,005,2,Bronx,20216025002,0,0,0,0.4
2020,CB2020,005,2,Bronx,20216026000,1008,465,543,3.85
2020,CB2020,005,2,Bronx,20217001000,1298,664,634,8.97
2020,CB2020,005,2,Bronx,20217001001,401,224,177,3.73
2020,CB2020,005,2,Bronx,20217001002,411,187,224,3.24
2020,CB2020,005,2,Bronx,20217001003,0,0,0,1.24
2020,CB2020,005,2,Bronx,20217002000,1379,648,731,5.02
2020,CB2020,005,2,Bronx,20217003000,147,65,82,8.45
2020,CB2020,005,2,Bronx,20217003001,532,244,288,4.38
2020,CB2020,005,2,Bronx,20217004000,838,380,458,4.88
2020,CB2020,005,2,Bronx,20218001000,283,123,160,1.22
2020,CB2020,005,2,Bronx,20218001001,896,479,417,2.96
2020,CB2020,005,2,Bronx,20218002000,789,381,408,5.07
2020,CB2020,005,2,Bronx,20218002001,1366,659,707,4.48
2020,CB2020,005,2,Bronx,20218003000,315,129,186,4.52
2020,CB2020,005,2,Bronx,20218003001,248,115,133,3.77
2020,CB2020,005,2,Bronx,20218003002,252,131,121,2.73
2020,CB2020,005,2,Bronx,20218003003,371,234,137,2.94
2020,CB2020,005,2,Bronx,20218003004,129,58,71,1.58
2020,CB2020,005,2,Bronx,20218003005,112,62,50,1.54
2020,CB2020,005,2,Bronx,20218003006,72,24,48,1.23
2020,CB2020,005,2,Bronx,20218004000,374,182,192,3.02
2020,CB2020,005,2,Bronx,20218004001,0,0,0,0.29
2020,CB2020,005,2,Bronx,20218004002,216,100,116,2.72
2020,CB2020,005,2,Bronx,20218004003,107,50,57,3.61
2020,CB2020,005,2,Bronx,20218004004,0,0,0,0.78
2020,CB2020,005,2,Bronx,20218004005,0,0,0,1.75
2020,CB2020,005,2,Bronx,20218004006,216,101,115,3.22
2020,CB2020,005,2,Bronx,20218005000,0,0,0,4.02
2020,CB2020,005,2,Bronx,20218005001,0,0,0,1.65
2020,CB2020,005,2,Bronx,20218005002,201,110,91,2.18
2020,CB2020,005,2,Bronx,20218005003,0,0,0,0.49
2020,CB2020,005,2,Bronx,20218005004,0,0,0,0.51
2020,CB2020,005,2,Bronx,20218005005,0,0,0,5.63
2020,CB2020,005,2,Bronx,20218005006,663,302,361,5.24
2020,CB2020,005,2,Bronx,20218005007,0,0,0,3.08
2020,CB2020,005,2,Bronx,20218005008,0,0,0,0.8
2020,CB2020,005,2,Bronx,20218005009,0,0,0,3.08
2020,CB2020,005,2,Bronx,20219001000,180,82,98,3.98
2020,CB2020,005,2,Bronx,20219001001,343,195,148,3.33
2020,CB2020,005,2,Bronx,20219001002,288,153,135,2.38
2020,CB2020,005,2,Bronx,20219001003,21,20,1,0.89
2020,CB2020,005,2,Bronx,20219001004,0,0,0,0.69
2020,CB2020,005,2,Bronx,20219001005,0,0,0,5.71
2020,CB2020,005,2,Bronx,20219001006,55,20,35,5.24
2020,CB2020,005,2,Bronx,20219001007,71,68,3,4.87
2020,CB2020,005,2,Bronx,20219001008,17,11,6,3
2020,CB2020,005,2,Bronx,20219001009,201,116,85,2.73
2020,CB2020,005,2,Bronx,20219001010,0,0,0,2.5
2020,CB2020,005,2,Bronx,20220001000,23,16,7,6.35
2020,CB2020,005,2,Bronx,20220001001,39,27,12,7.82
2020,CB2020,005,2,Bronx,20220001002,460,230,230,2.13
2020,CB2020,005,2,Bronx,20220001003,0,0,0,1.08
2020,CB2020,005,2,Bronx,20220001004,0,0,0,5.3
2020,CB2020,005,2,Bronx,20220001005,0,0,0,4.46
2020,CB2020,005,2,Bronx,20220001006,480,263,217,3.33
2020,CB2020,005,2,Bronx,20220001007,103,39,64,2.83
2020,CB2020,005,2,Bronx,20220001008,0,0,0,4.72
2020,CB2020,005,2,Bronx,20220001009,59,29,30,10.02
2020,CB2020,005,2,Bronx,20220001010,1176,756,420,3.42
2020,CB2020,005,2,Bronx,20220001011,91,63,28,2.73
2020,CB2020,005,2,Bronx,20220001012,80,38,42,2.32
2020,CB2020,005,2,Bronx,20221011000,906,426,480,2.57
2020,CB2020,005,2,Bronx,20221011001,0,0,0,1.91
2020,CB2020,005,2,Bronx,20221012000,438,209,229,3.17
2020,CB2020,005,2,Bronx,20221012001,944,470,474,3.13
2020,CB2020,005,2,Bronx,20221013000,1053,475,578,2.94
2020,CB2020,005,2,Bronx,20221013001,660,309,351,3.1
2020,CB2020,005,2,Bronx,20221021000,0,0,0,0.32
2020,CB2020,005,2,Bronx,20221021001,943,461,482,3.71
2020,CB2020,005,2,Bronx,20221021002,1578,754,824,3.69
2020,CB2020,005,2,Bronx,20221021003,0,0,0,0.31
2020,CB2020,005,2,Bronx,20221022000,0,0,0,0.31
2020,CB2020,005,2,Bronx,20221022001,1065,447,618,3.43
2020,CB2020,005,2,Bronx,20221023000,0,0,0,0.3
2020,CB2020,005,2,Bronx,20221023001,1132,504,628,3.29
2020,CB2020,005,2,Bronx,20221023002,739,352,387,3.62
2020,CB2020,005,2,Bronx,20221023003,0,0,0,0.35
2020,CB2020,005,2,Bronx,20222001000,100,48,52,2.22
2020,CB2020,005,2,Bronx,20222001001,10,5,5,4.92
2020,CB2020,005,2,Bronx,20222001002,275,160,115,3.41
2020,CB2020,005,2,Bronx,20222001003,791,368,423,6.47
2020,CB2020,005,2,Bronx,20222002000,604,286,318,4.54
2020,CB2020,005,2,Bronx,20222002001,229,117,112,5.12
2020,CB2020,005,2,Bronx,20222003000,252,133,119,2.87
2020,CB2020,005,2,Bronx,20222003001,0,0,0,0.29
2020,CB2020,005,2,Bronx,20222003002,55,13,42,0.75
2020,CB2020,005,2,Bronx,20222003003,263,136,127,6.66
2020,CB2020,005,2,Bronx,20222003004,452,233,219,5.53
2020,CB2020,005,2,Bronx,20222003005,0,0,0,1.63
2020,CB2020,005,2,Bronx,20222004000,492,239,253,5.38
2020,CB2020,005,2,Bronx,20222004001,445,224,221,4.85
2020,CB2020,005,2,Bronx,20223001000,427,183,244,2.63
2020,CB2020,005,2,Bronx,20223001001,493,250,243,2.93
2020,CB2020,005,2,Bronx,20223002000,811,358,453,2.45
2020,CB2020,005,2,Bronx,20223002001,266,134,132,2.71
2020,CB2020,005,2,Bronx,20223003000,811,357,454,2.44
2020,CB2020,005,2,Bronx,20223003001,797,404,393,2.67
2020,CB2020,005,2,Bronx,20223004000,0,0,0,0.46
2020,CB2020,005,2,Bronx,20223004001,681,240,441,2.73
2020,CB2020,005,2,Bronx,20223004002,777,352,425,3.5
2020,CB2020,005,2,Bronx,20223004003,0,0,0,0.41
2020,CB2020,005,2,Bronx,20224011000,0,0,0,1.38
2020,CB2020,005,2,Bronx,20224011001,0,0,0,1.56
2020,CB2020,005,2,Bronx,20224011002,0,0,0,0.5
2020,CB2020,005,2,Bronx,20224011003,1400,671,729,5.36
2020,CB2020,005,2,Bronx,20224012000,482,203,279,5.02
2020,CB2020,005,2,Bronx,20224012001,408,183,225,2.58
2020,CB2020,005,2,Bronx,20224012002,497,239,258,3.46
2020,CB2020,005,2,Bronx,20224012003,0,0,0,1.16
2020,CB2020,005,2,Bronx,20224031000,0,0,0,7.99
2020,CB2020,005,2,Bronx,20224031001,0,0,0,6.08
2020,CB2020,005,2,Bronx,20224031002,0,0,0,2.13
2020,CB2020,005,2,Bronx,20224031003,1164,521,643,4.86
2020,CB2020,005,2,Bronx,20224032000,1481,658,823,4.76
2020,CB2020,005,2,Bronx,20224032001,630,298,332,5.04
2020,CB2020,005,2,Bronx,20224041000,238,95,143,1.95
2020,CB2020,005,2,Bronx,20224041001,410,186,224,2.93
2020,CB2020,005,2,Bronx,20224042000,1152,564,588,4.53
2020,CB2020,005,2,Bronx,20224042001,293,129,164,4.53
2020,CB2020,005,2,Bronx,20224043000,585,229,356,2.66
2020,CB2020,005,2,Bronx,20224043001,1158,540,618,3.65
2020,CB2020,005,2,Bronx,20224043002,653,328,325,2.67
2020,CB2020,005,2,Bronx,20225001000,0,0,0,0.39
2020,CB2020,005,2,Bronx,20225001001,1108,547,561,4.22
2020,CB2020,005,2,Bronx,20225002000,88,46,42,0.65
2020,CB2020,005,2,Bronx,20225002001,894,407,487,4.8
2020,CB2020,005,2,Bronx,20225002002,91,50,41,1.38
2020,CB2020,005,2,Bronx,20225002003,523,240,283,2.92
2020,CB2020,005,2,Bronx,20225002004,342,180,162,1.87
2020,CB2020,005,2,Bronx,20225003000,223,116,107,3.02
2020,CB2020,005,2,Bronx,20225003001,285,149,136,0.63
2020,CB2020,005,2,Bronx,20225003002,785,394,391,2.74
2020,CB2020,005,2,Bronx,20225004000,112,35,77,8.26
2020,CB2020,005,2,Bronx,20225004001,800,382,418,2.66
2020,CB2020,005,2,Bronx,20225004002,0,0,0,0.51
2020,CB2020,005,2,Bronx,20225004003,0,0,0,0.25
2020,CB2020,005,2,Bronx,20225005000,1170,547,623,2.8
2020,CB2020,005,2,Bronx,20225005001,0,0,0,0.55
2020,CB2020,005,2,Bronx,20225006000,30,13,17,0.73
2020,CB2020,005,2,Bronx,20225006001,1690,762,928,5.2
2020,CB2020,005,2,Bronx,20225006002,0,0,0,0.91
2020,CB2020,005,2,Bronx,20227011000,832,412,420,2.95
2020,CB2020,005,2,Bronx,20227011001,466,217,249,2.76
2020,CB2020,005,2,Bronx,20227012000,0,0,0,0.58
2020,CB2020,005,2,Bronx,20227012001,277,116,161,1.11
2020,CB2020,005,2,Bronx,20227012002,871,429,442,2.39
2020,CB2020,005,2,Bronx,20227012003,1089,494,595,2.63
2020,CB2020,005,2,Bronx,20227012004,0,0,0,0.33
2020,CB2020,005,2,Bronx,20227013000,806,368,438,3.03
2020,CB2020,005,2,Bronx,20227013001,484,242,242,2.74
2020,CB2020,005,2,Bronx,20227013002,320,147,173,2.94
2020,CB2020,005,2,Bronx,20227013003,246,120,126,4.9
2020,CB2020,005,2,Bronx,20227013004,0,0,0,0.3
2020,CB2020,005,2,Bronx,20227013005,0,0,0,0.47
2020,CB2020,005,2,Bronx,20227013006,0,0,0,0.29
2020,CB2020,005,2,Bronx,20227013007,278,142,136,0.99
2020,CB2020,005,2,Bronx,20227013008,0,0,0,0.54
2020,CB2020,005,2,Bronx,20227021000,0,0,0,0.67
2020,CB2020,005,2,Bronx,20227021001,0,0,0,0.53
2020,CB2020,005,2,Bronx,20227021002,380,181,199,2.52
2020,CB2020,005,2,Bronx,20227021003,0,0,0,2.09
2020,CB2020,005,2,Bronx,20227021004,521,251,270,2.66
2020,CB2020,005,2,Bronx,20227021005,715,334,381,2.51
2020,CB2020,005,2,Bronx,20227021006,18,5,13,0.73
2020,CB2020,005,2,Bronx,20227031000,0,0,0,0.81
2020,CB2020,005,2,Bronx,20227031001,801,384,417,2.32
2020,CB2020,005,2,Bronx,20227031002,0,0,0,0.35
2020,CB2020,005,2,Bronx,20227031003,0,0,0,0.29
2020,CB2020,005,2,Bronx,20227031004,12,5,7,2.04
2020,CB2020,005,2,Bronx,20227031005,180,94,86,1.52
2020,CB2020,005,2,Bronx,20227031006,706,331,375,2.22
2020,CB2020,005,2,Bronx,20228001000,367,192,175,4.54
2020,CB2020,005,2,Bronx,20228001001,620,282,338,4.5
2020,CB2020,005,2,Bronx,20228001002,0,0,0,3.67
2020,CB2020,005,2,Bronx,20228001003,0,0,0,0.91
2020,CB2020,005,2,Bronx,20228001004,188,102,86,3.45
2020,CB2020,005,2,Bronx,20228001005,559,235,324,5.77
2020,CB2020,005,2,Bronx,20228002000,642,305,337,5.14
2020,CB2020,005,2,Bronx,20228002001,1285,631,654,5.04
2020,CB2020,005,2,Bronx,20228003000,1366,629,737,4.94
2020,CB2020,005,2,Bronx,20228004000,1309,604,705,4.57
2020,CB2020,005,2,Bronx,20229011000,0,0,0,0.42
2020,CB2020,005,2,Bronx,20229011001,0,0,0,0.68
2020,CB2020,005,2,Bronx,20229011002,517,234,283,2.12
2020,CB2020,005,2,Bronx,20229011003,484,245,239,3
2020,CB2020,005,2,Bronx,20229011004,0,0,0,0.5
2020,CB2020,005,2,Bronx,20229011005,0,0,0,0.57
2020,CB2020,005,2,Bronx,20229011006,0,0,0,0.53
2020,CB2020,005,2,Bronx,20229012000,401,182,219,1.62
2020,CB2020,005,2,Bronx,20229012001,861,428,433,3.38
2020,CB2020,005,2,Bronx,20229012002,0,0,0,0.52
2020,CB2020,005,2,Bronx,20229012003,0,0,0,0.68
2020,CB2020,005,2,Bronx,20229013000,734,351,383,2.05
2020,CB2020,005,2,Bronx,20229013001,131,76,55,1.7
2020,CB2020,005,2,Bronx,20229014000,244,135,109,1.63
2020,CB2020,005,2,Bronx,20229014001,676,325,351,3.34
2020,CB2020,005,2,Bronx,20229015000,878,414,464,3.63
2020,CB2020,005,2,Bronx,20229015001,840,386,454,3.39
2020,CB2020,005,2,Bronx,20229015002,0,0,0,0.34
2020,CB2020,005,2,Bronx,20229021000,0,0,0,0.73
2020,CB2020,005,2,Bronx,20229021001,608,250,358,2.22
2020,CB2020,005,2,Bronx,20229021002,0,0,0,2.2
2020,CB2020,005,2,Bronx,20229021003,110,60,50,1.53
2020,CB2020,005,2,Bronx,20229021004,505,239,266,1.54
2020,CB2020,005,2,Bronx,20229021005,19,7,12,0.58
2020,CB2020,005,2,Bronx,20229022000,0,0,0,0.62
2020,CB2020,005,2,Bronx,20229022001,0,0,0,0.35
2020,CB2020,005,2,Bronx,20229022002,232,124,108,2.19
2020,CB2020,005,2,Bronx,20229022003,434,200,234,2.18
2020,CB2020,005,2,Bronx,20229022004,281,128,153,2.44
2020,CB2020,005,2,Bronx,20229023000,413,177,236,2.05
2020,CB2020,005,2,Bronx,20229023001,462,250,212,1.97
2020,CB2020,005,2,Bronx,20229023002,337,154,183,2.05
2020,CB2020,005,2,Bronx,20230001000,0,0,0,1.71
2020,CB2020,005,2,Bronx,20230001001,862,428,434,3.02
2020,CB2020,005,2,Bronx,20230001002,0,0,0,1.13
2020,CB2020,005,2,Bronx,20230001003,151,80,71,5.11
2020,CB2020,005,2,Bronx,20230001004,42,15,27,2.31
2020,CB2020,005,2,Bronx,20230001005,136,61,75,2.49
2020,CB2020,005,2,Bronx,20230001006,179,108,71,2.09
2020,CB2020,005,2,Bronx,20230001007,48,21,27,3.57
2020,CB2020,005,2,Bronx,20230002000,137,80,57,3.58
2020,CB2020,005,2,Bronx,20230002001,383,195,188,4.93
2020,CB2020,005,2,Bronx,20230002002,296,126,170,2.88
2020,CB2020,005,2,Bronx,20230002003,367,207,160,2.65
2020,CB2020,005,2,Bronx,20230002004,400,188,212,3.92
2020,CB2020,005,2,Bronx,20231001000,20,8,12,2.97
2020,CB2020,005,2,Bronx,20231001001,15,5,10,1.28
2020,CB2020,005,2,Bronx,20231001002,641,306,335,6.51
2020,CB2020,005,2,Bronx,20231001003,265,129,136,1.51
2020,CB2020,005,2,Bronx,20231001004,165,128,37,1.57
2020,CB2020,005,2,Bronx,20231001005,190,87,103,1.66
2020,CB2020,005,2,Bronx,20231001006,99,59,40,1.86
2020,CB2020,005,2,Bronx,20231001007,0,0,0,1.33
2020,CB2020,005,2,Bronx,20231001008,0,0,0,2.11
2020,CB2020,005,2,Bronx,20231001009,26,12,14,4.06
2020,CB2020,005,2,Bronx,20231001010,34,31,3,2.27
2020,CB2020,005,2,Bronx,20231001011,0,0,0,0.57
2020,CB2020,005,2,Bronx,20231001012,9,4,5,1.24
2020,CB2020,005,2,Bronx,20232001000,361,184,177,5.03
2020,CB2020,005,2,Bronx,20232001001,309,168,141,5.01
2020,CB2020,005,2,Bronx,20232001002,330,126,204,4.8
2020,CB2020,005,2,Bronx,20232001003,378,188,190,4.76
2020,CB2020,005,2,Bronx,20232001004,68,29,39,0.89
2020,CB2020,005,2,Bronx,20232002000,498,237,261,4.79
2020,CB2020,005,2,Bronx,20232002001,371,197,174,4.8
2020,CB2020,005,2,Bronx,20232002002,685,343,342,5.19
2020,CB2020,005,2,Bronx,20233011000,0,0,0,4.7
2020,CB2020,005,2,Bronx,20233011001,847,394,453,3.67
2020,CB2020,005,2,Bronx,20233011002,361,175,186,3.26
2020,CB2020,005,2,Bronx,20233012000,0,0,0,0.45
2020,CB2020,005,2,Bronx,20233012001,995,470,525,3.16
2020,CB2020,005,2,Bronx,20233012002,620,283,337,2.21
2020,CB2020,005,2,Bronx,20233012003,0,0,0,0.47
2020,CB2020,005,2,Bronx,20233013000,468,247,221,3.11
2020,CB2020,005,2,Bronx,20233013001,533,275,258,3.7
2020,CB2020,005,2,Bronx,20233014000,753,370,383,2.34
2020,CB2020,005,2,Bronx,20233014001,0,0,0,2.36
2020,CB2020,005,2,Bronx,20233021000,499,277,222,3.31
2020,CB2020,005,2,Bronx,20233021001,956,498,458,4.39
2020,CB2020,005,2,Bronx,20233021002,127,59,68,0.75
2020,CB2020,005,2,Bronx,20233021003,0,0,0,0.32
2020,CB2020,005,2,Bronx,20233021004,0,0,0,0.41
2020,CB2020,005,2,Bronx,20233022000,1515,712,803,4.36
2020,CB2020,005,2,Bronx,20233022001,477,224,253,1.61
2020,CB2020,005,2,Bronx,20233022002,0,0,0,0.3
2020,CB2020,005,2,Bronx,20235011000,0,0,0,0.39
2020,CB2020,005,2,Bronx,20235011001,0,0,0,0.62
2020,CB2020,005,2,Bronx,20235011002,269,109,160,1.81
2020,CB2020,005,2,Bronx,20235011003,548,263,285,1.74
2020,CB2020,005,2,Bronx,20235011004,0,0,0,0.3
2020,CB2020,005,2,Bronx,20235011005,0,0,0,0.27
2020,CB2020,005,2,Bronx,20235011006,434,191,243,1.95
2020,CB2020,005,2,Bronx,20235011007,410,174,236,1.99
2020,CB2020,005,2,Bronx,20235011008,0,0,0,0.3
2020,CB2020,005,2,Bronx,20235011009,0,0,0,0.28
2020,CB2020,005,2,Bronx,20235011010,0,0,0,0.57
2020,CB2020,005,2,Bronx,20235012000,0,0,0,0.58
2020,CB2020,005,2,Bronx,20235012001,972,467,505,2.39
2020,CB2020,005,2,Bronx,20235013000,0,0,0,0.59
2020,CB2020,005,2,Bronx,20235013001,937,426,511,3.06
2020,CB2020,005,2,Bronx,20235021000,926,433,493,3.75
2020,CB2020,005,2,Bronx,20235021001,0,0,0,0.27
2020,CB2020,005,2,Bronx,20235021002,931,445,486,4.4
2020,CB2020,005,2,Bronx,20235021003,0,0,0,0.4
2020,CB2020,005,2,Bronx,20235022000,902,422,480,2.95
2020,CB2020,005,2,Bronx,20235022001,0,0,0,0.26
2020,CB2020,005,2,Bronx,20235023000,0,0,0,0.34
2020,CB2020,005,2,Bronx,20235023001,377,181,196,1.43
2020,CB2020,005,2,Bronx,20235023002,316,146,170,2.15
2020,CB2020,005,2,Bronx,20235023003,0,0,0,0.26
2020,CB2020,005,2,Bronx,20235024000,0,0,0,0.54
2020,CB2020,005,2,Bronx,20235024001,6,3,3,0.55
2020,CB2020,005,2,Bronx,20235024002,189,81,108,2.13
2020,CB2020,005,2,Bronx,20235024003,0,0,0,0.51
2020,CB2020,005,2,Bronx,20235024004,0,0,0,0.61
2020,CB2020,005,2,Bronx,20235024005,770,358,412,3.23
2020,CB2020,005,2,Bronx,20236001000,473,244,229,4.33
2020,CB2020,005,2,Bronx,20236001001,382,146,236,4.28
2020,CB2020,005,2,Bronx,20236001002,277,142,135,2.94
2020,CB2020,005,2,Bronx,20236002000,305,151,154,2.68
2020,CB2020,005,2,Bronx,20236002001,238,118,120,2.9
2020,CB2020,005,2,Bronx,20236002002,142,66,76,1.67
2020,CB2020,005,2,Bronx,20236002003,385,185,200,2.76
2020,CB2020,005,2,Bronx,20236002004,2,2,0,0.86
2020,CB2020,005,2,Bronx,20236002005,0,0,0,0.33
2020,CB2020,005,2,Bronx,20237021000,197,87,110,3.44
2020,CB2020,005,2,Bronx,20237021001,0,0,0,0.51
2020,CB2020,005,2,Bronx,20237021002,0,0,0,0.44
2020,CB2020,005,2,Bronx,20237021003,314,175,139,3.15
2020,CB2020,005,2,Bronx,20237021004,659,330,329,2.64
2020,CB2020,005,2,Bronx,20237021005,9,2,7,1.21
2020,CB2020,005,2,Bronx,20237021006,0,0,0,0.44
2020,CB2020,005,2,Bronx,20237031000,0,0,0,0.61
2020,CB2020,005,2,Bronx,20237031001,76,45,31,1.82
2020,CB2020,005,2,Bronx,20237031002,0,0,0,0.76
2020,CB2020,005,2,Bronx,20237031003,1685,854,831,5.73
2020,CB2020,005,2,Bronx,20237031004,895,476,419,4.61
2020,CB2020,005,2,Bronx,20237031005,0,0,0,0.53
2020,CB2020,005,2,Bronx,20237031006,0,0,0,0.51
2020,CB2020,005,2,Bronx,20237032000,0,0,0,0.33
2020,CB2020,005,2,Bronx,20237032001,433,207,226,1.41
2020,CB2020,005,2,Bronx,20237032002,889,430,459,2.81
2020,CB2020,005,2,Bronx,20237032003,20,13,7,0.65
2020,CB2020,005,2,Bronx,20237033000,0,0,0,1.69
2020,CB2020,005,2,Bronx,20237033001,1088,500,588,3.4
2020,CB2020,005,2,Bronx,20237041000,0,0,0,0.72
2020,CB2020,005,2,Bronx,20237041001,794,372,422,3.07
2020,CB2020,005,2,Bronx,20237042000,1047,477,570,3.81
2020,CB2020,005,2,Bronx,20237042001,820,397,423,4.6
2020,CB2020,005,2,Bronx,20237043000,0,0,0,0.78
2020,CB2020,005,2,Bronx,20237043001,1309,640,669,3.69
2020,CB2020,005,2,Bronx,20238001000,117,50,67,37.09
2020,CB2020,005,2,Bronx,20238001001,21,13,8,13.06
2020,CB2020,005,2,Bronx,20238002000,341,144,197,4.35
2020,CB2020,005,2,Bronx,20238002001,229,108,121,3.14
2020,CB2020,005,2,Bronx,20238002002,294,153,141,3.16
2020,CB2020,005,2,Bronx,20238002003,145,92,53,1.47
2020,CB2020,005,2,Bronx,20238002004,95,39,56,1.25
2020,CB2020,005,2,Bronx,20238002005,222,107,115,4.19
2020,CB2020,005,2,Bronx,20238003000,351,203,148,3.15
2020,CB2020,005,2,Bronx,20238003001,190,90,100,3.15
2020,CB2020,005,2,Bronx,20238003002,317,168,149,3.35
2020,CB2020,005,2,Bronx,20238003003,155,83,72,2.7
2020,CB2020,005,2,Bronx,20238003004,132,74,58,2.08
2020,CB2020,005,2,Bronx,20238003005,141,46,95,1.76
2020,CB2020,005,2,Bronx,20239001000,1153,585,568,4.74
2020,CB2020,005,2,Bronx,20239001001,296,143,153,5.66
2020,CB2020,005,2,Bronx,20239002000,1291,659,632,3.26
2020,CB2020,005,2,Bronx,20239002001,197,99,98,3.51
2020,CB2020,005,2,Bronx,20239003000,684,321,363,2.58
2020,CB2020,005,2,Bronx,20239003001,357,169,188,2.87
2020,CB2020,005,2,Bronx,20239003002,72,34,38,1.28
2020,CB2020,005,2,Bronx,20239003003,413,199,214,1.38
2020,CB2020,005,2,Bronx,20239004000,744,344,400,4.79
2020,CB2020,005,2,Bronx,20239005000,1108,536,572,4.49
2020,CB2020,005,2,Bronx,20239006000,399,201,198,2.52
2020,CB2020,005,2,Bronx,20239006001,292,127,165,1.76
2020,CB2020,005,2,Bronx,20239006002,208,105,103,1.73
2020,CB2020,005,2,Bronx,20239007000,393,198,195,1.76
2020,CB2020,005,2,Bronx,20239007001,606,296,310,1.77
2020,CB2020,005,2,Bronx,20240001000,374,188,186,3.37
2020,CB2020,005,2,Bronx,20240001001,394,190,204,3.06
2020,CB2020,005,2,Bronx,20240001002,75,36,39,0.44
2020,CB2020,005,2,Bronx,20240001003,144,59,85,3.79
2020,CB2020,005,2,Bronx,20240001004,0,0,0,1.57
2020,CB2020,005,2,Bronx,20240001005,0,0,0,3.08
2020,CB2020,005,2,Bronx,20240001006,534,287,247,4
2020,CB2020,005,2,Bronx,20240001007,737,407,330,10.07
2020,CB2020,005,2,Bronx,20240001008,53,10,43,1.38
2020,CB2020,005,2,Bronx,20240001009,0,0,0,0.51
2020,CB2020,005,2,Bronx,20240002000,407,207,200,4
2020,CB2020,005,2,Bronx,20240002001,439,221,218,4.04
2020,CB2020,005,2,Bronx,20240003000,467,232,235,4.02
2020,CB2020,005,2,Bronx,20240003001,489,239,250,3.85
2020,CB2020,005,2,Bronx,20240003002,462,223,239,4.05
2020,CB2020,005,2,Bronx,20240003003,0,0,0,3.5
2020,CB2020,005,2,Bronx,20240003004,0,0,0,0.58
2020,CB2020,005,2,Bronx,20240003005,8,3,5,1.34
2020,CB2020,005,2,Bronx,20240003006,0,0,0,2.6
2020,CB2020,005,2,Bronx,20241001000,273,102,171,2.49
2020,CB2020,005,2,Bronx,20241001001,588,315,273,2.47
2020,CB2020,005,2,Bronx,20241001002,519,249,270,2.55
2020,CB2020,005,2,Bronx,20241002000,692,360,332,5.4
2020,CB2020,005,2,Bronx,20241002001,370,172,198,3.39
2020,CB2020,005,2,Bronx,20241003000,551,238,313,4.9
2020,CB2020,005,2,Bronx,20241003001,796,372,424,3.44
2020,CB2020,005,2,Bronx,20241004000,890,437,453,3.66
2020,CB2020,005,2,Bronx,20241005000,1652,803,849,4.99
2020,CB2020,005,2,Bronx,20243001000,374,179,195,5.14
2020,CB2020,005,2,Bronx,20243001001,995,425,570,4.35
2020,CB2020,005,2,Bronx,20243002000,1211,601,610,14.55
2020,CB2020,005,2,Bronx,20243002001,296,149,147,2.23
2020,CB2020,005,2,Bronx,20243003000,1046,518,528,5.13
2020,CB2020,005,2,Bronx,20243004000,1655,736,919,5.78
2020,CB2020,005,2,Bronx,20244001000,178,58,120,4.95
2020,CB2020,005,2,Bronx,20244001001,557,257,300,4.95
2020,CB2020,005,2,Bronx,20244001002,144,87,57,4.09
2020,CB2020,005,2,Bronx,20244001003,102,49,53,3.44
2020,CB2020,005,2,Bronx,20244002000,195,93,102,3.31
2020,CB2020,005,2,Bronx,20244002001,255,86,169,3.3
2020,CB2020,005,2,Bronx,20244002002,307,169,138,5.01
2020,CB2020,005,2,Bronx,20244002003,282,145,137,4.68
2020,CB2020,005,2,Bronx,20244002004,125,71,54,1.72
2020,CB2020,005,2,Bronx,20244002005,93,45,48,2.47
2020,CB2020,005,2,Bronx,20244002006,169,76,93,5.48
2020,CB2020,005,2,Bronx,20245011000,1789,814,975,9.65
2020,CB2020,005,2,Bronx,20245012000,684,317,367,4.69
2020,CB2020,005,2,Bronx,20245012001,432,234,198,2.42
2020,CB2020,005,2,Bronx,20245013000,983,463,520,5.62
2020,CB2020,005,2,Bronx,20245014000,1171,530,641,5.56
2020,CB2020,005,2,Bronx,20245021000,993,479,514,3.92
2020,CB2020,005,2,Bronx,20245021001,87,40,47,3.11
2020,CB2020,005,2,Bronx,20245021002,144,76,68,2.68
2020,CB2020,005,2,Bronx,20245021003,339,136,203,2.82
2020,CB2020,005,2,Bronx,20245022000,546,247,299,4.89
2020,CB2020,005,2,Bronx,20245023000,902,406,496,4.24
2020,CB2020,005,2,Bronx,20245023001,786,379,407,3.08
2020,CB2020,005,2,Bronx,20246001000,327,138,189,5.26
2020,CB2020,005,2,Bronx,20246001001,228,121,107,1.92
2020,CB2020,005,2,Bronx,20246001002,207,110,97,2.98
2020,CB2020,005,2,Bronx,20246001003,70,10,60,2
2020,CB2020,005,2,Bronx,20246001004,179,107,72,2.96
2020,CB2020,005,2,Bronx,20246001005,143,72,71,2.63
2020,CB2020,005,2,Bronx,20246002000,330,146,184,4.92
2020,CB2020,005,2,Bronx,20246002001,323,172,151,4.9
2020,CB2020,005,2,Bronx,20246002002,288,144,144,4.89
2020,CB2020,005,2,Bronx,20246002003,202,109,93,3.81
2020,CB2020,005,2,Bronx,20246002004,0,0,0,1.41
2020,CB2020,005,2,Bronx,20247001000,0,0,0,1.82
2020,CB2020,005,2,Bronx,20247001001,812,400,412,4.69
2020,CB2020,005,2,Bronx,20247002000,0,0,0,2.05
2020,CB2020,005,2,Bronx,20247002001,0,0,0,1.7
2020,CB2020,005,2,Bronx,20247002002,0,0,0,3.35
2020,CB2020,005,2,Bronx,20247002003,16,8,8,14.56
2020,CB2020,005,2,Bronx,20247002004,1093,503,590,8.7
2020,CB2020,005,2,Bronx,20248001000,0,0,0,7.18
2020,CB2020,005,2,Bronx,20248001001,16,10,6,5.85
2020,CB2020,005,2,Bronx,20248001002,0,0,0,1.82
2020,CB2020,005,2,Bronx,20248001003,0,0,0,0.38
2020,CB2020,005,2,Bronx,20248001004,172,82,90,4.47
2020,CB2020,005,2,Bronx,20248001005,204,85,119,4.05
2020,CB2020,005,2,Bronx,20248001006,0,0,0,0.45
2020,CB2020,005,2,Bronx,20248001007,26,10,16,1.67
2020,CB2020,005,2,Bronx,20248001008,608,259,349,2.94
2020,CB2020,005,2,Bronx,20248001009,173,93,80,3.87
2020,CB2020,005,2,Bronx,20248002000,485,226,259,4.28
2020,CB2020,005,2,Bronx,20248002001,189,77,112,1.43
2020,CB2020,005,2,Bronx,20248002002,92,36,56,1.3
2020,CB2020,005,2,Bronx,20248002003,291,141,150,1.96
2020,CB2020,005,2,Bronx,20248002004,116,56,60,2.03
2020,CB2020,005,2,Bronx,20248002005,159,82,77,3.31
2020,CB2020,005,2,Bronx,20248002006,60,29,31,0.84
2020,CB2020,005,2,Bronx,20248003000,88,32,56,3.37
2020,CB2020,005,2,Bronx,20248003001,181,91,90,3.13
2020,CB2020,005,2,Bronx,20248003002,149,84,65,3.12
2020,CB2020,005,2,Bronx,20248003003,180,101,79,3.05
2020,CB2020,005,2,Bronx,20248003004,91,44,47,2.23
2020,CB2020,005,2,Bronx,20248003005,54,27,27,0.9
2020,CB2020,005,2,Bronx,20248003006,224,113,111,3.64
2020,CB2020,005,2,Bronx,20248003007,62,18,44,1.4
2020,CB2020,005,2,Bronx,20249001000,4,3,1,42.93
2020,CB2020,005,2,Bronx,20250001000,287,144,143,5.27
2020,CB2020,005,2,Bronx,20250001001,273,134,139,4.89
2020,CB2020,005,2,Bronx,20250001002,311,161,150,4.9
2020,CB2020,005,2,Bronx,20250001003,361,144,217,4.94
2020,CB2020,005,2,Bronx,20250001004,373,177,196,5.34
2020,CB2020,005,2,Bronx,20250002000,313,167,146,4.9
2020,CB2020,005,2,Bronx,20250002001,142,82,60,2.78
2020,CB2020,005,2,Bronx,20250002002,273,125,148,4.89
2020,CB2020,005,2,Bronx,20250002003,60,38,22,2.12
2020,CB2020,005,2,Bronx,20250002004,279,136,143,4.88
2020,CB2020,005,2,Bronx,20251001000,317,153,164,1.55
2020,CB2020,005,2,Bronx,20251001001,240,109,131,2.11
2020,CB2020,005,2,Bronx,20251001002,560,301,259,1.55
2020,CB2020,005,2,Bronx,20251002000,294,148,146,1.77
2020,CB2020,005,2,Bronx,20251002001,407,166,241,1.55
2020,CB2020,005,2,Bronx,20251002002,247,160,87,1.55
2020,CB2020,005,2,Bronx,20251002003,60,25,35,1.71
2020,CB2020,005,2,Bronx,20251003000,358,175,183,5.69
2020,CB2020,005,2,Bronx,20251003001,497,239,258,3.23
2020,CB2020,005,2,Bronx,20251004000,428,209,219,2.97
2020,CB2020,005,2,Bronx,20251004001,375,188,187,2.67
2020,CB2020,005,2,Bronx,20251005000,737,302,435,6.08
2020,CB2020,005,2,Bronx,20251005001,498,248,250,2.4
2020,CB2020,005,2,Bronx,20251005002,264,187,77,2.66
2020,CB2020,005,2,Bronx,20251005003,368,171,197,2.95
2020,CB2020,005,2,Bronx,20251006000,281,129,152,5.79
2020,CB2020,005,2,Bronx,20251007000,351,156,195,2.85
2020,CB2020,005,2,Bronx,20251007001,642,291,351,2.65
2020,CB2020,005,2,Bronx,20252001000,137,75,62,2.95
2020,CB2020,005,2,Bronx,20252001001,129,60,69,1.99
2020,CB2020,005,2,Bronx,20252001002,394,189,205,4.96
2020,CB2020,005,2,Bronx,20252001003,275,129,146,4.95
2020,CB2020,005,2,Bronx,20252001004,177,91,86,3.3
2020,CB2020,005,2,Bronx,20252001005,174,73,101,3.32
2020,CB2020,005,2,Bronx,20252001006,88,48,40,1.26
2020,CB2020,005,2,Bronx,20252001007,103,58,45,2.06
2020,CB2020,005,2,Bronx,20252002000,172,68,104,2.96
2020,CB2020,005,2,Bronx,20252002001,276,127,149,4.7
2020,CB2020,005,2,Bronx,20252002002,87,27,60,1.73
2020,CB2020,005,2,Bronx,20252002003,89,58,31,2.17
2020,CB2020,005,2,Bronx,20252002004,68,34,34,1.03
2020,CB2020,005,2,Bronx,20252002005,145,50,95,2.55
2020,CB2020,005,2,Bronx,20252002006,103,49,54,2.52
2020,CB2020,005,2,Bronx,20252002007,265,149,116,4.68
2020,CB2020,005,2,Bronx,20253001000,594,278,316,5.24
2020,CB2020,005,2,Bronx,20253001001,1074,524,550,3.99
2020,CB2020,005,2,Bronx,20253001002,535,242,293,2.23
2020,CB2020,005,2,Bronx,20253002000,358,189,169,1.55
2020,CB2020,005,2,Bronx,20253002001,439,207,232,1.55
2020,CB2020,005,2,Bronx,20253002002,217,106,111,1.57
2020,CB2020,005,2,Bronx,20253002003,76,32,44,0.25
2020,CB2020,005,2,Bronx,20253002004,519,229,290,1.56
2020,CB2020,005,2,Bronx,20253003000,1496,706,790,6.95
2020,CB2020,005,2,Bronx,20253004000,666,303,363,4.11
2020,CB2020,005,2,Bronx,20253004001,260,127,133,1.77
2020,CB2020,005,2,Bronx,20254001000,184,101,83,3.58
2020,CB2020,005,2,Bronx,20254001001,0,0,0,3.3
2020,CB2020,005,2,Bronx,20254001002,113,37,76,3.3
2020,CB2020,005,2,Bronx,20254001003,365,206,159,4.96
2020,CB2020,005,2,Bronx,20254001004,334,124,210,4.95
2020,CB2020,005,2,Bronx,20254001005,117,47,70,3.31
2020,CB2020,005,2,Bronx,20254002000,320,158,162,4.55
2020,CB2020,005,2,Bronx,20254002001,246,114,132,4.68
2020,CB2020,005,2,Bronx,20254002002,254,120,134,4.68
2020,CB2020,005,2,Bronx,20254002003,230,123,107,4.68
2020,CB2020,005,2,Bronx,20255001000,1990,991,999,8.42
2020,CB2020,005,2,Bronx,20255001001,479,213,266,5.75
2020,CB2020,005,2,Bronx,20255002000,3558,1732,1826,7.58
2020,CB2020,005,2,Bronx,20255002001,461,240,221,4.64
2020,CB2020,005,2,Bronx,20255003000,1079,533,546,6.47
2020,CB2020,005,2,Bronx,20255003001,344,161,183,7.52
2020,CB2020,005,2,Bronx,20255003002,181,73,108,1.29
2020,CB2020,005,2,Bronx,20256001000,530,251,279,3.74
2020,CB2020,005,2,Bronx,20256001001,155,73,82,3.7
2020,CB2020,005,2,Bronx,20256001002,155,69,86,3.64
2020,CB2020,005,2,Bronx,20256001003,178,87,91,3.48
2020,CB2020,005,2,Bronx,20256001004,57,46,11,3.69
2020,CB2020,005,2,Bronx,20256001005,0,0,0,1.95
2020,CB2020,005,2,Bronx,20256002000,123,57,66,5.53
2020,CB2020,005,2,Bronx,20256002001,191,103,88,5.95
2020,CB2020,005,2,Bronx,20256002002,89,45,44,3.16
2020,CB2020,005,2,Bronx,20256002003,382,188,194,9.41
2020,CB2020,005,2,Bronx,20256002004,48,34,14,2.52
2020,CB2020,005,2,Bronx,20257001000,771,332,439,11.93
2020,CB2020,005,2,Bronx,20257001001,424,193,231,2.63
2020,CB2020,005,2,Bronx,20257001002,614,294,320,5.15
2020,CB2020,005,2,Bronx,20257001003,0,0,0,1.92
2020,CB2020,005,2,Bronx,20257001004,0,0,0,5.67
2020,CB2020,005,2,Bronx,20257001005,0,0,0,10.75
2020,CB2020,005,2,Bronx,20257001006,0,0,0,0.37
2020,CB2020,005,2,Bronx,20257001007,0,0,0,0.53
2020,CB2020,005,2,Bronx,20257001008,0,0,0,0.9
2020,CB2020,005,2,Bronx,20261001000,1702,797,905,41.51
2020,CB2020,005,2,Bronx,20261001001,358,165,193,1.67
2020,CB2020,005,2,Bronx,20263001000,1232,548,684,5.39
2020,CB2020,005,2,Bronx,20263001001,6,4,2,8.7
2020,CB2020,005,2,Bronx,20263002000,684,301,383,2.06
2020,CB2020,005,2,Bronx,20263002001,376,202,174,1.47
2020,CB2020,005,2,Bronx,20263003000,1863,869,994,7.75
2020,CB2020,005,2,Bronx,20263004000,755,331,424,3.81
2020,CB2020,005,2,Bronx,20263005000,1872,829,1043,10.06
2020,CB2020,005,2,Bronx,20264001000,145,67,78,2.66
2020,CB2020,005,2,Bronx,20264001001,228,110,118,3.9
2020,CB2020,005,2,Bronx,20264001002,171,88,83,2.83
2020,CB2020,005,2,Bronx,20264001003,177,94,83,4.4
2020,CB2020,005,2,Bronx,20264001004,99,46,53,1.96
2020,CB2020,005,2,Bronx,20264001005,201,117,84,3.96
2020,CB2020,005,2,Bronx,20264001006,319,153,166,5.68
2020,CB2020,005,2,Bronx,20264001007,175,82,93,3.31
2020,CB2020,005,2,Bronx,20264001008,144,66,78,2.9
2020,CB2020,005,2,Bronx,20264002000,175,84,91,3.11
2020,CB2020,005,2,Bronx,20264002001,173,73,100,3.34
2020,CB2020,005,2,Bronx,20264002002,240,123,117,3.25
2020,CB2020,005,2,Bronx,20264002003,97,53,44,2.98
2020,CB2020,005,2,Bronx,20264002004,25,6,19,0.51
2020,CB2020,005,2,Bronx,20264002005,154,67,87,3.53
2020,CB2020,005,2,Bronx,20264002006,91,24,67,1.77
2020,CB2020,005,2,Bronx,20264002007,32,8,24,0.65
2020,CB2020,005,2,Bronx,20264002008,55,47,8,1.09
2020,CB2020,005,2,Bronx,20264002009,110,58,52,2.32
2020,CB2020,005,2,Bronx,20264003000,193,83,110,4.24
2020,CB2020,005,2,Bronx,20264003001,231,102,129,3.79
2020,CB2020,005,2,Bronx,20264003002,172,63,109,3.12
2020,CB2020,005,2,Bronx,20264003003,197,88,109,3.49
2020,CB2020,005,2,Bronx,20264003004,189,91,98,3.73
2020,CB2020,005,2,Bronx,20264003005,223,106,117,3.6
2020,CB2020,005,2,Bronx,20264003006,92,59,33,1.66
2020,CB2020,005,2,Bronx,20264003007,106,74,32,5.16
2020,CB2020,005,2,Bronx,20264004000,170,67,103,3.01
2020,CB2020,005,2,Bronx,20264004001,240,110,130,3.57
2020,CB2020,005,2,Bronx,20264004002,0,0,0,0.27
2020,CB2020,005,2,Bronx,20264004003,0,0,0,0.39
2020,CB2020,005,2,Bronx,20264004004,327,178,149,3.66
2020,CB2020,005,2,Bronx,20264004005,186,69,117,2.82
2020,CB2020,005,2,Bronx,20264004006,149,70,79,2.82
2020,CB2020,005,2,Bronx,20264004007,338,174,164,3.72
2020,CB2020,005,2,Bronx,20264004008,69,37,32,2.19
2020,CB2020,005,2,Bronx,20265001000,0,0,0,9.71
2020,CB2020,005,2,Bronx,20265001001,694,334,360,5.25
2020,CB2020,005,2,Bronx,20265001002,195,111,84,3.65
2020,CB2020,005,2,Bronx,20265001003,149,54,95,3.03
2020,CB2020,005,2,Bronx,20265001004,827,385,442,3.6
2020,CB2020,005,2,Bronx,20265002000,1767,828,939,4.54
2020,CB2020,005,2,Bronx,20265002001,266,126,140,3.35
2020,CB2020,005,2,Bronx,20265003000,1200,571,629,3.99
2020,CB2020,005,2,Bronx,20265003001,824,397,427,3.34
2020,CB2020,005,2,Bronx,20265004000,706,329,377,4.36
2020,CB2020,005,2,Bronx,20265004001,538,258,280,5.13
2020,CB2020,005,2,Bronx,20266011000,0,0,0,1.43
2020,CB2020,005,2,Bronx,20266011001,638,290,348,3.43
2020,CB2020,005,2,Bronx,20266011002,518,228,290,4.65
2020,CB2020,005,2,Bronx,20266011003,78,36,42,1.65
2020,CB2020,005,2,Bronx,20266011004,78,42,36,1.31
2020,CB2020,005,2,Bronx,20266011005,255,111,144,2.82
2020,CB2020,005,2,Bronx,20266011006,101,49,52,1.1
2020,CB2020,005,2,Bronx,20266012000,94,40,54,1.65
2020,CB2020,005,2,Bronx,20266012001,478,217,261,4.39
2020,CB2020,005,2,Bronx,20266012002,283,125,158,4.85
2020,CB2020,005,2,Bronx,20266013000,268,149,119,4.63
2020,CB2020,005,2,Bronx,20266013001,247,116,131,4.89
2020,CB2020,005,2,Bronx,20266013002,151,64,87,2.64
2020,CB2020,005,2,Bronx,20266013003,139,86,53,2.61
2020,CB2020,005,2,Bronx,20266021000,657,310,347,3.5
2020,CB2020,005,2,Bronx,20266021001,190,86,104,3.7
2020,CB2020,005,2,Bronx,20266021002,344,172,172,3.7
2020,CB2020,005,2,Bronx,20266021003,219,107,112,3.54
2020,CB2020,005,2,Bronx,20266021004,314,153,161,3.74
2020,CB2020,005,2,Bronx,20266022000,254,114,140,3.49
2020,CB2020,005,2,Bronx,20266022001,0,0,0,0.44
2020,CB2020,005,2,Bronx,20266022002,359,160,199,4.26
2020,CB2020,005,2,Bronx,20266022003,392,174,218,4.14
2020,CB2020,005,2,Bronx,20266022004,517,265,252,4.15
2020,CB2020,005,2,Bronx,20266023000,114,47,67,3.44
2020,CB2020,005,2,Bronx,20266023001,167,89,78,2.19
2020,CB2020,005,2,Bronx,20266023002,0,0,0,0.45
2020,CB2020,005,2,Bronx,20266023003,219,114,105,4.2
2020,CB2020,005,2,Bronx,20266023004,291,138,153,3.91
2020,CB2020,005,2,Bronx,20266023005,230,122,108,3.85
2020,CB2020,005,2,Bronx,20266023006,187,90,97,1.91
2020,CB2020,005,2,Bronx,20266023007,138,69,69,2.39
2020,CB2020,005,2,Bronx,20266023008,137,76,61,3.1
2020,CB2020,005,2,Bronx,20266023009,57,31,26,1.22
2020,CB2020,005,2,Bronx,20266024000,706,314,392,4.19
2020,CB2020,005,2,Bronx,20266025000,132,48,84,2.55
2020,CB2020,005,2,Bronx,20266025001,170,110,60,2.76
2020,CB2020,005,2,Bronx,20266025002,615,286,329,4.14
2020,CB2020,005,2,Bronx,20267011000,473,213,260,2.31
2020,CB2020,005,2,Bronx,20267011001,427,200,227,2.13
2020,CB2020,005,2,Bronx,20267011002,601,282,319,3.07
2020,CB2020,005,2,Bronx,20267012000,1512,688,824,4.81
2020,CB2020,005,2,Bronx,20267013000,970,474,496,4.48
2020,CB2020,005,2,Bronx,20267013001,0,0,0,0.28
2020,CB2020,005,2,Bronx,20267021000,1037,453,584,4.77
2020,CB2020,005,2,Bronx,20267021001,695,295,400,4.45
2020,CB2020,005,2,Bronx,20267021002,96,49,47,3.18
2020,CB2020,005,2,Bronx,20267022000,1057,467,590,3.97
2020,CB2020,005,2,Bronx,20267023000,1232,559,673,8.35
2020,CB2020,005,2,Bronx,20267024000,623,290,333,5.18
2020,CB2020,005,2,Bronx,20267025000,749,353,396,4.24
2020,CB2020,005,2,Bronx,20267026000,500,232,268,2.56
2020,CB2020,005,2,Bronx,20267026001,1033,489,544,4.41
2020,CB2020,005,2,Bronx,20269001000,0,0,0,2.74
2020,CB2020,005,2,Bronx,20269001001,693,307,386,6.2
2020,CB2020,005,2,Bronx,20269001002,528,212,316,3.99
2020,CB2020,005,2,Bronx,20269001003,0,0,0,0.31
2020,CB2020,005,2,Bronx,20269001004,227,138,89,15.77
2020,CB2020,005,2,Bronx,20269001005,0,0,0,4.5
2020,CB2020,005,2,Bronx,20269001006,0,0,0,1.89
2020,CB2020,005,2,Bronx,20269001007,48,16,32,17.06
2020,CB2020,005,2,Bronx,20269001008,0,0,0,21.99
2020,CB2020,005,2,Bronx,20269001009,23,20,3,1.48
2020,CB2020,005,2,Bronx,20269002000,585,268,317,6.47
2020,CB2020,005,2,Bronx,20269002001,32,19,13,0.37
2020,CB2020,005,2,Bronx,20269002002,1169,559,610,6.86
2020,CB2020,005,2,Bronx,20269003000,821,391,430,5.28
2020,CB2020,005,2,Bronx,20273001000,0,0,0,3.49
2020,CB2020,005,2,Bronx,20273001001,0,0,0,1.39
2020,CB2020,005,2,Bronx,20273001002,0,0,0,0.94
2020,CB2020,005,2,Bronx,20273001003,1125,538,587,4.74
2020,CB2020,005,2,Bronx,20273001004,411,175,236,3.81
2020,CB2020,005,2,Bronx,20273002000,99,60,39,1.56
2020,CB2020,005,2,Bronx,20273002001,242,126,116,2.54
2020,CB2020,005,2,Bronx,20273002002,539,232,307,5.81
2020,CB2020,005,2,Bronx,20273002003,653,277,376,2.25
2020,CB2020,005,2,Bronx,20273003000,1545,715,830,6.3
2020,CB2020,005,2,Bronx,20273003001,829,424,405,4.74
2020,CB2020,005,2,Bronx,20273004000,923,432,491,3.85
2020,CB2020,005,2,Bronx,20273004001,1573,769,804,8.84
2020,CB2020,005,2,Bronx,20274011000,98,36,62,2.43
2020,CB2020,005,2,Bronx,20274011001,40,25,15,1.33
2020,CB2020,005,2,Bronx,20274011002,171,67,104,4.54
2020,CB2020,005,2,Bronx,20274011003,204,114,90,4.51
2020,CB2020,005,2,Bronx,20274011004,66,27,39,2.29
2020,CB2020,005,2,Bronx,20274011005,145,72,73,4.53
2020,CB2020,005,2,Bronx,20274012000,184,111,73,4.64
2020,CB2020,005,2,Bronx,20274012001,141,57,84,3.58
2020,CB2020,005,2,Bronx,20274012002,184,102,82,4.53
2020,CB2020,005,2,Bronx,20274012003,146,69,77,4.62
2020,CB2020,005,2,Bronx,20274012004,130,47,83,3.2
2020,CB2020,005,2,Bronx,20274012005,73,26,47,2.59
2020,CB2020,005,2,Bronx,20274013000,114,58,56,4.72
2020,CB2020,005,2,Bronx,20274013001,16,10,6,1.09
2020,CB2020,005,2,Bronx,20274013002,100,36,64,3.02
2020,CB2020,005,2,Bronx,20274013003,141,58,83,4.79
2020,CB2020,005,2,Bronx,20274013004,230,97,133,7.37
2020,CB2020,005,2,Bronx,20274013005,390,198,192,11.18
2020,CB2020,005,2,Bronx,20274013006,124,59,65,4.5
2020,CB2020,005,2,Bronx,20274013007,116,40,76,3.74
2020,CB2020,005,2,Bronx,20274013008,56,9,47,2.23
2020,CB2020,005,2,Bronx,20274013009,104,54,50,2.63
2020,CB2020,005,2,Bronx,20274013010,332,157,175,11.68
2020,CB2020,005,2,Bronx,20274013011,65,52,13,3.34
2020,CB2020,005,2,Bronx,20274013012,35,17,18,0.63
2020,CB2020,005,2,Bronx,20274013013,116,68,48,4.9
2020,CB2020,005,2,Bronx,20274014000,0,0,0,1.09
2020,CB2020,005,2,Bronx,20274014001,0,0,0,0.76
2020,CB2020,005,2,Bronx,20274014002,0,0,0,1.47
2020,CB2020,005,2,Bronx,20274014003,0,0,0,4.98
2020,CB2020,005,2,Bronx,20274014004,0,0,0,1.39
2020,CB2020,005,2,Bronx,20274014005,0,0,0,1.01
2020,CB2020,005,2,Bronx,20274014006,0,0,0,1.62
2020,CB2020,005,2,Bronx,20274014007,0,0,0,1.22
2020,CB2020,005,2,Bronx,20274014008,0,0,0,2.3
2020,CB2020,005,2,Bronx,20274014009,0,0,0,1.08
2020,CB2020,005,2,Bronx,20274014010,97,54,43,6.15
2020,CB2020,005,2,Bronx,20274014011,149,56,93,3.45
2020,CB2020,005,2,Bronx,20274014012,142,64,78,3.04
2020,CB2020,005,2,Bronx,20274014013,0,0,0,0.97
2020,CB2020,005,2,Bronx,20274014014,0,0,0,2.26
2020,CB2020,005,2,Bronx,20274014015,0,0,0,0.76
2020,CB2020,005,2,Bronx,20274014016,0,0,0,3.69
2020,CB2020,005,2,Bronx,20274014017,97,29,68,1.91
2020,CB2020,005,2,Bronx,20274014018,99,62,37,2.07
2020,CB2020,005,2,Bronx,20274014019,116,73,43,2.54
2020,CB2020,005,2,Bronx,20274014020,82,39,43,2.09
2020,CB2020,005,2,Bronx,20274014021,42,7,35,1.33
2020,CB2020,005,2,Bronx,20274014022,117,56,61,2.71
2020,CB2020,005,2,Bronx,20274014023,81,24,57,2.23
2020,CB2020,005,2,Bronx,20274014024,114,48,66,2.77
2020,CB2020,005,2,Bronx,20274014025,109,62,47,2.44
2020,CB2020,005,2,Bronx,20274014026,72,42,30,2.4
2020,CB2020,005,2,Bronx,20274014027,120,60,60,2.46
2020,CB2020,005,2,Bronx,20274014028,178,116,62,2.46
2020,CB2020,005,2,Bronx,20274020001,0,0,0,0
2020,CB2020,005,2,Bronx,20274020002,0,0,0,0
2020,CB2020,005,2,Bronx,20274021000,179,82,97,17.72
2020,CB2020,005,2,Bronx,20274021001,50,21,29,2.36
2020,CB2020,005,2,Bronx,20274021002,71,38,33,4.66
2020,CB2020,005,2,Bronx,20274021003,166,98,68,4.21
2020,CB2020,005,2,Bronx,20274021004,104,42,62,3.19
2020,CB2020,005,2,Bronx,20274021005,118,50,68,4.78
2020,CB2020,005,2,Bronx,20274021006,127,61,66,4.83
2020,CB2020,005,2,Bronx,20274021007,113,41,72,5.18
2020,CB2020,005,2,Bronx,20274021008,431,147,284,14.04
2020,CB2020,005,2,Bronx,20274021009,63,32,31,2.07
2020,CB2020,005,2,Bronx,20274022000,220,103,117,5.24
2020,CB2020,005,2,Bronx,20274022001,187,98,89,4.84
2020,CB2020,005,2,Bronx,20274022002,182,78,104,4.51
2020,CB2020,005,2,Bronx,20274022003,168,92,76,4.25
2020,CB2020,005,2,Bronx,20274023000,340,203,137,12.01
2020,CB2020,005,2,Bronx,20274023001,125,39,86,3.79
2020,CB2020,005,2,Bronx,20274023002,95,48,47,3
2020,CB2020,005,2,Bronx,20274023003,105,51,54,3.49
2020,CB2020,005,2,Bronx,20274023004,214,118,96,4.58
2020,CB2020,005,2,Bronx,20274023005,223,95,128,5.67
2020,CB2020,005,2,Bronx,20274023006,272,116,156,10.31
2020,CB2020,005,2,Bronx,20276000001,0,0,0,0
2020,CB2020,005,2,Bronx,20276000002,0,0,0,0
2020,CB2020,005,2,Bronx,20276001000,3,3,0,305.8
2020,CB2020,005,2,Bronx,20276001001,0,0,0,0.46
2020,CB2020,005,2,Bronx,20276001002,0,0,0,0.91
2020,CB2020,005,2,Bronx,20276001003,0,0,0,1.67
2020,CB2020,005,2,Bronx,20276001004,0,0,0,3.87
2020,CB2020,005,2,Bronx,20276001005,0,0,0,57.32
2020,CB2020,005,2,Bronx,20276001006,0,0,0,6.98
2020,CB2020,005,2,Bronx,20276001007,0,0,0,0.15
2020,CB2020,005,2,Bronx,20276001008,3,2,1,23.56
2020,CB2020,005,2,Bronx,20276001009,0,0,0,8.23
2020,CB2020,005,2,Bronx,20276001010,0,0,0,2.27
2020,CB2020,005,2,Bronx,20276001011,0,0,0,0.66
2020,CB2020,005,2,Bronx,20276001012,0,0,0,1.18
2020,CB2020,005,2,Bronx,20276001013,0,0,0,14.48
2020,CB2020,005,2,Bronx,20276001014,0,0,0,1.3
2020,CB2020,005,2,Bronx,20276001015,0,0,0,1.5
2020,CB2020,005,2,Bronx,20276001016,0,0,0,0.64
2020,CB2020,005,2,Bronx,20276001017,0,0,0,1.98
2020,CB2020,005,2,Bronx,20276001018,0,0,0,0.81
2020,CB2020,005,2,Bronx,20276001019,0,0,0,0.65
2020,CB2020,005,2,Bronx,20276001020,0,0,0,0.7
2020,CB2020,005,2,Bronx,20276001021,0,0,0,3.06
2020,CB2020,005,2,Bronx,20276001022,0,0,0,2.3
2020,CB2020,005,2,Bronx,20276001023,0,0,0,5.56
2020,CB2020,005,2,Bronx,20276001024,0,0,0,1.39
2020,CB2020,005,2,Bronx,20276001025,0,0,0,3.05
2020,CB2020,005,2,Bronx,20276001026,0,0,0,2.85
2020,CB2020,005,2,Bronx,20276001027,17,7,10,0.83
2020,CB2020,005,2,Bronx,20277001000,518,232,286,3.9
2020,CB2020,005,2,Bronx,20277001001,209,115,94,4.02
2020,CB2020,005,2,Bronx,20277001002,381,173,208,1.76
2020,CB2020,005,2,Bronx,20277002000,0,0,0,0.47
2020,CB2020,005,2,Bronx,20277002001,0,0,0,2.48
2020,CB2020,005,2,Bronx,20277002002,0,0,0,1.14
2020,CB2020,005,2,Bronx,20277002003,0,0,0,0.74
2020,CB2020,005,2,Bronx,20277002004,0,0,0,0.83
2020,CB2020,005,2,Bronx,20277002005,0,0,0,1.72
2020,CB2020,005,2,Bronx,20277002006,546,256,290,3.04
2020,CB2020,005,2,Bronx,20277002007,529,264,265,4.78
2020,CB2020,005,2,Bronx,20277002008,0,0,0,0.4
2020,CB2020,005,2,Bronx,20277003000,499,245,254,4.73
2020,CB2020,005,2,Bronx,20277003001,270,124,146,3.82
2020,CB2020,005,2,Bronx,20277004000,2016,909,1107,9.64
2020,CB2020,005,2,Bronx,20279001000,453,213,240,5.28
2020,CB2020,005,2,Bronx,20279001001,0,0,0,0.86
2020,CB2020,005,2,Bronx,20279001002,0,0,0,1.75
2020,CB2020,005,2,Bronx,20279001003,154,69,85,7.22
2020,CB2020,005,2,Bronx,20279001004,718,340,378,6.11
2020,CB2020,005,2,Bronx,20279002000,65,31,34,0.9
2020,CB2020,005,2,Bronx,20279002001,1168,513,655,8.77
2020,CB2020,005,2,Bronx,20279003000,1271,624,647,5.69
2020,CB2020,005,2,Bronx,20279003001,620,295,325,6.38
2020,CB2020,005,2,Bronx,20279004000,957,412,545,8.48
2020,CB2020,005,2,Bronx,20279004001,482,239,243,4.33
2020,CB2020,005,2,Bronx,20279005000,1064,489,575,6.67
2020,CB2020,005,2,Bronx,20279006000,1193,563,630,5.84
2020,CB2020,005,2,Bronx,20281001000,448,208,240,6.06
2020,CB2020,005,2,Bronx,20281001001,971,442,529,5.47
2020,CB2020,005,2,Bronx,20281002000,207,92,115,1.15
2020,CB2020,005,2,Bronx,20281002001,600,259,341,3.96
2020,CB2020,005,2,Bronx,20281003000,70,32,38,3.48
2020,CB2020,005,2,Bronx,20281003001,873,331,542,6.32
2020,CB2020,005,2,Bronx,20281003002,551,238,313,5.47
2020,CB2020,005,2,Bronx,20283001000,0,0,0,3.73
2020,CB2020,005,2,Bronx,20283001001,41,24,17,5.44
2020,CB2020,005,2,Bronx,20283001002,13,8,5,6.3
2020,CB2020,005,2,Bronx,20283001003,0,0,0,5.59
2020,CB2020,005,2,Bronx,20283001004,849,342,507,5.77
2020,CB2020,005,2,Bronx,20283001005,0,0,0,2.03
2020,CB2020,005,2,Bronx,20283002000,104,46,58,2.15
2020,CB2020,005,2,Bronx,20283002001,3,2,1,2.76
2020,CB2020,005,2,Bronx,20283002002,163,63,100,1.55
2020,CB2020,005,2,Bronx,20283002003,0,0,0,0.17
2020,CB2020,005,2,Bronx,20283002004,98,55,43,1.97
2020,CB2020,005,2,Bronx,20283002005,669,297,372,1.89
2020,CB2020,005,2,Bronx,20283002006,144,79,65,2.99
2020,CB2020,005,2,Bronx,20283002007,0,0,0,4.49
2020,CB2020,005,2,Bronx,20283002008,0,0,0,3.38
2020,CB2020,005,2,Bronx,20283002009,0,0,0,5.97
2020,CB2020,005,2,Bronx,20284001000,9,2,7,21.53
2020,CB2020,005,2,Bronx,20284001001,0,0,0,6.26
2020,CB2020,005,2,Bronx,20284001002,0,0,0,0.62
2020,CB2020,005,2,Bronx,20284001003,241,142,99,171.12
2020,CB2020,005,2,Bronx,20284001004,0,0,0,4.96
2020,CB2020,005,2,Bronx,20284001005,0,0,0,1.07
2020,CB2020,005,2,Bronx,20284001006,0,0,0,4.79
2020,CB2020,005,2,Bronx,20284001007,0,0,0,3.19
2020,CB2020,005,2,Bronx,20284001008,21,7,14,30.29
2020,CB2020,005,2,Bronx,20284001009,0,0,0,8.23
2020,CB2020,005,2,Bronx,20284001010,0,0,0,1.71
2020,CB2020,005,2,Bronx,20284001011,0,0,0,2.4
2020,CB2020,005,2,Bronx,20284001012,0,0,0,0.78
2020,CB2020,005,2,Bronx,20284001013,0,0,0,6.35
2020,CB2020,005,2,Bronx,20284001014,0,0,0,3.66
2020,CB2020,005,2,Bronx,20284001015,0,0,0,1
2020,CB2020,005,2,Bronx,20284001016,11,7,4,5.35
2020,CB2020,005,2,Bronx,20284001017,0,0,0,2.78
2020,CB2020,005,2,Bronx,20284001018,0,0,0,0.65
2020,CB2020,005,2,Bronx,20284001019,15,8,7,0.78
2020,CB2020,005,2,Bronx,20284001020,0,0,0,0.4
2020,CB2020,005,2,Bronx,20285001000,407,194,213,5.28
2020,CB2020,005,2,Bronx,20285001001,1159,515,644,9.98
2020,CB2020,005,2,Bronx,20285002000,403,184,219,4.56
2020,CB2020,005,2,Bronx,20285003000,213,90,123,2.43
2020,CB2020,005,2,Bronx,20285003001,302,138,164,14.51
2020,CB2020,005,2,Bronx,20285003002,0,0,0,5.29
2020,CB2020,005,2,Bronx,20285004000,0,0,0,0.92
2020,CB2020,005,2,Bronx,20285004001,0,0,0,2.93
2020,CB2020,005,2,Bronx,20285004002,0,0,0,2.25
2020,CB2020,005,2,Bronx,20285004003,181,103,78,3.64
2020,CB2020,005,2,Bronx,20285004004,344,163,181,3.79
2020,CB2020,005,2,Bronx,20285004005,210,86,124,3.85
2020,CB2020,005,2,Bronx,20285004006,169,93,76,1.6
2020,CB2020,005,2,Bronx,20285004007,0,0,0,1.11
2020,CB2020,005,2,Bronx,20285004008,52,16,36,3
2020,CB2020,005,2,Bronx,20286001000,0,0,0,10.58
2020,CB2020,005,2,Bronx,20286001001,50,27,23,2.57
2020,CB2020,005,2,Bronx,20286001002,116,68,48,3.21
2020,CB2020,005,2,Bronx,20286001003,125,60,65,3.5
2020,CB2020,005,2,Bronx,20286001004,142,79,63,3.64
2020,CB2020,005,2,Bronx,20286001005,63,33,30,5.94
2020,CB2020,005,2,Bronx,20286001006,168,72,96,4.4
2020,CB2020,005,2,Bronx,20286002000,190,101,89,4.5
2020,CB2020,005,2,Bronx,20286002001,292,126,166,5.5
2020,CB2020,005,2,Bronx,20286002002,135,72,63,3.23
2020,CB2020,005,2,Bronx,20286002003,114,74,40,2.37
2020,CB2020,005,2,Bronx,20287001000,354,177,177,4.31
2020,CB2020,005,2,Bronx,20287001001,256,136,120,4.19
2020,CB2020,005,2,Bronx,20287001002,283,138,145,4.45
2020,CB2020,005,2,Bronx,20287001003,106,43,63,4.87
2020,CB2020,005,2,Bronx,20287001004,251,107,144,3.86
2020,CB2020,005,2,Bronx,20287001005,282,96,186,3.86
2020,CB2020,005,2,Bronx,20287002000,1077,494,583,5.86
2020,CB2020,005,2,Bronx,20287003000,541,247,294,3.7
2020,CB2020,005,2,Bronx,20287003001,803,393,410,3.28
2020,CB2020,005,2,Bronx,20288001000,60,30,30,2.37
2020,CB2020,005,2,Bronx,20288001001,64,30,34,2.53
2020,CB2020,005,2,Bronx,20288001002,86,47,39,2.93
2020,CB2020,005,2,Bronx,20288001003,140,57,83,4.75
2020,CB2020,005,2,Bronx,20288001004,175,104,71,4.92
2020,CB2020,005,2,Bronx,20288001005,97,40,57,4.9
2020,CB2020,005,2,Bronx,20288001006,223,107,116,5.27
2020,CB2020,005,2,Bronx,20288002000,107,58,49,2.96
2020,CB2020,005,2,Bronx,20288002001,59,25,34,2.13
2020,CB2020,005,2,Bronx,20288002002,113,41,72,3.15
2020,CB2020,005,2,Bronx,20288002003,95,43,52,3.11
2020,CB2020,005,2,Bronx,20288002004,98,61,37,3.39
2020,CB2020,005,2,Bronx,20288002005,148,72,76,4.95
2020,CB2020,005,2,Bronx,20288002006,155,71,84,5.32
2020,CB2020,005,2,Bronx,20288002007,64,24,40,2
2020,CB2020,005,2,Bronx,20288003000,501,244,257,3.84
2020,CB2020,005,2,Bronx,20288003001,192,89,103,3.33
2020,CB2020,005,2,Bronx,20288004000,109,46,63,2.71
2020,CB2020,005,2,Bronx,20288004001,77,53,24,2.8
2020,CB2020,005,2,Bronx,20288004002,97,46,51,3.06
2020,CB2020,005,2,Bronx,20288004003,78,45,33,2.86
2020,CB2020,005,2,Bronx,20288004004,82,36,46,2.72
2020,CB2020,005,2,Bronx,20288004005,108,42,66,2.78
2020,CB2020,005,2,Bronx,20288004006,74,20,54,2.18
2020,CB2020,005,2,Bronx,20288004007,47,30,17,1.53
2020,CB2020,005,2,Bronx,20288004008,6,1,5,0.57
2020,CB2020,005,2,Bronx,20289001000,333,151,182,1.91
2020,CB2020,005,2,Bronx,20289001001,188,96,92,1.57
2020,CB2020,005,2,Bronx,20289001002,257,126,131,3.93
2020,CB2020,005,2,Bronx,20289001003,148,59,89,2.8
2020,CB2020,005,2,Bronx,20289001004,107,33,74,2.99
2020,CB2020,005,2,Bronx,20289001005,0,0,0,0.17
2020,CB2020,005,2,Bronx,20289002000,1734,817,917,5.16
2020,CB2020,005,2,Bronx,20289003000,539,210,329,3.52
2020,CB2020,005,2,Bronx,20289003001,219,95,124,3.14
2020,CB2020,005,2,Bronx,20289003002,132,72,60,4.36
2020,CB2020,005,2,Bronx,20289003003,165,71,94,5.61
2020,CB2020,005,2,Bronx,20289003004,50,27,23,3.7
2020,CB2020,005,2,Bronx,20289003005,0,0,0,4.69
2020,CB2020,005,2,Bronx,20289003006,0,0,0,3.16
2020,CB2020,005,2,Bronx,20289004000,577,286,291,1.77
2020,CB2020,005,2,Bronx,20289004001,287,108,179,1.23
2020,CB2020,005,2,Bronx,20293010001,0,0,0,0
2020,CB2020,005,2,Bronx,20293011000,985,446,539,32.6
2020,CB2020,005,2,Bronx,20293011001,18,8,10,1.88
2020,CB2020,005,2,Bronx,20293011002,0,0,0,0.95
2020,CB2020,005,2,Bronx,20293011003,0,0,0,12.3
2020,CB2020,005,2,Bronx,20293011004,0,0,0,4.47
2020,CB2020,005,2,Bronx,20293012000,262,111,151,9.39
2020,CB2020,005,2,Bronx,20293012001,130,70,60,2.79
2020,CB2020,005,2,Bronx,20293012002,559,241,318,4.24
2020,CB2020,005,2,Bronx,20293012003,0,0,0,0.87
2020,CB2020,005,2,Bronx,20293012004,0,0,0,1.37
2020,CB2020,005,2,Bronx,20293021000,788,327,461,28.11
2020,CB2020,005,2,Bronx,20293021001,44,29,15,5.2
2020,CB2020,005,2,Bronx,20293021002,23,6,17,3.04
2020,CB2020,005,2,Bronx,20293022000,0,0,0,0.27
2020,CB2020,005,2,Bronx,20293022001,721,324,397,11.94
2020,CB2020,005,2,Bronx,20293022002,348,131,217,4.54
2020,CB2020,005,2,Bronx,20293022003,0,0,0,0.34
2020,CB2020,005,2,Bronx,20293023000,42,28,14,3.78
2020,CB2020,005,2,Bronx,20293023001,44,9,35,0.83
2020,CB2020,005,2,Bronx,20293023002,1010,482,528,5.84
2020,CB2020,005,2,Bronx,20293023003,598,221,377,2.8
2020,CB2020,005,2,Bronx,20293024000,0,0,0,1.14
2020,CB2020,005,2,Bronx,20293024001,0,0,0,1.01
2020,CB2020,005,2,Bronx,20293024002,0,0,0,2.01
2020,CB2020,005,2,Bronx,20293024003,0,0,0,0.3
2020,CB2020,005,2,Bronx,20293024004,0,0,0,0.65
2020,CB2020,005,2,Bronx,20293024005,400,170,230,5.51
2020,CB2020,005,2,Bronx,20293024006,349,175,174,3.58
2020,CB2020,005,2,Bronx,20293024007,238,128,110,2.59
2020,CB2020,005,2,Bronx,20293024008,225,111,114,3.8
2020,CB2020,005,2,Bronx,20293024009,67,30,37,5.48
2020,CB2020,005,2,Bronx,20293024010,80,34,46,4.97
2020,CB2020,005,2,Bronx,20293024011,72,40,32,2.88
2020,CB2020,005,2,Bronx,20293024012,199,75,124,4.48
2020,CB2020,005,2,Bronx,20295001000,179,87,92,1.99
2020,CB2020,005,2,Bronx,20295001001,433,187,246,6.79
2020,CB2020,005,2,Bronx,20295001002,437,194,243,2.7
2020,CB2020,005,2,Bronx,20295001003,118,61,57,2.33
2020,CB2020,005,2,Bronx,20295001004,342,158,184,2.3
2020,CB2020,005,2,Bronx,20295001005,252,122,130,2.6
2020,CB2020,005,2,Bronx,20295002000,252,116,136,2.94
2020,CB2020,005,2,Bronx,20295002001,588,275,313,4.28
2020,CB2020,005,2,Bronx,20295002002,36,18,18,1.96
2020,CB2020,005,2,Bronx,20295002003,216,109,107,1.74
2020,CB2020,005,2,Bronx,20295003000,640,303,337,6.29
2020,CB2020,005,2,Bronx,20295003001,413,200,213,3.74
2020,CB2020,005,2,Bronx,20295004000,143,83,60,4.5
2020,CB2020,005,2,Bronx,20295004001,566,262,304,14.28
2020,CB2020,005,2,Bronx,20296001000,0,0,0,8.21
2020,CB2020,005,2,Bronx,20296001001,0,0,0,3.94
2020,CB2020,005,2,Bronx,20296001002,0,0,0,3.73
2020,CB2020,005,2,Bronx,20296001003,0,0,0,9.19
2020,CB2020,005,2,Bronx,20296001004,0,0,0,0.5
2020,CB2020,005,2,Bronx,20296001005,0,0,0,6.37
2020,CB2020,005,2,Bronx,20296001006,0,0,0,6.57
2020,CB2020,005,2,Bronx,20296001007,0,0,0,7.43
2020,CB2020,005,2,Bronx,20296001008,0,0,0,2.55
2020,CB2020,005,2,Bronx,20296001009,0,0,0,1.15
2020,CB2020,005,2,Bronx,20296001010,0,0,0,1.7
2020,CB2020,005,2,Bronx,20296001011,1020,491,529,8.72
2020,CB2020,005,2,Bronx,20296001012,3,2,1,0.54
2020,CB2020,005,2,Bronx,20296001013,289,133,156,5.17
2020,CB2020,005,2,Bronx,20296001014,176,87,89,17.5
2020,CB2020,005,2,Bronx,20296001015,36,14,22,5.22
2020,CB2020,005,2,Bronx,20296001016,0,0,0,0.82
2020,CB2020,005,2,Bronx,20296001017,0,0,0,1.44
2020,CB2020,005,2,Bronx,20296001018,0,0,0,0.5
2020,CB2020,005,2,Bronx,20296001019,0,0,0,3.8
2020,CB2020,005,2,Bronx,20296001020,14,10,4,1.65
2020,CB2020,005,2,Bronx,20296001021,11,6,5,4.56
2020,CB2020,005,2,Bronx,20296001022,79,49,30,3.2
2020,CB2020,005,2,Bronx,20296001023,48,13,35,2.83
2020,CB2020,005,2,Bronx,20296002000,0,0,0,0.67
2020,CB2020,005,2,Bronx,20296002001,1024,513,511,43.94
2020,CB2020,005,2,Bronx,20296002002,178,83,95,26.84
2020,CB2020,005,2,Bronx,20297001000,0,0,0,2.31
2020,CB2020,005,2,Bronx,20297001001,0,0,0,1.8
2020,CB2020,005,2,Bronx,20297001002,0,0,0,3.02
2020,CB2020,005,2,Bronx,20297001003,273,134,139,2.45
2020,CB2020,005,2,Bronx,20297001004,560,223,337,4.42
2020,CB2020,005,2,Bronx,20297001005,528,234,294,3.38
2020,CB2020,005,2,Bronx,20297001006,0,0,0,1.09
2020,CB2020,005,2,Bronx,20297001007,45,16,29,2.08
2020,CB2020,005,2,Bronx,20297002000,760,306,454,5.07
2020,CB2020,005,2,Bronx,20297002001,278,145,133,4.56
2020,CB2020,005,2,Bronx,20297002002,37,20,17,3.23
2020,CB2020,005,2,Bronx,20297002003,303,149,154,7.78
2020,CB2020,005,2,Bronx,20297002004,68,28,40,3.69
2020,CB2020,005,2,Bronx,20297003000,649,289,360,5.1
2020,CB2020,005,2,Bronx,20297003001,150,70,80,1.23
2020,CB2020,005,2,Bronx,20297003002,250,130,120,2.62
2020,CB2020,005,2,Bronx,20297003003,104,46,58,3.69
2020,CB2020,005,2,Bronx,20300001000,0,0,0,3.46
2020,CB2020,005,2,Bronx,20300001001,550,245,305,4.18
2020,CB2020,005,2,Bronx,20300001002,231,106,125,5.84
2020,CB2020,005,2,Bronx,20300001003,185,83,102,2.06
2020,CB2020,005,2,Bronx,20300001004,116,46,70,2.16
2020,CB2020,005,2,Bronx,20300001005,196,90,106,5.6
2020,CB2020,005,2,Bronx,20300002000,94,43,51,2
2020,CB2020,005,2,Bronx,20300002001,277,138,139,4.78
2020,CB2020,005,2,Bronx,20300002002,252,117,135,4.81
2020,CB2020,005,2,Bronx,20300002003,234,116,118,2.14
2020,CB2020,005,2,Bronx,20300002004,215,111,104,4.6
2020,CB2020,005,2,Bronx,20300002005,282,120,162,4.5
2020,CB2020,005,2,Bronx,20300002006,160,89,71,2.58
2020,CB2020,005,2,Bronx,20300003000,357,159,198,4.58
2020,CB2020,005,2,Bronx,20300003001,406,189,217,4.77
2020,CB2020,005,2,Bronx,20300004000,292,126,166,2.6
2020,CB2020,005,2,Bronx,20300004001,415,203,212,3.37
2020,CB2020,005,2,Bronx,20300004002,189,113,76,3.77
2020,CB2020,005,2,Bronx,20300004003,295,152,143,3.99
2020,CB2020,005,2,Bronx,20300005000,152,66,86,6.62
2020,CB2020,005,2,Bronx,20300005001,286,134,152,4.81
2020,CB2020,005,2,Bronx,20300005002,447,200,247,4.81
2020,CB2020,005,2,Bronx,20300006000,473,228,245,4.97
2020,CB2020,005,2,Bronx,20300006001,173,85,88,2.3
2020,CB2020,005,2,Bronx,20300006002,192,97,95,4.83
2020,CB2020,005,2,Bronx,20300006003,122,59,63,2.59
2020,CB2020,005,2,Bronx,20301001000,63,24,39,2.96
2020,CB2020,005,2,Bronx,20301001001,235,102,133,3.2
2020,CB2020,005,2,Bronx,20301001002,363,175,188,2.97
2020,CB2020,005,2,Bronx,20301001003,233,110,123,2.26
2020,CB2020,005,2,Bronx,20301002000,64,36,28,6.06
2020,CB2020,005,2,Bronx,20301002001,669,231,438,18.62
2020,CB2020,005,2,Bronx,20302011000,1051,450,601,3.4
2020,CB2020,005,2,Bronx,20302011001,58,36,22,1.67
2020,CB2020,005,2,Bronx,20302011002,95,42,53,3.22
2020,CB2020,005,2,Bronx,20302011003,32,12,20,9.25
2020,CB2020,005,2,Bronx,20302011004,101,54,47,2.15
2020,CB2020,005,2,Bronx,20302011005,117,44,73,2.1
2020,CB2020,005,2,Bronx,20302011006,0,0,0,1.33
2020,CB2020,005,2,Bronx,20302011007,86,35,51,2.21
2020,CB2020,005,2,Bronx,20302012000,983,390,593,10.17
2020,CB2020,005,2,Bronx,20302012001,21,6,15,3.34
2020,CB2020,005,2,Bronx,20302012002,0,0,0,3.14
2020,CB2020,005,2,Bronx,20302013000,0,0,0,2.9
2020,CB2020,005,2,Bronx,20302013001,1504,618,886,9.89
2020,CB2020,005,2,Bronx,20302021000,2674,1135,1539,7.51
2020,CB2020,005,2,Bronx,20302022000,0,0,0,2.54
2020,CB2020,005,2,Bronx,20302022001,0,0,0,0
2020,CB2020,005,2,Bronx,20302023000,2635,1114,1521,21.18
2020,CB2020,005,2,Bronx,20302023001,0,0,0,6.81
2020,CB2020,005,2,Bronx,20302024000,732,326,406,1.56
2020,CB2020,005,2,Bronx,20302024001,22,8,14,5.61
2020,CB2020,005,2,Bronx,20307011000,108,66,42,20.24
2020,CB2020,005,2,Bronx,20307011001,460,196,264,9.38
2020,CB2020,005,2,Bronx,20307011002,69,30,39,5.3
2020,CB2020,005,2,Bronx,20307011003,0,0,0,3.53
2020,CB2020,005,2,Bronx,20307011004,54,20,34,3.28
2020,CB2020,005,2,Bronx,20307011005,81,18,63,5.29
2020,CB2020,005,2,Bronx,20307011006,156,78,78,4.39
2020,CB2020,005,2,Bronx,20307012000,2065,926,1139,23.62
2020,CB2020,005,2,Bronx,20307012001,209,91,118,3.06
2020,CB2020,005,2,Bronx,20307012002,92,47,45,0.82
2020,CB2020,005,2,Bronx,20307013000,760,371,389,4.4
2020,CB2020,005,2,Bronx,20307013001,370,155,215,2.5
2020,CB2020,005,2,Bronx,20307013002,235,89,146,2.27
2020,CB2020,005,2,Bronx,20307014000,362,170,192,3.26
2020,CB2020,005,2,Bronx,20307014001,164,66,98,1.97
2020,CB2020,005,2,Bronx,20307014002,614,240,374,4.72
2020,CB2020,005,2,Bronx,20309000001,0,0,0,0
2020,CB2020,005,2,Bronx,20309001000,348,107,241,13.99
2020,CB2020,005,2,Bronx,20309001001,0,0,0,11.06
2020,CB2020,005,2,Bronx,20309001002,860,247,613,49.39
2020,CB2020,005,2,Bronx,20309001003,23,11,12,63.25
2020,CB2020,005,2,Bronx,20309001004,30,10,20,2.92
2020,CB2020,005,2,Bronx,20309001005,0,0,0,25.31
2020,CB2020,005,2,Bronx,20309002000,57,37,20,9.04
2020,CB2020,005,2,Bronx,20309002001,53,20,33,34.07
2020,CB2020,005,2,Bronx,20309002002,0,0,0,2.6
2020,CB2020,005,2,Bronx,20309002003,48,9,39,12.23
2020,CB2020,005,2,Bronx,20309002004,27,12,15,2.69
2020,CB2020,005,2,Bronx,20309002005,43,27,16,11.09
2020,CB2020,005,2,Bronx,20309002006,19,10,9,3.26
2020,CB2020,005,2,Bronx,20309002007,48,18,30,7.14
2020,CB2020,005,2,Bronx,20309002008,40,17,23,12.63
2020,CB2020,005,2,Bronx,20309002009,49,32,17,3.72
2020,CB2020,005,2,Bronx,20309002010,30,12,18,5.16
2020,CB2020,005,2,Bronx,20309002011,333,169,164,32.26
2020,CB2020,005,2,Bronx,20309003000,863,396,467,12.13
2020,CB2020,005,2,Bronx,20309003001,279,120,159,3.08
2020,CB2020,005,2,Bronx,20309004000,779,365,414,8.23
2020,CB2020,005,2,Bronx,20309004001,18,7,11,7.02
2020,CB2020,005,2,Bronx,20309004002,0,0,0,5.24
2020,CB2020,005,2,Bronx,20310001000,56,23,33,3.29
2020,CB2020,005,2,Bronx,20310001001,80,43,37,3.32
2020,CB2020,005,2,Bronx,20310001002,303,158,145,4.98
2020,CB2020,005,2,Bronx,20310001003,251,127,124,4.26
2020,CB2020,005,2,Bronx,20310001004,26,16,10,0.89
2020,CB2020,005,2,Bronx,20310001005,41,14,27,1.8
2020,CB2020,005,2,Bronx,20310001006,48,18,30,2.74
2020,CB2020,005,2,Bronx,20310001007,47,22,25,3.57
2020,CB2020,005,2,Bronx,20310001008,74,35,39,3.56
2020,CB2020,005,2,Bronx,20310001009,93,48,45,3.39
2020,CB2020,005,2,Bronx,20310001010,72,39,33,3.24
2020,CB2020,005,2,Bronx,20310001011,71,47,24,3.06
2020,CB2020,005,2,Bronx,20310002000,0,0,0,0.69
2020,CB2020,005,2,Bronx,20310002001,0,0,0,5.52
2020,CB2020,005,2,Bronx,20310002002,89,37,52,25.75
2020,CB2020,005,2,Bronx,20310002003,121,74,47,4.02
2020,CB2020,005,2,Bronx,20310002004,0,0,0,2.86
2020,CB2020,005,2,Bronx,20310002005,0,0,0,1.34
2020,CB2020,005,2,Bronx,20310002006,11,6,5,4.79
2020,CB2020,005,2,Bronx,20310002007,295,101,194,3.02
2020,CB2020,005,2,Bronx,20310002008,122,59,63,4.06
2020,CB2020,005,2,Bronx,20310002009,206,96,110,4.24
2020,CB2020,005,2,Bronx,20310002010,194,81,113,3.92
2020,CB2020,005,2,Bronx,20310002011,113,69,44,3.71
2020,CB2020,005,2,Bronx,20310002012,88,34,54,3.97
2020,CB2020,005,2,Bronx,20310002013,144,91,53,3.98
2020,CB2020,005,2,Bronx,20310002014,133,70,63,4.1
2020,CB2020,005,2,Bronx,20310003000,261,117,144,5.3
2020,CB2020,005,2,Bronx,20310003001,228,125,103,5.33
2020,CB2020,005,2,Bronx,20310003002,195,90,105,5.3
2020,CB2020,005,2,Bronx,20310003003,218,102,116,5.34
2020,CB2020,005,2,Bronx,20310003004,130,65,65,4.07
2020,CB2020,005,2,Bronx,20310003005,114,53,61,4.04
2020,CB2020,005,2,Bronx,20310003006,208,95,113,4.05
2020,CB2020,005,2,Bronx,20310003007,123,69,54,3.65
2020,CB2020,005,2,Bronx,20310003008,88,45,43,3.5
2020,CB2020,005,2,Bronx,20310003009,129,38,91,3.37
2020,CB2020,005,2,Bronx,20312001000,189,96,93,5.31
2020,CB2020,005,2,Bronx,20312001001,104,59,45,3.47
2020,CB2020,005,2,Bronx,20312001002,254,123,131,5.72
2020,CB2020,005,2,Bronx,20312001003,98,51,47,2.91
2020,CB2020,005,2,Bronx,20312001004,154,62,92,3.06
2020,CB2020,005,2,Bronx,20312002000,129,40,89,4.06
2020,CB2020,005,2,Bronx,20312002001,113,60,53,6.57
2020,CB2020,005,2,Bronx,20312002002,121,68,53,5
2020,CB2020,005,2,Bronx,20312002003,115,61,54,3.24
2020,CB2020,005,2,Bronx,20312002004,49,17,32,4.14
2020,CB2020,005,2,Bronx,20312002005,157,67,90,3.51
2020,CB2020,005,2,Bronx,20312002006,72,41,31,2.93
2020,CB2020,005,2,Bronx,20314001000,210,97,113,5.31
2020,CB2020,005,2,Bronx,20314001001,305,155,150,5.32
2020,CB2020,005,2,Bronx,20314001002,102,50,52,5.31
2020,CB2020,005,2,Bronx,20314001003,147,58,89,4.06
2020,CB2020,005,2,Bronx,20314001004,152,48,104,4.06
2020,CB2020,005,2,Bronx,20314001005,129,71,58,4.06
2020,CB2020,005,2,Bronx,20314002000,288,153,135,4.4
2020,CB2020,005,2,Bronx,20314002001,121,56,65,2.75
2020,CB2020,005,2,Bronx,20314002002,108,71,37,2.63
2020,CB2020,005,2,Bronx,20314002003,71,31,40,2.56
2020,CB2020,005,2,Bronx,20314002004,80,43,37,2.45
2020,CB2020,005,2,Bronx,20314002005,108,49,59,2.5
2020,CB2020,005,2,Bronx,20314002006,93,32,61,2.57
2020,CB2020,005,2,Bronx,20314002007,157,80,77,4.22
2020,CB2020,005,2,Bronx,20316001000,251,126,125,5.31
2020,CB2020,005,2,Bronx,20316001001,318,161,157,5.47
2020,CB2020,005,2,Bronx,20316001002,264,118,146,5.12
2020,CB2020,005,2,Bronx,20316001003,214,117,97,4.26
2020,CB2020,005,2,Bronx,20316001004,187,83,104,4.16
2020,CB2020,005,2,Bronx,20316002000,172,86,86,4.06
2020,CB2020,005,2,Bronx,20316002001,145,63,82,2.56
2020,CB2020,005,2,Bronx,20316002002,100,65,35,2.67
2020,CB2020,005,2,Bronx,20316002003,120,60,60,2.71
2020,CB2020,005,2,Bronx,20316002004,96,44,52,2.54
2020,CB2020,005,2,Bronx,20316002005,125,53,72,2.5
2020,CB2020,005,2,Bronx,20316002006,79,51,28,2.41
2020,CB2020,005,2,Bronx,20318001000,0,0,0,0.48
2020,CB2020,005,2,Bronx,20318001001,110,35,75,4.07
2020,CB2020,005,2,Bronx,20318001002,68,36,32,1.79
2020,CB2020,005,2,Bronx,20318001003,223,117,106,5.3
2020,CB2020,005,2,Bronx,20318001004,164,75,89,3.22
2020,CB2020,005,2,Bronx,20318001005,147,82,65,1.5
2020,CB2020,005,2,Bronx,20318002000,188,60,128,4.04
2020,CB2020,005,2,Bronx,20318002001,182,104,78,4.07
2020,CB2020,005,2,Bronx,20318002002,103,65,38,3.18
2020,CB2020,005,2,Bronx,20318002003,140,71,69,2.8
2020,CB2020,005,2,Bronx,20318002004,119,62,57,2.74
2020,CB2020,005,2,Bronx,20318002005,112,71,41,2.68
2020,CB2020,005,2,Bronx,20318002006,90,36,54,2.6
2020,CB2020,005,2,Bronx,20318002007,197,96,101,2.73
2020,CB2020,005,2,Bronx,20318002008,118,52,66,2.87
2020,CB2020,005,2,Bronx,20319000001,0,0,0,0
2020,CB2020,005,2,Bronx,20319001000,120,14,106,18.01
2020,CB2020,005,2,Bronx,20319001001,0,0,0,5.33
2020,CB2020,005,2,Bronx,20319001002,0,0,0,3.3
2020,CB2020,005,2,Bronx,20319001003,0,0,0,2.82
2020,CB2020,005,2,Bronx,20319001004,0,0,0,3.96
2020,CB2020,005,2,Bronx,20319001005,0,0,0,4.48
2020,CB2020,005,2,Bronx,20319001006,334,104,230,14.77
2020,CB2020,005,2,Bronx,20323001000,558,274,284,8.47
2020,CB2020,005,2,Bronx,20323001001,323,140,183,4.96
2020,CB2020,005,2,Bronx,20323002000,1367,593,774,6.76
2020,CB2020,005,2,Bronx,20323003000,665,274,391,5.01
2020,CB2020,005,2,Bronx,20323004000,203,147,56,39.94
2020,CB2020,005,2,Bronx,20323004001,141,62,79,11.97
2020,CB2020,005,2,Bronx,20323004002,297,148,149,2.65
2020,CB2020,005,2,Bronx,20323004003,424,208,216,3.36
2020,CB2020,005,2,Bronx,20323004004,261,88,173,3.24
2020,CB2020,005,2,Bronx,20323004005,237,124,113,2.33
2020,CB2020,005,2,Bronx,20323004006,73,41,32,5.75
2020,CB2020,005,2,Bronx,20323004007,137,68,69,15.53
2020,CB2020,005,2,Bronx,20323004008,201,74,127,4.11
2020,CB2020,005,2,Bronx,20323005000,84,41,43,13.83
2020,CB2020,005,2,Bronx,20323005001,30,17,13,10.75
2020,CB2020,005,2,Bronx,20324001000,1211,494,717,16.99
2020,CB2020,005,2,Bronx,20324001001,0,0,0,7.08
2020,CB2020,005,2,Bronx,20324001002,0,0,0,3.42
2020,CB2020,005,2,Bronx,20324001003,497,167,330,4.57
2020,CB2020,005,2,Bronx,20324001004,10,6,4,18.07
2020,CB2020,005,2,Bronx,20324002000,404,194,210,3.96
2020,CB2020,005,2,Bronx,20324002001,533,245,288,5.3
2020,CB2020,005,2,Bronx,20324002002,458,245,213,5.73
2020,CB2020,005,2,Bronx,20324002003,0,0,0,0.97
2020,CB2020,005,2,Bronx,20326001000,299,160,139,5.71
2020,CB2020,005,2,Bronx,20326001001,293,152,141,5.3
2020,CB2020,005,2,Bronx,20326001002,239,120,119,4.37
2020,CB2020,005,2,Bronx,20326001003,20,14,6,1.35
2020,CB2020,005,2,Bronx,20326001004,99,37,62,3.62
2020,CB2020,005,2,Bronx,20326001005,372,183,189,4.37
2020,CB2020,005,2,Bronx,20326001006,136,71,65,2.67
2020,CB2020,005,2,Bronx,20326001007,111,55,56,2.34
2020,CB2020,005,2,Bronx,20326001008,0,0,0,3.9
2020,CB2020,005,2,Bronx,20326002000,163,74,89,5.32
2020,CB2020,005,2,Bronx,20326002001,253,113,140,5.32
2020,CB2020,005,2,Bronx,20326002002,237,131,106,5.72
2020,CB2020,005,2,Bronx,20326002003,163,73,90,4.37
2020,CB2020,005,2,Bronx,20326002004,159,75,84,4.07
2020,CB2020,005,2,Bronx,20326002005,197,84,113,4.93
2020,CB2020,005,2,Bronx,20326003000,112,36,76,3.26
2020,CB2020,005,2,Bronx,20326003001,108,74,34,2.52
2020,CB2020,005,2,Bronx,20326003002,108,27,81,3.27
2020,CB2020,005,2,Bronx,20326003003,37,15,22,1.35
2020,CB2020,005,2,Bronx,20326003004,22,10,12,1.31
2020,CB2020,005,2,Bronx,20326003005,196,113,83,3.95
2020,CB2020,005,2,Bronx,20326003006,170,88,82,3.05
2020,CB2020,005,2,Bronx,20328001000,126,56,70,2.56
2020,CB2020,005,2,Bronx,20328001001,128,70,58,3.08
2020,CB2020,005,2,Bronx,20328001002,0,0,0,1.13
2020,CB2020,005,2,Bronx,20328001003,278,118,160,4.1
2020,CB2020,005,2,Bronx,20328001004,331,137,194,2.49
2020,CB2020,005,2,Bronx,20328001005,150,85,65,2.6
2020,CB2020,005,2,Bronx,20328002000,888,337,551,8.52
2020,CB2020,005,2,Bronx,20328002001,234,87,147,2.71
2020,CB2020,005,2,Bronx,20328003000,135,67,68,1.99
2020,CB2020,005,2,Bronx,20328003001,138,72,66,1.77
2020,CB2020,005,2,Bronx,20328003002,219,104,115,3.56
2020,CB2020,005,2,Bronx,20328003003,555,277,278,3.6
2020,CB2020,005,2,Bronx,20328004000,189,101,88,4.35
2020,CB2020,005,2,Bronx,20328004001,279,135,144,4.06
2020,CB2020,005,2,Bronx,20328004002,483,235,248,4.06
2020,CB2020,005,2,Bronx,20330001000,341,189,152,4.1
2020,CB2020,005,2,Bronx,20330001001,716,335,381,4.93
2020,CB2020,005,2,Bronx,20330001002,481,245,236,5.24
2020,CB2020,005,2,Bronx,20330001003,0,0,0,0.94
2020,CB2020,005,2,Bronx,20330002000,565,297,268,3.8
2020,CB2020,005,2,Bronx,20330002001,1053,559,494,3.75
2020,CB2020,005,2,Bronx,20330003000,1287,646,641,6.09
2020,CB2020,005,2,Bronx,20330003001,34,23,11,1.92
2020,CB2020,005,2,Bronx,20330003002,346,142,204,3.96
2020,CB2020,005,2,Bronx,20330004000,106,45,61,4.07
2020,CB2020,005,2,Bronx,20330004001,319,141,178,3.45
2020,CB2020,005,2,Bronx,20330004002,0,0,0,0.89
2020,CB2020,005,2,Bronx,20330004003,174,71,103,4.07
2020,CB2020,005,2,Bronx,20330004004,415,193,222,3.73
2020,CB2020,005,2,Bronx,20332011000,0,0,0,0.97
2020,CB2020,005,2,Bronx,20332011001,0,0,0,1.08
2020,CB2020,005,2,Bronx,20332011002,463,220,243,2.39
2020,CB2020,005,2,Bronx,20332011003,411,195,216,2.06
2020,CB2020,005,2,Bronx,20332011004,605,280,325,2.64
2020,CB2020,005,2,Bronx,20332012000,1431,680,751,7.31
2020,CB2020,005,2,Bronx,20332013000,750,367,383,6.24
2020,CB2020,005,2,Bronx,20332013001,443,164,279,5.49
2020,CB2020,005,2,Bronx,20332021000,590,262,328,4.54
2020,CB2020,005,2,Bronx,20332021001,507,222,285,4.05
2020,CB2020,005,2,Bronx,20332022000,932,432,500,5.14
2020,CB2020,005,2,Bronx,20332022001,531,255,276,4.38
2020,CB2020,005,2,Bronx,20332023000,720,322,398,4.82
2020,CB2020,005,2,Bronx,20332024000,924,441,483,5.53
2020,CB2020,005,2,Bronx,20334001000,0,0,0,1.91
2020,CB2020,005,2,Bronx,20334001001,0,0,0,0.89
2020,CB2020,005,2,Bronx,20334001002,0,0,0,0.72
2020,CB2020,005,2,Bronx,20334001003,50,25,25,33.18
2020,CB2020,005,2,Bronx,20334001004,0,0,0,0.17
2020,CB2020,005,2,Bronx,20334001005,0,0,0,3.85
2020,CB2020,005,2,Bronx,20334001006,0,0,0,19.82
2020,CB2020,005,2,Bronx,20334001007,0,0,0,52.35
2020,CB2020,005,2,Bronx,20334001008,0,0,0,18.57
2020,CB2020,005,2,Bronx,20334001009,3,1,2,28.37
2020,CB2020,005,2,Bronx,20334001010,0,0,0,7.35
2020,CB2020,005,2,Bronx,20334001011,0,0,0,5.55
2020,CB2020,005,2,Bronx,20334001012,0,0,0,146.7
2020,CB2020,005,2,Bronx,20334001013,0,0,0,19.35
2020,CB2020,005,2,Bronx,20334001014,0,0,0,60.22
2020,CB2020,005,2,Bronx,20334001015,0,0,0,10.11
2020,CB2020,005,2,Bronx,20334001016,0,0,0,1.09
2020,CB2020,005,2,Bronx,20334001017,0,0,0,0.89
2020,CB2020,005,2,Bronx,20334001018,0,0,0,0.96
2020,CB2020,005,2,Bronx,20334001019,0,0,0,0.59
2020,CB2020,005,2,Bronx,20334001020,0,0,0,12.09
2020,CB2020,005,2,Bronx,20334001021,0,0,0,3
2020,CB2020,005,2,Bronx,20334001022,5,2,3,157.5
2020,CB2020,005,2,Bronx,20334001023,0,0,0,18.21
2020,CB2020,005,2,Bronx,20334001024,0,0,0,4.27
2020,CB2020,005,2,Bronx,20334001025,0,0,0,0.65
2020,CB2020,005,2,Bronx,20334001026,0,0,0,2.35
2020,CB2020,005,2,Bronx,20334001027,11,5,6,42.92
2020,CB2020,005,2,Bronx,20334001028,0,0,0,3.8
2020,CB2020,005,2,Bronx,20334001029,0,0,0,1.82
2020,CB2020,005,2,Bronx,20334001030,0,0,0,70.02
2020,CB2020,005,2,Bronx,20334001031,0,0,0,28.23
2020,CB2020,005,2,Bronx,20334001032,0,0,0,0.53
2020,CB2020,005,2,Bronx,20335001000,0,0,0,0.8
2020,CB2020,005,2,Bronx,20335001001,0,0,0,3.03
2020,CB2020,005,2,Bronx,20335001002,0,0,0,1.66
2020,CB2020,005,2,Bronx,20335001003,0,0,0,0.56
2020,CB2020,005,2,Bronx,20335001004,0,0,0,1.63
2020,CB2020,005,2,Bronx,20335001005,0,0,0,2.9
2020,CB2020,005,2,Bronx,20335001006,125,51,74,28.93
2020,CB2020,005,2,Bronx,20335001007,53,30,23,5.1
2020,CB2020,005,2,Bronx,20335001008,22,12,10,8.01
2020,CB2020,005,2,Bronx,20335001009,0,0,0,2.18
2020,CB2020,005,2,Bronx,20335001010,71,31,40,8.41
2020,CB2020,005,2,Bronx,20335001011,37,15,22,2.61
2020,CB2020,005,2,Bronx,20335001012,60,37,23,10.8
2020,CB2020,005,2,Bronx,20335001013,77,38,39,8.16
2020,CB2020,005,2,Bronx,20335001014,64,38,26,4
2020,CB2020,005,2,Bronx,20335002000,63,31,32,9.36
2020,CB2020,005,2,Bronx,20335002001,65,44,21,7.55
2020,CB2020,005,2,Bronx,20335002002,80,46,34,8.07
2020,CB2020,005,2,Bronx,20335002003,74,48,26,7.07
2020,CB2020,005,2,Bronx,20335002004,0,0,0,1.08
2020,CB2020,005,2,Bronx,20335002005,0,0,0,1.07
2020,CB2020,005,2,Bronx,20335002006,0,0,0,2.38
2020,CB2020,005,2,Bronx,20335002007,0,0,0,0.49
2020,CB2020,005,2,Bronx,20335002008,0,0,0,0.67
2020,CB2020,005,2,Bronx,20335002009,69,26,43,16.08
2020,CB2020,005,2,Bronx,20335002010,75,27,48,9.55
2020,CB2020,005,2,Bronx,20335002011,169,73,96,4.58
2020,CB2020,005,2,Bronx,20335002012,30,14,16,6.99
2020,CB2020,005,2,Bronx,20335002013,202,86,116,2.64
2020,CB2020,005,2,Bronx,20335003000,341,143,198,2.82
2020,CB2020,005,2,Bronx,20335003001,383,179,204,1.98
2020,CB2020,005,2,Bronx,20335003002,380,176,204,0.97
2020,CB2020,005,2,Bronx,20336011000,168,97,71,2.72
2020,CB2020,005,2,Bronx,20336011001,187,88,99,2.2
2020,CB2020,005,2,Bronx,20336011002,717,344,373,3.72
2020,CB2020,005,2,Bronx,20336012000,391,198,193,3.09
2020,CB2020,005,2,Bronx,20336012001,476,213,263,2.73
2020,CB2020,005,2,Bronx,20336013000,772,341,431,3.87
2020,CB2020,005,2,Bronx,20336014000,350,145,205,4.18
2020,CB2020,005,2,Bronx,20336014001,914,371,543,6.08
2020,CB2020,005,2,Bronx,20336014002,331,139,192,3.03
2020,CB2020,005,2,Bronx,20336021000,0,0,0,2.12
2020,CB2020,005,2,Bronx,20336021001,189,78,111,2.21
2020,CB2020,005,2,Bronx,20336021002,904,384,520,5.18
2020,CB2020,005,2,Bronx,20336021003,195,85,110,2.26
2020,CB2020,005,2,Bronx,20336021004,267,134,133,2.17
2020,CB2020,005,2,Bronx,20337001000,73,24,49,0.47
2020,CB2020,005,2,Bronx,20337001001,170,74,96,1.64
2020,CB2020,005,2,Bronx,20337001002,33,19,14,0.33
2020,CB2020,005,2,Bronx,20337001003,280,145,135,5.21
2020,CB2020,005,2,Bronx,20337002000,269,134,135,4.81
2020,CB2020,005,2,Bronx,20337002001,191,111,80,4.82
2020,CB2020,005,2,Bronx,20337002002,126,42,84,3.55
2020,CB2020,005,2,Bronx,20337002003,83,41,42,3.8
2020,CB2020,005,2,Bronx,20337002004,126,53,73,3.2
2020,CB2020,005,2,Bronx,20337002005,89,63,26,3.19
2020,CB2020,005,2,Bronx,20337002006,102,48,54,3.57
2020,CB2020,005,2,Bronx,20337003000,85,41,44,2.78
2020,CB2020,005,2,Bronx,20337003001,97,43,54,3.01
2020,CB2020,005,2,Bronx,20337003002,113,44,69,3.37
2020,CB2020,005,2,Bronx,20337003003,32,15,17,3.55
2020,CB2020,005,2,Bronx,20337003004,309,167,142,13.26
2020,CB2020,005,2,Bronx,20337003005,102,41,61,3.92
2020,CB2020,005,2,Bronx,20337003006,156,88,68,2.8
2020,CB2020,005,2,Bronx,20337003007,1402,832,570,19.83
2020,CB2020,005,2,Bronx,20337003008,0,0,0,8.76
2020,CB2020,005,2,Bronx,20337003009,0,0,0,6.1
2020,CB2020,005,2,Bronx,20337003010,0,0,0,2.85
2020,CB2020,005,2,Bronx,20338011000,67,32,35,1.56
2020,CB2020,005,2,Bronx,20338011001,43,15,28,0.79
2020,CB2020,005,2,Bronx,20338011002,116,72,44,4.26
2020,CB2020,005,2,Bronx,20338011003,494,220,274,3.17
2020,CB2020,005,2,Bronx,20338011004,253,119,134,2.39
2020,CB2020,005,2,Bronx,20338012000,645,315,330,5.14
2020,CB2020,005,2,Bronx,20338012001,466,247,219,5.24
2020,CB2020,005,2,Bronx,20338012002,253,112,141,5.72
2020,CB2020,005,2,Bronx,20338021000,724,313,411,3.77
2020,CB2020,005,2,Bronx,20338021001,714,334,380,3.76
2020,CB2020,005,2,Bronx,20338021002,299,133,166,4.08
2020,CB2020,005,2,Bronx,20340001000,339,158,181,2.64
2020,CB2020,005,2,Bronx,20340001001,422,191,231,3.77
2020,CB2020,005,2,Bronx,20340001002,405,183,222,3.76
2020,CB2020,005,2,Bronx,20340001003,115,60,55,1.43
2020,CB2020,005,2,Bronx,20340002000,134,58,76,1.75
2020,CB2020,005,2,Bronx,20340002001,119,69,50,1.65
2020,CB2020,005,2,Bronx,20340002002,369,154,215,1.63
2020,CB2020,005,2,Bronx,20340002003,89,51,38,1.83
2020,CB2020,005,2,Bronx,20340002004,501,226,275,2.13
2020,CB2020,005,2,Bronx,20340002005,354,169,185,2.33
2020,CB2020,005,2,Bronx,20340002006,56,27,29,0.84
2020,CB2020,005,2,Bronx,20340003000,1092,517,575,5.07
2020,CB2020,005,2,Bronx,20340004000,103,49,54,1.85
2020,CB2020,005,2,Bronx,20340004001,166,80,86,2.88
2020,CB2020,005,2,Bronx,20340004002,0,0,0,0.56
2020,CB2020,005,2,Bronx,20340004003,594,281,313,5
2020,CB2020,005,2,Bronx,20342001000,286,133,153,3.78
2020,CB2020,005,2,Bronx,20342001001,266,117,149,3.77
2020,CB2020,005,2,Bronx,20342001002,295,136,159,4.06
2020,CB2020,005,2,Bronx,20342002000,101,48,53,3.07
2020,CB2020,005,2,Bronx,20342002001,231,135,96,3.95
2020,CB2020,005,2,Bronx,20342002002,124,57,67,4.28
2020,CB2020,005,2,Bronx,20342002003,35,13,22,1.67
2020,CB2020,005,2,Bronx,20342002004,0,0,0,0.9
2020,CB2020,005,2,Bronx,20342002005,118,69,49,3.07
2020,CB2020,005,2,Bronx,20342002006,0,0,0,1
2020,CB2020,005,2,Bronx,20342002007,276,149,127,4.87
2020,CB2020,005,2,Bronx,20342002008,0,0,0,0.91
2020,CB2020,005,2,Bronx,20342002009,0,0,0,1.23
2020,CB2020,005,2,Bronx,20342002010,0,0,0,2.2
2020,CB2020,005,2,Bronx,20343001000,664,313,351,6.8
2020,CB2020,005,2,Bronx,20343001001,136,67,69,4.62
2020,CB2020,005,2,Bronx,20343001002,102,55,47,3.61
2020,CB2020,005,2,Bronx,20343002000,205,98,107,4.26
2020,CB2020,005,2,Bronx,20343002001,118,48,70,3.7
2020,CB2020,005,2,Bronx,20343002002,127,69,58,3.03
2020,CB2020,005,2,Bronx,20343002003,60,38,22,2.35
2020,CB2020,005,2,Bronx,20343002004,294,133,161,1.65
2020,CB2020,005,2,Bronx,20344001000,251,120,131,5.25
2020,CB2020,005,2,Bronx,20344001001,307,136,171,4.87
2020,CB2020,005,2,Bronx,20344001002,259,131,128,4.87
2020,CB2020,005,2,Bronx,20344002000,83,56,27,3.48
2020,CB2020,005,2,Bronx,20344002001,0,0,0,0.56
2020,CB2020,005,2,Bronx,20344002002,155,68,87,3.01
2020,CB2020,005,2,Bronx,20344002003,276,138,138,3.76
2020,CB2020,005,2,Bronx,20344002004,20,16,4,1.25
2020,CB2020,005,2,Bronx,20344002005,254,113,141,3.95
2020,CB2020,005,2,Bronx,20344002006,0,0,0,0.83
2020,CB2020,005,2,Bronx,20344002007,53,26,27,2.71
2020,CB2020,005,2,Bronx,20344002008,272,103,169,4.27
2020,CB2020,005,2,Bronx,20345001000,383,163,220,2.72
2020,CB2020,005,2,Bronx,20345001001,149,72,77,4.84
2020,CB2020,005,2,Bronx,20345001002,73,21,52,2.62
2020,CB2020,005,2,Bronx,20345001003,114,56,58,2.43
2020,CB2020,005,2,Bronx,20345001004,27,21,6,1.01
2020,CB2020,005,2,Bronx,20345001005,183,91,92,2.27
2020,CB2020,005,2,Bronx,20345001006,313,144,169,2.87
2020,CB2020,005,2,Bronx,20345001007,0,0,0,0.41
2020,CB2020,005,2,Bronx,20345001008,62,33,29,1.12
2020,CB2020,005,2,Bronx,20345002000,266,131,135,5.67
2020,CB2020,005,2,Bronx,20345002001,360,190,170,4.38
2020,CB2020,005,2,Bronx,20345002002,132,76,56,2.99
2020,CB2020,005,2,Bronx,20345002003,141,53,88,4.82
2020,CB2020,005,2,Bronx,20345002004,251,106,145,6.27
2020,CB2020,005,2,Bronx,20345002005,68,37,31,1.38
2020,CB2020,005,2,Bronx,20345002006,315,200,115,4.6
2020,CB2020,005,2,Bronx,20345002007,59,33,26,3.06
2020,CB2020,005,2,Bronx,20345002008,0,0,0,4.81
2020,CB2020,005,2,Bronx,20345003000,858,391,467,9.6
2020,CB2020,005,2,Bronx,20348001000,0,0,0,1.2
2020,CB2020,005,2,Bronx,20348001001,40,22,18,2.13
2020,CB2020,005,2,Bronx,20348001002,197,109,88,2.93
2020,CB2020,005,2,Bronx,20348001003,219,113,106,3.76
2020,CB2020,005,2,Bronx,20348001004,246,111,135,4.2
2020,CB2020,005,2,Bronx,20348001005,322,159,163,3.85
2020,CB2020,005,2,Bronx,20348001006,0,0,0,0.99
2020,CB2020,005,2,Bronx,20348001007,41,9,32,3.58
2020,CB2020,005,2,Bronx,20348001008,78,23,55,2.42
2020,CB2020,005,2,Bronx,20348001009,70,26,44,3.95
2020,CB2020,005,2,Bronx,20348001010,0,0,0,0.31
2020,CB2020,005,2,Bronx,20348001011,0,0,0,2.29
2020,CB2020,005,2,Bronx,20348002000,2240,913,1327,18.88
2020,CB2020,005,2,Bronx,20348003000,224,110,114,3.92
2020,CB2020,005,2,Bronx,20348003001,231,111,120,3.95
2020,CB2020,005,2,Bronx,20348003002,230,122,108,3.93
2020,CB2020,005,2,Bronx,20348003003,174,77,97,3.95
2020,CB2020,005,2,Bronx,20348003004,233,115,118,3.91
2020,CB2020,005,2,Bronx,20348003005,295,114,181,4.31
2020,CB2020,005,2,Bronx,20348003006,258,123,135,4.07
2020,CB2020,005,2,Bronx,20348004000,0,0,0,4.88
2020,CB2020,005,2,Bronx,20348004001,360,182,178,4.87
2020,CB2020,005,2,Bronx,20348004002,287,136,151,4.84
2020,CB2020,005,2,Bronx,20348004003,285,129,156,4.85
2020,CB2020,005,2,Bronx,20348004004,298,142,156,4.87
2020,CB2020,005,2,Bronx,20348004005,312,158,154,5.24
2020,CB2020,005,2,Bronx,20350001000,182,102,80,4.98
2020,CB2020,005,2,Bronx,20350001001,121,46,75,3.6
2020,CB2020,005,2,Bronx,20350001002,0,0,0,0.7
2020,CB2020,005,2,Bronx,20350001003,246,103,143,7.42
2020,CB2020,005,2,Bronx,20350001004,24,14,10,0.42
2020,CB2020,005,2,Bronx,20350001005,195,84,111,2.84
2020,CB2020,005,2,Bronx,20350001006,278,133,145,7.21
2020,CB2020,005,2,Bronx,20350001007,0,0,0,0.39
2020,CB2020,005,2,Bronx,20350002000,315,150,165,4.77
2020,CB2020,005,2,Bronx,20350002001,319,150,169,4.12
2020,CB2020,005,2,Bronx,20350002002,157,72,85,2.94
2020,CB2020,005,2,Bronx,20350002003,0,0,0,1.94
2020,CB2020,005,2,Bronx,20350002004,148,75,73,2.34
2020,CB2020,005,2,Bronx,20350002005,299,146,153,3.69
2020,CB2020,005,2,Bronx,20351001000,278,148,130,8.93
2020,CB2020,005,2,Bronx,20351001001,56,33,23,5.48
2020,CB2020,005,2,Bronx,20351001002,940,517,423,16.92
2020,CB2020,005,2,Bronx,20351002000,183,77,106,3.09
2020,CB2020,005,2,Bronx,20351002001,747,350,397,21.76
2020,CB2020,005,2,Bronx,20351002002,32,14,18,8.57
2020,CB2020,005,2,Bronx,20351002003,204,106,98,3.44
2020,CB2020,005,2,Bronx,20351003000,0,0,0,0.88
2020,CB2020,005,2,Bronx,20351003001,39,20,19,5.69
2020,CB2020,005,2,Bronx,20351003002,139,65,74,3.15
2020,CB2020,005,2,Bronx,20351003003,192,87,105,32.87
2020,CB2020,005,2,Bronx,20351003004,0,0,0,0.28
2020,CB2020,005,2,Bronx,20351003005,30,9,21,5.38
2020,CB2020,005,2,Bronx,20351003006,82,34,48,16.53
2020,CB2020,005,2,Bronx,20351003007,0,0,0,0.82
2020,CB2020,005,2,Bronx,20351003008,287,137,150,5.04
2020,CB2020,005,2,Bronx,20351003009,330,151,179,4.61
2020,CB2020,005,2,Bronx,20356001000,246,109,137,3.91
2020,CB2020,005,2,Bronx,20356001001,214,72,142,3.91
2020,CB2020,005,2,Bronx,20356001002,328,163,165,3.91
2020,CB2020,005,2,Bronx,20356001003,204,122,82,3.9
2020,CB2020,005,2,Bronx,20356001004,108,52,56,4.33
2020,CB2020,005,2,Bronx,20356001005,0,0,0,1.57
2020,CB2020,005,2,Bronx,20356002000,290,149,141,3.91
2020,CB2020,005,2,Bronx,20356002001,149,63,86,4.11
2020,CB2020,005,2,Bronx,20356002002,145,71,74,4.1
2020,CB2020,005,2,Bronx,20356002003,173,72,101,4.1
2020,CB2020,005,2,Bronx,20356002004,137,71,66,4.02
2020,CB2020,005,2,Bronx,20356002005,89,65,24,2.3
2020,CB2020,005,2,Bronx,20356002006,2,2,0,0.28
2020,CB2020,005,2,Bronx,20356002007,0,0,0,0.47
2020,CB2020,005,2,Bronx,20356002008,38,19,19,2.55
2020,CB2020,005,2,Bronx,20356002009,138,52,86,41.86
2020,CB2020,005,2,Bronx,20356002010,0,0,0,4.03
2020,CB2020,005,2,Bronx,20356002011,0,0,0,6.67
2020,CB2020,005,2,Bronx,20358001000,192,58,134,2.93
2020,CB2020,005,2,Bronx,20358001001,123,65,58,3.11
2020,CB2020,005,2,Bronx,20358001002,105,68,37,2.49
2020,CB2020,005,2,Bronx,20358001003,16,4,12,1.82
2020,CB2020,005,2,Bronx,20358001004,0,0,0,1.64
2020,CB2020,005,2,Bronx,20358001005,205,109,96,3.99
2020,CB2020,005,2,Bronx,20358001006,194,110,84,3.73
2020,CB2020,005,2,Bronx,20358001007,198,66,132,3.79
2020,CB2020,005,2,Bronx,20358001008,256,91,165,3.76
2020,CB2020,005,2,Bronx,20358001009,294,127,167,3.8
2020,CB2020,005,2,Bronx,20358002000,106,30,76,1.22
2020,CB2020,005,2,Bronx,20358002001,320,157,163,5.16
2020,CB2020,005,2,Bronx,20358002002,210,94,116,3.78
2020,CB2020,005,2,Bronx,20358002003,0,0,0,11.61
2020,CB2020,005,2,Bronx,20358002004,247,103,144,2.49
2020,CB2020,005,2,Bronx,20358002005,266,110,156,4.12
2020,CB2020,005,2,Bronx,20358002006,216,126,90,4.1
2020,CB2020,005,2,Bronx,20358003000,54,22,32,1.11
2020,CB2020,005,2,Bronx,20358003001,301,123,178,3.95
2020,CB2020,005,2,Bronx,20358003002,13,7,6,0.52
2020,CB2020,005,2,Bronx,20358003003,76,53,23,1.38
2020,CB2020,005,2,Bronx,20358003004,358,178,180,8.47
2020,CB2020,005,2,Bronx,20358003005,68,28,40,1.5
2020,CB2020,005,2,Bronx,20358003006,164,60,104,3.72
2020,CB2020,005,2,Bronx,20358004000,878,383,495,19.02
2020,CB2020,005,2,Bronx,20358005000,223,105,118,4.11
2020,CB2020,005,2,Bronx,20358005001,241,98,143,4.11
2020,CB2020,005,2,Bronx,20358005002,253,122,131,4.1
2020,CB2020,005,2,Bronx,20358005003,113,34,79,5.54
2020,CB2020,005,2,Bronx,20358006000,253,108,145,5.88
2020,CB2020,005,2,Bronx,20358006001,364,179,185,5.43
2020,CB2020,005,2,Bronx,20358006002,221,92,129,3.91
2020,CB2020,005,2,Bronx,20358006003,260,103,157,4.18
2020,CB2020,005,2,Bronx,20358007000,145,79,66,5.21
2020,CB2020,005,2,Bronx,20358007001,221,99,122,4.29
2020,CB2020,005,2,Bronx,20358007002,29,10,19,1.99
2020,CB2020,005,2,Bronx,20358007003,54,24,30,2.48
2020,CB2020,005,2,Bronx,20358007004,155,83,72,3.4
2020,CB2020,005,2,Bronx,20358007005,150,72,78,3.16
2020,CB2020,005,2,Bronx,20359001000,0,0,0,0.72
2020,CB2020,005,2,Bronx,20359001001,395,167,228,2.58
2020,CB2020,005,2,Bronx,20359001002,0,0,0,1.35
2020,CB2020,005,2,Bronx,20359001003,476,188,288,3.15
2020,CB2020,005,2,Bronx,20359001004,499,245,254,5.76
2020,CB2020,005,2,Bronx,20359001005,287,163,124,4.77
2020,CB2020,005,2,Bronx,20359001006,272,140,132,2.65
2020,CB2020,005,2,Bronx,20359001007,505,209,296,3.22
2020,CB2020,005,2,Bronx,20359001008,312,138,174,2.01
2020,CB2020,005,2,Bronx,20359001009,0,0,0,1.27
2020,CB2020,005,2,Bronx,20359001010,0,0,0,1.07
2020,CB2020,005,2,Bronx,20359001011,0,0,0,0.63
2020,CB2020,005,2,Bronx,20359001012,0,0,0,1.23
2020,CB2020,005,2,Bronx,20359001013,0,0,0,0.3
2020,CB2020,005,2,Bronx,20359001014,980,423,557,1.53
2020,CB2020,005,2,Bronx,20359001015,0,0,0,0.13
2020,CB2020,005,2,Bronx,20359001016,5,3,2,0.19
2020,CB2020,005,2,Bronx,20359001017,0,0,0,0.63
2020,CB2020,005,2,Bronx,20360001000,224,103,121,4.05
2020,CB2020,005,2,Bronx,20360001001,213,97,116,4.82
2020,CB2020,005,2,Bronx,20360001002,321,166,155,4.24
2020,CB2020,005,2,Bronx,20360001003,0,0,0,1.66
2020,CB2020,005,2,Bronx,20360001004,94,48,46,1.53
2020,CB2020,005,2,Bronx,20360002000,332,150,182,5.89
2020,CB2020,005,2,Bronx,20360002001,273,129,144,4.87
2020,CB2020,005,2,Bronx,20360002002,256,123,133,4.87
2020,CB2020,005,2,Bronx,20360002003,288,141,147,5.12
2020,CB2020,005,2,Bronx,20360003000,0,0,0,1.63
2020,CB2020,005,2,Bronx,20360003001,12,6,6,2.03
2020,CB2020,005,2,Bronx,20360003002,235,108,127,5.67
2020,CB2020,005,2,Bronx,20360003003,167,83,84,4.67
2020,CB2020,005,2,Bronx,20360003004,117,58,59,3.84
2020,CB2020,005,2,Bronx,20360003005,46,16,30,2.65
2020,CB2020,005,2,Bronx,20360003006,48,14,34,1.64
2020,CB2020,005,2,Bronx,20360003007,133,58,75,2.6
2020,CB2020,005,2,Bronx,20360003008,265,121,144,3.98
2020,CB2020,005,2,Bronx,20361001000,1319,555,764,8.53
2020,CB2020,005,2,Bronx,20361002000,443,182,261,3
2020,CB2020,005,2,Bronx,20361002001,530,218,312,3.64
2020,CB2020,005,2,Bronx,20361002002,521,239,282,2.66
2020,CB2020,005,2,Bronx,20361003000,303,136,167,5.15
2020,CB2020,005,2,Bronx,20361003001,34,12,22,3.98
2020,CB2020,005,2,Bronx,20361003002,652,270,382,3.86
2020,CB2020,005,2,Bronx,20361004000,746,320,426,2.53
2020,CB2020,005,2,Bronx,20361005000,1021,450,571,7.4
2020,CB2020,005,2,Bronx,20363001000,258,120,138,1.78
2020,CB2020,005,2,Bronx,20363001001,836,359,477,3.23
2020,CB2020,005,2,Bronx,20363002000,744,290,454,3.32
2020,CB2020,005,2,Bronx,20363003000,491,178,313,1.89
2020,CB2020,005,2,Bronx,20363003001,419,204,215,3
2020,CB2020,005,2,Bronx,20363003002,422,214,208,4.33
2020,CB2020,005,2,Bronx,20363004000,0,0,0,0.86
2020,CB2020,005,2,Bronx,20363004001,0,0,0,0.57
2020,CB2020,005,2,Bronx,20363004002,106,42,64,2.65
2020,CB2020,005,2,Bronx,20363004003,328,195,133,2.16
2020,CB2020,005,2,Bronx,20363004004,332,145,187,2.77
2020,CB2020,005,2,Bronx,20363004005,132,74,58,3.02
2020,CB2020,005,2,Bronx,20363004006,403,199,204,2.36
2020,CB2020,005,2,Bronx,20363004007,107,53,54,2.17
2020,CB2020,005,2,Bronx,20363004008,0,0,0,0.98
2020,CB2020,005,2,Bronx,20363005000,0,0,0,1.67
2020,CB2020,005,2,Bronx,20363005001,560,253,307,2.03
2020,CB2020,005,2,Bronx,20363005002,561,245,316,3.85
2020,CB2020,005,2,Bronx,20363006000,0,0,0,1.33
2020,CB2020,005,2,Bronx,20363006001,224,108,116,1.46
2020,CB2020,005,2,Bronx,20363006002,173,87,86,1.84
2020,CB2020,005,2,Bronx,20363006003,101,41,60,1.23
2020,CB2020,005,2,Bronx,20363006004,147,72,75,0.98
2020,CB2020,005,2,Bronx,20363006005,207,104,103,1.68
2020,CB2020,005,2,Bronx,20363006006,0,0,0,0.88
2020,CB2020,005,2,Bronx,20363006007,523,243,280,2.69
2020,CB2020,005,2,Bronx,20364001000,265,126,139,3.91
2020,CB2020,005,2,Bronx,20364001001,266,103,163,3.91
2020,CB2020,005,2,Bronx,20364001002,222,103,119,3.87
2020,CB2020,005,2,Bronx,20364001003,84,53,31,3.15
2020,CB2020,005,2,Bronx,20364001004,17,12,5,1.61
2020,CB2020,005,2,Bronx,20364001005,165,57,108,3.39
2020,CB2020,005,2,Bronx,20364001006,0,0,0,1.07
2020,CB2020,005,2,Bronx,20364002000,343,157,186,5.39
2020,CB2020,005,2,Bronx,20364002001,443,192,251,5.35
2020,CB2020,005,2,Bronx,20364003000,300,141,159,5.17
2020,CB2020,005,2,Bronx,20364003001,206,101,105,4.78
2020,CB2020,005,2,Bronx,20364003002,237,113,124,4.21
2020,CB2020,005,2,Bronx,20364003003,55,10,45,4.52
2020,CB2020,005,2,Bronx,20365011000,366,191,175,4.36
2020,CB2020,005,2,Bronx,20365011001,808,346,462,2.97
2020,CB2020,005,2,Bronx,20365012000,994,442,552,4.77
2020,CB2020,005,2,Bronx,20365012001,422,186,236,2.02
2020,CB2020,005,2,Bronx,20365012002,270,148,122,1.02
2020,CB2020,005,2,Bronx,20365012003,0,0,0,0.26
2020,CB2020,005,2,Bronx,20365013000,265,104,161,2.91
2020,CB2020,005,2,Bronx,20365013001,454,241,213,2.87
2020,CB2020,005,2,Bronx,20365013002,318,129,189,2.51
2020,CB2020,005,2,Bronx,20365021000,499,225,274,2.71
2020,CB2020,005,2,Bronx,20365021001,619,285,334,3.25
2020,CB2020,005,2,Bronx,20365021002,180,87,93,3.17
2020,CB2020,005,2,Bronx,20365021003,0,0,0,0.58
2020,CB2020,005,2,Bronx,20365021004,0,0,0,1.61
2020,CB2020,005,2,Bronx,20365022000,313,173,140,4.35
2020,CB2020,005,2,Bronx,20365022001,221,116,105,0.95
2020,CB2020,005,2,Bronx,20365022002,502,238,264,3.18
2020,CB2020,005,2,Bronx,20365022003,115,44,71,2.78
2020,CB2020,005,2,Bronx,20365022004,0,0,0,0.52
2020,CB2020,005,2,Bronx,20365022005,0,0,0,1.02
2020,CB2020,005,2,Bronx,20367001000,334,173,161,7.16
2020,CB2020,005,2,Bronx,20367001001,374,175,199,2.58
2020,CB2020,005,2,Bronx,20367001002,197,92,105,1.88
2020,CB2020,005,2,Bronx,20367001003,184,102,82,1.59
2020,CB2020,005,2,Bronx,20367001004,111,45,66,1.88
2020,CB2020,005,2,Bronx,20367002000,871,354,517,4.8
2020,CB2020,005,2,Bronx,20367002001,601,337,264,3.1
2020,CB2020,005,2,Bronx,20368001000,28,16,12,2.48
2020,CB2020,005,2,Bronx,20368001001,232,80,152,3.59
2020,CB2020,005,2,Bronx,20368001002,350,165,185,4.62
2020,CB2020,005,2,Bronx,20368001003,317,127,190,4.56
2020,CB2020,005,2,Bronx,20368001004,207,111,96,5.14
2020,CB2020,005,2,Bronx,20368001005,60,32,28,4.64
2020,CB2020,005,2,Bronx,20368002000,92,53,39,1.59
2020,CB2020,005,2,Bronx,20368002001,319,150,169,4.79
2020,CB2020,005,2,Bronx,20368002002,343,142,201,5.32
2020,CB2020,005,2,Bronx,20368002003,217,89,128,5.18
2020,CB2020,005,2,Bronx,20369011000,421,207,214,3.61
2020,CB2020,005,2,Bronx,20369011001,206,88,118,5.49
2020,CB2020,005,2,Bronx,20369011002,156,100,56,1.9
2020,CB2020,005,2,Bronx,20369011003,0,0,0,0.39
2020,CB2020,005,2,Bronx,20369011004,176,85,91,3.29
2020,CB2020,005,2,Bronx,20369011005,0,0,0,0.47
2020,CB2020,005,2,Bronx,20369011006,0,0,0,0.35
2020,CB2020,005,2,Bronx,20369011007,0,0,0,0.6
2020,CB2020,005,2,Bronx,20369012000,438,199,239,3.83
2020,CB2020,005,2,Bronx,20369012001,513,215,298,4.46
2020,CB2020,005,2,Bronx,20369021000,756,327,429,4.66
2020,CB2020,005,2,Bronx,20369022000,257,130,127,4.43
2020,CB2020,005,2,Bronx,20369022001,214,93,121,1.63
2020,CB2020,005,2,Bronx,20369022002,841,353,488,2.3
2020,CB2020,005,2,Bronx,20369022003,256,132,124,2.41
2020,CB2020,005,2,Bronx,20370001000,176,87,89,2.88
2020,CB2020,005,2,Bronx,20370001001,169,68,101,3.19
2020,CB2020,005,2,Bronx,20370001002,325,146,179,3.88
2020,CB2020,005,2,Bronx,20370001003,293,151,142,3.86
2020,CB2020,005,2,Bronx,20370002000,261,120,141,3.88
2020,CB2020,005,2,Bronx,20370002001,256,103,153,3.87
2020,CB2020,005,2,Bronx,20370002002,303,134,169,4.19
2020,CB2020,005,2,Bronx,20370003000,220,117,103,4.04
2020,CB2020,005,2,Bronx,20370003001,184,67,117,3.83
2020,CB2020,005,2,Bronx,20370003002,179,82,97,2.97
2020,CB2020,005,2,Bronx,20370003003,170,69,101,2.67
2020,CB2020,005,2,Bronx,20371001000,493,199,294,5.28
2020,CB2020,005,2,Bronx,20371001001,267,107,160,2.31
2020,CB2020,005,2,Bronx,20371001002,329,169,160,2.68
2020,CB2020,005,2,Bronx,20371001003,34,23,11,2.86
2020,CB2020,005,2,Bronx,20371001004,153,75,78,2.86
2020,CB2020,005,2,Bronx,20371002000,0,0,0,4.92
2020,CB2020,005,2,Bronx,20371002001,123,53,70,1.44
2020,CB2020,005,2,Bronx,20371002002,543,224,319,2.02
2020,CB2020,005,2,Bronx,20371002003,0,0,0,1.93
2020,CB2020,005,2,Bronx,20371002004,147,68,79,2.76
2020,CB2020,005,2,Bronx,20371002005,418,183,235,2.89
2020,CB2020,005,2,Bronx,20371002006,129,65,64,0.59
2020,CB2020,005,2,Bronx,20371003000,150,63,87,2.57
2020,CB2020,005,2,Bronx,20371003001,186,91,95,2.01
2020,CB2020,005,2,Bronx,20371003002,396,174,222,2.09
2020,CB2020,005,2,Bronx,20371003003,322,139,183,2.69
2020,CB2020,005,2,Bronx,20371004000,608,282,326,4.34
2020,CB2020,005,2,Bronx,20371004001,206,112,94,2.74
2020,CB2020,005,2,Bronx,20372001000,18,7,11,5.02
2020,CB2020,005,2,Bronx,20372001001,280,145,135,2.97
2020,CB2020,005,2,Bronx,20372001002,154,57,97,2.87
2020,CB2020,005,2,Bronx,20372001003,62,24,38,1.21
2020,CB2020,005,2,Bronx,20372001004,150,65,85,2.89
2020,CB2020,005,2,Bronx,20372001005,112,61,51,2.83
2020,CB2020,005,2,Bronx,20372002000,0,0,0,4.01
2020,CB2020,005,2,Bronx,20372002001,31,15,16,5.31
2020,CB2020,005,2,Bronx,20372002002,153,76,77,2.44
2020,CB2020,005,2,Bronx,20372002003,136,83,53,1.96
2020,CB2020,005,2,Bronx,20372002004,237,108,129,3.35
2020,CB2020,005,2,Bronx,20372002005,173,83,90,3.08
2020,CB2020,005,2,Bronx,20372002006,330,143,187,3.69
2020,CB2020,005,2,Bronx,20372002007,55,15,40,0.61
2020,CB2020,005,2,Bronx,20372002008,109,45,64,2.02
2020,CB2020,005,2,Bronx,20372002009,289,142,147,1.84
2020,CB2020,005,2,Bronx,20373001000,108,48,60,2.44
2020,CB2020,005,2,Bronx,20373001001,533,270,263,3.89
2020,CB2020,005,2,Bronx,20373001002,997,441,556,6.91
2020,CB2020,005,2,Bronx,20373002000,373,158,215,1.85
2020,CB2020,005,2,Bronx,20373002001,550,246,304,2.47
2020,CB2020,005,2,Bronx,20373002002,228,112,116,2.33
2020,CB2020,005,2,Bronx,20373002003,132,54,78,2.69
2020,CB2020,005,2,Bronx,20373002004,157,75,82,1.76
2020,CB2020,005,2,Bronx,20373003000,516,248,268,3.13
2020,CB2020,005,2,Bronx,20373003001,266,155,111,2.1
2020,CB2020,005,2,Bronx,20373003002,259,113,146,3.54
2020,CB2020,005,2,Bronx,20373003003,347,170,177,1.84
2020,CB2020,005,2,Bronx,20373004000,686,318,368,3.16
2020,CB2020,005,2,Bronx,20373004001,965,464,501,4.76
2020,CB2020,005,2,Bronx,20374001000,476,183,293,4
2020,CB2020,005,2,Bronx,20374001001,476,254,222,2.63
2020,CB2020,005,2,Bronx,20374002000,0,0,0,1.47
2020,CB2020,005,2,Bronx,20374002001,269,136,133,5.92
2020,CB2020,005,2,Bronx,20374002002,91,32,59,5.18
2020,CB2020,005,2,Bronx,20374002003,59,38,21,2.13
2020,CB2020,005,2,Bronx,20374002004,94,47,47,1.91
2020,CB2020,005,2,Bronx,20374002005,159,79,80,1.52
2020,CB2020,005,2,Bronx,20374002006,250,111,139,2.3
2020,CB2020,005,2,Bronx,20374002007,383,141,242,4.53
2020,CB2020,005,2,Bronx,20374003000,831,323,508,5
2020,CB2020,005,2,Bronx,20374004000,802,319,483,4.69
2020,CB2020,005,2,Bronx,20375041000,367,187,180,12.64
2020,CB2020,005,2,Bronx,20375041001,0,0,0,0.35
2020,CB2020,005,2,Bronx,20375041002,0,0,0,0.29
2020,CB2020,005,2,Bronx,20375041003,49,28,21,1.88
2020,CB2020,005,2,Bronx,20375041004,679,309,370,4.23
2020,CB2020,005,2,Bronx,20375041005,86,26,60,1.95
2020,CB2020,005,2,Bronx,20375041006,0,0,0,0.42
2020,CB2020,005,2,Bronx,20375041007,0,0,0,3.27
2020,CB2020,005,2,Bronx,20375041008,0,0,0,2.76
2020,CB2020,005,2,Bronx,20375042000,0,0,0,2.25
2020,CB2020,005,2,Bronx,20375042001,743,329,414,3.66
2020,CB2020,005,2,Bronx,20375042002,0,0,0,7.67
2020,CB2020,005,2,Bronx,20375042003,337,156,181,3.43
2020,CB2020,005,2,Bronx,20375043000,495,192,303,3.04
2020,CB2020,005,2,Bronx,20375043001,540,232,308,2.79
2020,CB2020,005,2,Bronx,20375043002,235,127,108,2.53
2020,CB2020,005,2,Bronx,20375043003,144,65,79,1.53
2020,CB2020,005,2,Bronx,20375043004,121,71,50,2.19
2020,CB2020,005,2,Bronx,20375043005,227,111,116,2.37
2020,CB2020,005,2,Bronx,20376001000,794,361,433,4.48
2020,CB2020,005,2,Bronx,20376001001,359,199,160,4.72
2020,CB2020,005,2,Bronx,20376002000,30,15,15,6.13
2020,CB2020,005,2,Bronx,20376002001,141,60,81,1.56
2020,CB2020,005,2,Bronx,20376002002,321,165,156,3.53
2020,CB2020,005,2,Bronx,20376002003,308,159,149,5.2
2020,CB2020,005,2,Bronx,20376002004,321,153,168,5.2
2020,CB2020,005,2,Bronx,20378001000,0,0,0,1.02
2020,CB2020,005,2,Bronx,20378001001,657,253,404,5.35
2020,CB2020,005,2,Bronx,20378001002,68,32,36,0.78
2020,CB2020,005,2,Bronx,20378001003,552,260,292,4.89
2020,CB2020,005,2,Bronx,20378001004,678,334,344,4.91
2020,CB2020,005,2,Bronx,20378001005,0,0,0,0.36
2020,CB2020,005,2,Bronx,20378002000,700,310,390,3.23
2020,CB2020,005,2,Bronx,20378002001,0,0,0,1.65
2020,CB2020,005,2,Bronx,20378003000,200,103,97,4.63
2020,CB2020,005,2,Bronx,20378003001,0,0,0,0.56
2020,CB2020,005,2,Bronx,20378003002,714,344,370,4.39
2020,CB2020,005,2,Bronx,20378003003,0,0,0,0.81
2020,CB2020,005,2,Bronx,20379001000,1301,545,756,4.15
2020,CB2020,005,2,Bronx,20379001001,340,167,173,1.44
2020,CB2020,005,2,Bronx,20379001002,0,0,0,1.03
2020,CB2020,005,2,Bronx,20379001003,0,0,0,0.27
2020,CB2020,005,2,Bronx,20379002000,146,73,73,4.54
2020,CB2020,005,2,Bronx,20379002001,18,12,6,2.24
2020,CB2020,005,2,Bronx,20379002002,125,65,60,5.42
2020,CB2020,005,2,Bronx,20379002003,1154,528,626,4.32
2020,CB2020,005,2,Bronx,20379002004,874,345,529,4.79
2020,CB2020,005,2,Bronx,20379003000,801,388,413,5.37
2020,CB2020,005,2,Bronx,20379004000,420,195,225,2.12
2020,CB2020,005,2,Bronx,20379004001,513,246,267,2.95
2020,CB2020,005,2,Bronx,20379005000,1186,535,651,8.62
2020,CB2020,005,2,Bronx,20380001000,706,304,402,6.34
2020,CB2020,005,2,Bronx,20380001001,435,165,270,4.86
2020,CB2020,005,2,Bronx,20380002000,401,176,225,4.25
2020,CB2020,005,2,Bronx,20380002001,398,197,201,4.33
2020,CB2020,005,2,Bronx,20380003000,400,206,194,3.81
2020,CB2020,005,2,Bronx,20380003001,271,157,114,2.56
2020,CB2020,005,2,Bronx,20380003002,217,115,102,2.26
2020,CB2020,005,2,Bronx,20380003003,410,174,236,3.48
2020,CB2020,005,2,Bronx,20380004000,383,185,198,3.45
2020,CB2020,005,2,Bronx,20380004001,162,89,73,2.64
2020,CB2020,005,2,Bronx,20380004002,192,56,136,2.31
2020,CB2020,005,2,Bronx,20380004003,102,64,38,2.47
2020,CB2020,005,2,Bronx,20380004004,36,21,15,2.51
2020,CB2020,005,2,Bronx,20380004005,608,260,348,4.62
2020,CB2020,005,2,Bronx,20380004006,217,143,74,2.89
2020,CB2020,005,2,Bronx,20381001000,683,324,359,3.18
2020,CB2020,005,2,Bronx,20381002000,1141,539,602,3.99
2020,CB2020,005,2,Bronx,20381003000,1017,494,523,3.12
2020,CB2020,005,2,Bronx,20381004000,512,260,252,3.66
2020,CB2020,005,2,Bronx,20381004001,603,295,308,4.68
2020,CB2020,005,2,Bronx,20381005000,866,420,446,5.47
2020,CB2020,005,2,Bronx,20381006000,1247,606,641,4.22
2020,CB2020,005,2,Bronx,20381006001,784,352,432,9.13
2020,CB2020,005,2,Bronx,20382001000,290,154,136,4.06
2020,CB2020,005,2,Bronx,20382001001,372,136,236,4.16
2020,CB2020,005,2,Bronx,20382001002,397,186,211,4.35
2020,CB2020,005,2,Bronx,20382001003,212,78,134,3.44
2020,CB2020,005,2,Bronx,20382001004,268,150,118,4.1
2020,CB2020,005,2,Bronx,20382002000,62,32,30,1.15
2020,CB2020,005,2,Bronx,20382002001,281,146,135,2.77
2020,CB2020,005,2,Bronx,20382002002,189,90,99,2.27
2020,CB2020,005,2,Bronx,20382002003,161,63,98,2.1
2020,CB2020,005,2,Bronx,20382002004,360,219,141,4.53
2020,CB2020,005,2,Bronx,20382002005,195,48,147,3.19
2020,CB2020,005,2,Bronx,20382002006,65,25,40,2.71
2020,CB2020,005,2,Bronx,20383011000,464,243,221,3.43
2020,CB2020,005,2,Bronx,20383011001,837,382,455,3.14
2020,CB2020,005,2,Bronx,20383011002,0,0,0,0.67
2020,CB2020,005,2,Bronx,20383012000,1266,589,677,4.81
2020,CB2020,005,2,Bronx,20383012001,93,39,54,0.51
2020,CB2020,005,2,Bronx,20383012002,371,183,188,2.32
2020,CB2020,005,2,Bronx,20383013000,1021,468,553,4.64
2020,CB2020,005,2,Bronx,20383013001,180,97,83,0.85
2020,CB2020,005,2,Bronx,20383013002,0,0,0,0.28
2020,CB2020,005,2,Bronx,20383013003,0,0,0,0.61
2020,CB2020,005,2,Bronx,20383013004,403,205,198,2.15
2020,CB2020,005,2,Bronx,20383031000,495,231,264,1.39
2020,CB2020,005,2,Bronx,20383031001,441,214,227,3
2020,CB2020,005,2,Bronx,20383031002,732,329,403,5.09
2020,CB2020,005,2,Bronx,20383032000,944,427,517,6
2020,CB2020,005,2,Bronx,20383032001,856,414,442,3.39
2020,CB2020,005,2,Bronx,20383041000,26,17,9,2.52
2020,CB2020,005,2,Bronx,20383041001,0,0,0,2
2020,CB2020,005,2,Bronx,20383041002,467,218,249,2.95
2020,CB2020,005,2,Bronx,20383041003,1523,716,807,5.26
2020,CB2020,005,2,Bronx,20383041004,123,43,80,1.2
2020,CB2020,005,2,Bronx,20383041005,369,183,186,3.2
2020,CB2020,005,2,Bronx,20385001000,0,0,0,1.66
2020,CB2020,005,2,Bronx,20385001001,78,46,32,1.28
2020,CB2020,005,2,Bronx,20385001002,0,0,0,0.81
2020,CB2020,005,2,Bronx,20385001003,0,0,0,1.04
2020,CB2020,005,2,Bronx,20385001004,73,10,63,1.13
2020,CB2020,005,2,Bronx,20385001005,346,165,181,2.54
2020,CB2020,005,2,Bronx,20385001006,516,270,246,2.58
2020,CB2020,005,2,Bronx,20385001007,0,0,0,0.7
2020,CB2020,005,2,Bronx,20385001008,28,15,13,1.23
2020,CB2020,005,2,Bronx,20385001009,317,167,150,2.59
2020,CB2020,005,2,Bronx,20385002000,0,0,0,2.52
2020,CB2020,005,2,Bronx,20385002001,382,176,206,2.56
2020,CB2020,005,2,Bronx,20385002002,286,132,154,2.46
2020,CB2020,005,2,Bronx,20385003000,0,0,0,0.56
2020,CB2020,005,2,Bronx,20385003001,125,41,84,1.36
2020,CB2020,005,2,Bronx,20385003002,234,123,111,1.14
2020,CB2020,005,2,Bronx,20385003003,226,100,126,1.16
2020,CB2020,005,2,Bronx,20385003004,177,87,90,1.37
2020,CB2020,005,2,Bronx,20385003005,363,184,179,1.76
2020,CB2020,005,2,Bronx,20385003006,75,27,48,1.05
2020,CB2020,005,2,Bronx,20385004000,651,324,327,3.15
2020,CB2020,005,2,Bronx,20385004001,420,187,233,1.92
2020,CB2020,005,2,Bronx,20385004002,59,23,36,0.95
2020,CB2020,005,2,Bronx,20385004003,0,0,0,1.26
2020,CB2020,005,2,Bronx,20385004004,278,111,167,2.95
2020,CB2020,005,2,Bronx,20385004005,631,263,368,4.25
2020,CB2020,005,2,Bronx,20385004006,97,69,28,0.71
2020,CB2020,005,2,Bronx,20386001000,409,162,247,6.67
2020,CB2020,005,2,Bronx,20386001001,244,127,117,4.86
2020,CB2020,005,2,Bronx,20386001002,110,59,51,1.89
2020,CB2020,005,2,Bronx,20386001003,89,39,50,1.59
2020,CB2020,005,2,Bronx,20386001004,139,81,58,3.03
2020,CB2020,005,2,Bronx,20386001005,132,47,85,2.62
2020,CB2020,005,2,Bronx,20386002000,25,5,20,1.81
2020,CB2020,005,2,Bronx,20386002001,241,131,110,4.7
2020,CB2020,005,2,Bronx,20386002002,296,129,167,5.6
2020,CB2020,005,2,Bronx,20386002003,80,51,29,2.03
2020,CB2020,005,2,Bronx,20386002004,318,144,174,4.62
2020,CB2020,005,2,Bronx,20386002005,204,68,136,3.95
2020,CB2020,005,2,Bronx,20386003000,966,444,522,5.72
2020,CB2020,005,2,Bronx,20386003001,0,0,0,0.32
2020,CB2020,005,2,Bronx,20386004000,30,11,19,0.85
2020,CB2020,005,2,Bronx,20386004001,0,0,0,0.14
2020,CB2020,005,2,Bronx,20386004002,217,103,114,3.3
2020,CB2020,005,2,Bronx,20386004003,353,177,176,5.59
2020,CB2020,005,2,Bronx,20386004004,171,100,71,2.46
2020,CB2020,005,2,Bronx,20386004005,50,29,21,2.75
2020,CB2020,005,2,Bronx,20386005000,129,66,63,2.14
2020,CB2020,005,2,Bronx,20386005001,22,8,14,1.84
2020,CB2020,005,2,Bronx,20386005002,347,165,182,4.92
2020,CB2020,005,2,Bronx,20386005003,124,50,74,2.39
2020,CB2020,005,2,Bronx,20386005004,148,52,96,2.6
2020,CB2020,005,2,Bronx,20386005005,123,67,56,1.65
2020,CB2020,005,2,Bronx,20386006000,1002,442,560,6.02
2020,CB2020,005,2,Bronx,20386007000,428,181,247,4.98
2020,CB2020,005,2,Bronx,20386007001,740,326,414,4.65
2020,CB2020,005,2,Bronx,20386008000,812,370,442,5.46
2020,CB2020,005,2,Bronx,20387001000,21,6,15,4.73
2020,CB2020,005,2,Bronx,20387001001,0,0,0,3.09
2020,CB2020,005,2,Bronx,20387001002,429,212,217,4.57
2020,CB2020,005,2,Bronx,20387001003,0,0,0,4.75
2020,CB2020,005,2,Bronx,20387001004,75,29,46,2.33
2020,CB2020,005,2,Bronx,20387001005,173,97,76,2.54
2020,CB2020,005,2,Bronx,20387001006,521,237,284,4.04
2020,CB2020,005,2,Bronx,20387001007,0,0,0,0.47
2020,CB2020,005,2,Bronx,20387002000,94,48,46,2.28
2020,CB2020,005,2,Bronx,20387002001,422,224,198,2.82
2020,CB2020,005,2,Bronx,20387002002,501,246,255,4.26
2020,CB2020,005,2,Bronx,20387003000,0,0,0,2.28
2020,CB2020,005,2,Bronx,20387003001,337,167,170,2.43
2020,CB2020,005,2,Bronx,20387003002,573,338,235,2.18
2020,CB2020,005,2,Bronx,20387003003,255,111,144,2.07
2020,CB2020,005,2,Bronx,20388001000,431,196,235,4.73
2020,CB2020,005,2,Bronx,20388001001,359,146,213,4.65
2020,CB2020,005,2,Bronx,20388001002,395,183,212,4.46
2020,CB2020,005,2,Bronx,20388001003,311,159,152,4.08
2020,CB2020,005,2,Bronx,20388002000,295,130,165,4.78
2020,CB2020,005,2,Bronx,20388002001,446,193,253,4.81
2020,CB2020,005,2,Bronx,20388002002,366,184,182,4.72
2020,CB2020,005,2,Bronx,20388002003,338,164,174,4.5
2020,CB2020,005,2,Bronx,20389001000,0,0,0,0.5
2020,CB2020,005,2,Bronx,20389001001,449,228,221,3.17
2020,CB2020,005,2,Bronx,20389001002,203,101,102,3.95
2020,CB2020,005,2,Bronx,20389001003,411,199,212,1.97
2020,CB2020,005,2,Bronx,20389001004,324,194,130,2.32
2020,CB2020,005,2,Bronx,20389002000,148,82,66,2.69
2020,CB2020,005,2,Bronx,20389002001,396,185,211,2.09
2020,CB2020,005,2,Bronx,20389002002,248,109,139,1.99
2020,CB2020,005,2,Bronx,20389003000,119,64,55,2.82
2020,CB2020,005,2,Bronx,20389003001,241,121,120,2.37
2020,CB2020,005,2,Bronx,20389003002,162,93,69,2.13
2020,CB2020,005,2,Bronx,20389003003,251,108,143,2.75
2020,CB2020,005,2,Bronx,20389003004,116,59,57,2.55
2020,CB2020,005,2,Bronx,20389003005,32,15,17,2.03
2020,CB2020,005,2,Bronx,20389004000,1002,494,508,4.38
2020,CB2020,005,2,Bronx,20389005000,329,171,158,2.21
2020,CB2020,005,2,Bronx,20389005001,388,174,214,2.17
2020,CB2020,005,2,Bronx,20390001000,414,183,231,5.52
2020,CB2020,005,2,Bronx,20390001001,421,214,207,5.52
2020,CB2020,005,2,Bronx,20390001002,272,132,140,5.49
2020,CB2020,005,2,Bronx,20390001003,446,198,248,5.47
2020,CB2020,005,2,Bronx,20390002000,416,173,243,5.45
2020,CB2020,005,2,Bronx,20390002001,493,284,209,5.56
2020,CB2020,005,2,Bronx,20390002002,553,278,275,5.57
2020,CB2020,005,2,Bronx,20390002003,308,143,165,6.31
2020,CB2020,005,2,Bronx,20391001000,1027,485,542,4.74
2020,CB2020,005,2,Bronx,20391001001,131,54,77,1.43
2020,CB2020,005,2,Bronx,20391001002,0,0,0,0.36
2020,CB2020,005,2,Bronx,20391001003,142,76,66,1.96
2020,CB2020,005,2,Bronx,20391002000,838,421,417,4.9
2020,CB2020,005,2,Bronx,20391002001,455,195,260,4.04
2020,CB2020,005,2,Bronx,20391002002,120,53,67,3.13
2020,CB2020,005,2,Bronx,20391002003,0,0,0,2.01
2020,CB2020,005,2,Bronx,20391003000,52,27,25,0.6
2020,CB2020,005,2,Bronx,20391003001,688,348,340,2.89
2020,CB2020,005,2,Bronx,20391003002,212,84,128,1.95
2020,CB2020,005,2,Bronx,20391003003,515,266,249,2.58
2020,CB2020,005,2,Bronx,20391004000,437,202,235,2.92
2020,CB2020,005,2,Bronx,20391004001,245,157,88,1.17
2020,CB2020,005,2,Bronx,20391004002,169,82,87,2.79
2020,CB2020,005,2,Bronx,20391004003,0,0,0,0.5
2020,CB2020,005,2,Bronx,20391004004,226,90,136,1.74
2020,CB2020,005,2,Bronx,20391005000,847,447,400,6.06
2020,CB2020,005,2,Bronx,20391006000,237,112,125,1.81
2020,CB2020,005,2,Bronx,20391006001,478,255,223,1.74
2020,CB2020,005,2,Bronx,20391006002,391,197,194,1.52
2020,CB2020,005,2,Bronx,20392001000,392,182,210,5.03
2020,CB2020,005,2,Bronx,20392001001,630,284,346,5.04
2020,CB2020,005,2,Bronx,20392002000,560,251,309,5.52
2020,CB2020,005,2,Bronx,20392002001,227,109,118,7.86
2020,CB2020,005,2,Bronx,20392002002,0,0,0,0.3
2020,CB2020,005,2,Bronx,20393001000,0,0,0,0.45
2020,CB2020,005,2,Bronx,20393001001,2075,897,1178,14.2
2020,CB2020,005,2,Bronx,20393002000,999,404,595,3.92
2020,CB2020,005,2,Bronx,20393002001,525,245,280,3.16
2020,CB2020,005,2,Bronx,20393002002,416,180,236,3.56
2020,CB2020,005,2,Bronx,20393003000,964,425,539,3.39
2020,CB2020,005,2,Bronx,20393004000,1304,598,706,5.11
2020,CB2020,005,2,Bronx,20393005000,549,250,299,3.93
2020,CB2020,005,2,Bronx,20393006000,821,357,464,3.3
2020,CB2020,005,2,Bronx,20393006001,74,13,61,1.11
2020,CB2020,005,2,Bronx,20393006002,306,135,171,2.78
2020,CB2020,005,2,Bronx,20394001000,891,417,474,3.36
2020,CB2020,005,2,Bronx,20394002000,403,203,200,5.54
2020,CB2020,005,2,Bronx,20394002001,979,432,547,5.49
2020,CB2020,005,2,Bronx,20394002002,233,130,103,3.69
2020,CB2020,005,2,Bronx,20394002003,167,93,74,1.8
2020,CB2020,005,2,Bronx,20394003000,1039,481,558,5.02
2020,CB2020,005,2,Bronx,20394004000,478,225,253,5.51
2020,CB2020,005,2,Bronx,20394004001,457,197,260,5.48
2020,CB2020,005,2,Bronx,20395001000,633,308,325,6.23
2020,CB2020,005,2,Bronx,20395001001,0,0,0,1.85
2020,CB2020,005,2,Bronx,20395001002,0,0,0,0.82
2020,CB2020,005,2,Bronx,20395001003,259,136,123,2.63
2020,CB2020,005,2,Bronx,20395001004,115,55,60,1.9
2020,CB2020,005,2,Bronx,20395001005,16,7,9,4.47
2020,CB2020,005,2,Bronx,20395002000,243,143,100,5.82
2020,CB2020,005,2,Bronx,20395002001,0,0,0,1.79
2020,CB2020,005,2,Bronx,20395002002,336,156,180,4.07
2020,CB2020,005,2,Bronx,20395002003,159,71,88,3.6
2020,CB2020,005,2,Bronx,20395002004,172,79,93,3.06
2020,CB2020,005,2,Bronx,20395003000,519,254,265,3.05
2020,CB2020,005,2,Bronx,20395003001,367,190,177,4.24
2020,CB2020,005,2,Bronx,20395003002,0,0,0,1.37
2020,CB2020,005,2,Bronx,20395003003,0,0,0,1.41
2020,CB2020,005,2,Bronx,20395003004,82,38,44,4.35
2020,CB2020,005,2,Bronx,20395003005,162,43,119,2.84
2020,CB2020,005,2,Bronx,20395003006,36,21,15,2.91
2020,CB2020,005,2,Bronx,20395004000,31,9,22,18.67
2020,CB2020,005,2,Bronx,20395004001,314,146,168,2.83
2020,CB2020,005,2,Bronx,20395004002,18,10,8,2.95
2020,CB2020,005,2,Bronx,20395004003,28,15,13,3.26
2020,CB2020,005,2,Bronx,20395004004,0,0,0,0.97
2020,CB2020,005,2,Bronx,20395004005,0,0,0,1.23
2020,CB2020,005,2,Bronx,20395004006,151,70,81,3.93
2020,CB2020,005,2,Bronx,20395004007,369,165,204,3.18
2020,CB2020,005,2,Bronx,20395004008,213,59,154,2.94
2020,CB2020,005,2,Bronx,20395004009,0,0,0,0.44
2020,CB2020,005,2,Bronx,20395004010,0,0,0,0.9
2020,CB2020,005,2,Bronx,20395004011,31,25,6,1.83
2020,CB2020,005,2,Bronx,20395004012,0,0,0,0.73
2020,CB2020,005,2,Bronx,20395004013,0,0,0,0.88
2020,CB2020,005,2,Bronx,20396001000,434,194,240,5.54
2020,CB2020,005,2,Bronx,20396001001,332,171,161,2.81
2020,CB2020,005,2,Bronx,20396001002,221,84,137,2.69
2020,CB2020,005,2,Bronx,20396002000,414,196,218,5.54
2020,CB2020,005,2,Bronx,20396002001,412,178,234,5.54
2020,CB2020,005,2,Bronx,20396002002,425,167,258,5.53
2020,CB2020,005,2,Bronx,20396003000,451,177,274,5.53
2020,CB2020,005,2,Bronx,20396003001,584,276,308,5.49
2020,CB2020,005,2,Bronx,20396003002,426,224,202,5.49
2020,CB2020,005,2,Bronx,20396004000,379,200,179,5.51
2020,CB2020,005,2,Bronx,20396004001,285,121,164,2.77
2020,CB2020,005,2,Bronx,20396004002,122,53,69,2.74
2020,CB2020,005,2,Bronx,20397001000,0,0,0,13.57
2020,CB2020,005,2,Bronx,20397001001,167,64,103,3.14
2020,CB2020,005,2,Bronx,20397001002,994,430,564,62.1
2020,CB2020,005,2,Bronx,20397001003,326,157,169,17.57
2020,CB2020,005,2,Bronx,20397001004,130,38,92,2.3
2020,CB2020,005,2,Bronx,20397001005,1902,845,1057,15.24
2020,CB2020,005,2,Bronx,20397001006,0,0,0,0.8
2020,CB2020,005,2,Bronx,20397001007,0,0,0,0.74
2020,CB2020,005,2,Bronx,20397001008,162,74,88,2.43
2020,CB2020,005,2,Bronx,20397001009,0,0,0,1.3
2020,CB2020,005,2,Bronx,20397001010,0,0,0,0.63
2020,CB2020,005,2,Bronx,20397001011,0,0,0,0.39
2020,CB2020,005,2,Bronx,20397001012,0,0,0,0.47
2020,CB2020,005,2,Bronx,20397001013,0,0,0,0.8
2020,CB2020,005,2,Bronx,20397001014,0,0,0,0.63
2020,CB2020,005,2,Bronx,20397001015,0,0,0,0.74
2020,CB2020,005,2,Bronx,20397001016,9,9,0,0.46
2020,CB2020,005,2,Bronx,20397002000,394,179,215,3.42
2020,CB2020,005,2,Bronx,20397002001,231,118,113,1.21
2020,CB2020,005,2,Bronx,20397002002,177,91,86,1.87
2020,CB2020,005,2,Bronx,20398001000,317,146,171,5.04
2020,CB2020,005,2,Bronx,20398001001,160,97,63,2.92
2020,CB2020,005,2,Bronx,20398001002,134,66,68,2.04
2020,CB2020,005,2,Bronx,20398001003,379,169,210,4.96
2020,CB2020,005,2,Bronx,20398001004,0,0,0,4.93
2020,CB2020,005,2,Bronx,20398001005,335,168,167,4.88
2020,CB2020,005,2,Bronx,20398002000,424,205,219,5.03
2020,CB2020,005,2,Bronx,20398002001,369,133,236,4.94
2020,CB2020,005,2,Bronx,20398002002,349,162,187,4.83
2020,CB2020,005,2,Bronx,20398003000,456,188,268,5.2
2020,CB2020,005,2,Bronx,20398003001,301,146,155,2.41
2020,CB2020,005,2,Bronx,20398003002,123,39,84,2.7
2020,CB2020,005,2,Bronx,20399011000,509,274,235,4.67
2020,CB2020,005,2,Bronx,20399011001,698,347,351,4.68
2020,CB2020,005,2,Bronx,20399011002,0,0,0,0.79
2020,CB2020,005,2,Bronx,20399011003,0,0,0,0.54
2020,CB2020,005,2,Bronx,20399012000,235,116,119,1.32
2020,CB2020,005,2,Bronx,20399012001,611,292,319,3.69
2020,CB2020,005,2,Bronx,20399013000,429,191,238,2.09
2020,CB2020,005,2,Bronx,20399013001,540,234,306,4.6
2020,CB2020,005,2,Bronx,20399014000,0,0,0,0.36
2020,CB2020,005,2,Bronx,20399014001,0,0,0,0.35
2020,CB2020,005,2,Bronx,20399014002,0,0,0,3.71
2020,CB2020,005,2,Bronx,20399014003,0,0,0,0.55
2020,CB2020,005,2,Bronx,20399014004,1311,647,664,4.17
2020,CB2020,005,2,Bronx,20399015000,881,416,465,4.62
2020,CB2020,005,2,Bronx,20399015001,40,17,23,1.34
2020,CB2020,005,2,Bronx,20399021000,537,267,270,5.53
2020,CB2020,005,2,Bronx,20399021001,212,114,98,2.96
2020,CB2020,005,2,Bronx,20399021002,510,252,258,3.16
2020,CB2020,005,2,Bronx,20399022000,657,311,346,2.41
2020,CB2020,005,2,Bronx,20399023000,421,205,216,1.68
2020,CB2020,005,2,Bronx,20399023001,421,223,198,1.46
2020,CB2020,005,2,Bronx,20399023002,947,422,525,3.22
2020,CB2020,005,2,Bronx,20399024000,951,465,486,3.43
2020,CB2020,005,2,Bronx,20399025000,218,105,113,2.68
2020,CB2020,005,2,Bronx,20399025001,674,338,336,3.48
2020,CB2020,005,2,Bronx,20401001000,1237,562,675,3.1
2020,CB2020,005,2,Bronx,20401001001,51,22,29,0.62
2020,CB2020,005,2,Bronx,20401002000,242,115,127,2.19
2020,CB2020,005,2,Bronx,20401002001,491,245,246,2.53
2020,CB2020,005,2,Bronx,20401002002,408,213,195,16.16
2020,CB2020,005,2,Bronx,20401002003,0,0,0,2.08
2020,CB2020,005,2,Bronx,20401002004,0,0,0,0.41
2020,CB2020,005,2,Bronx,20401003000,203,94,109,3.33
2020,CB2020,005,2,Bronx,20401003001,516,247,269,2.99
2020,CB2020,005,2,Bronx,20401004000,835,411,424,2.8
2020,CB2020,005,2,Bronx,20401005000,1026,532,494,5
2020,CB2020,005,2,Bronx,20401005001,0,0,0,0.9
2020,CB2020,005,2,Bronx,20403021000,0,0,0,0.37
2020,CB2020,005,2,Bronx,20403021001,679,333,346,2.11
2020,CB2020,005,2,Bronx,20403021002,1754,811,943,5.48
2020,CB2020,005,2,Bronx,20403021003,0,0,0,0.94
2020,CB2020,005,2,Bronx,20403021004,0,0,0,0.36
2020,CB2020,005,2,Bronx,20403022000,0,0,0,0.4
2020,CB2020,005,2,Bronx,20403022001,934,421,513,2.94
2020,CB2020,005,2,Bronx,20403023000,0,0,0,0.31
2020,CB2020,005,2,Bronx,20403023001,830,398,432,2.58
2020,CB2020,005,2,Bronx,20403031000,356,171,185,1.91
2020,CB2020,005,2,Bronx,20403031001,0,0,0,0.45
2020,CB2020,005,2,Bronx,20403031002,0,0,0,0.91
2020,CB2020,005,2,Bronx,20403031003,1067,490,577,4.66
2020,CB2020,005,2,Bronx,20403032000,1519,734,785,7.46
2020,CB2020,005,2,Bronx,20403033000,36,18,18,1.24
2020,CB2020,005,2,Bronx,20403033001,1865,870,995,5
2020,CB2020,005,2,Bronx,20403041000,1396,632,764,5.79
2020,CB2020,005,2,Bronx,20403042000,1482,725,757,4.62
2020,CB2020,005,2,Bronx,20403043000,1247,524,723,4.97
2020,CB2020,005,2,Bronx,20403043001,0,0,0,1
2020,CB2020,005,2,Bronx,20403043002,0,0,0,0.26
2020,CB2020,005,2,Bronx,20404001000,369,171,198,5.36
2020,CB2020,005,2,Bronx,20404001001,373,180,193,5.25
2020,CB2020,005,2,Bronx,20404001002,445,198,247,5.17
2020,CB2020,005,2,Bronx,20404001003,301,143,158,5.09
2020,CB2020,005,2,Bronx,20404001004,364,146,218,5.09
2020,CB2020,005,2,Bronx,20404002000,387,171,216,5.38
2020,CB2020,005,2,Bronx,20404002001,383,161,222,5.3
2020,CB2020,005,2,Bronx,20404003000,198,84,114,5.54
2020,CB2020,005,2,Bronx,20404003001,352,155,197,5.54
2020,CB2020,005,2,Bronx,20404003002,358,153,205,5.48
2020,CB2020,005,2,Bronx,20405011000,1431,643,788,4.7
2020,CB2020,005,2,Bronx,20405011001,667,404,263,4.78
2020,CB2020,005,2,Bronx,20405012000,987,472,515,3.52
2020,CB2020,005,2,Bronx,20405013000,431,160,271,1.92
2020,CB2020,005,2,Bronx,20405013001,518,243,275,1.97
2020,CB2020,005,2,Bronx,20405013002,351,159,192,3.59
2020,CB2020,005,2,Bronx,20405021000,1130,565,565,5.02
2020,CB2020,005,2,Bronx,20405022000,1785,819,966,6.68
2020,CB2020,005,2,Bronx,20405023000,260,110,150,2.85
2020,CB2020,005,2,Bronx,20405023001,912,425,487,3.89
2020,CB2020,005,2,Bronx,20405024000,502,246,256,2.38
2020,CB2020,005,2,Bronx,20405024001,691,337,354,3.58
2020,CB2020,005,2,Bronx,20405025000,801,368,433,3.26
2020,CB2020,005,2,Bronx,20405026000,789,390,399,3.9
2020,CB2020,005,2,Bronx,20405026001,450,219,231,3.35
2020,CB2020,005,2,Bronx,20406001000,359,161,198,5.51
2020,CB2020,005,2,Bronx,20406001001,318,124,194,5.52
2020,CB2020,005,2,Bronx,20406001002,431,193,238,5.51
2020,CB2020,005,2,Bronx,20406001003,289,137,152,5.52
2020,CB2020,005,2,Bronx,20406001004,307,168,139,5.51
2020,CB2020,005,2,Bronx,20406002000,457,206,251,5.53
2020,CB2020,005,2,Bronx,20406002001,453,218,235,5.51
2020,CB2020,005,2,Bronx,20406003000,577,272,305,5.56
2020,CB2020,005,2,Bronx,20406003001,214,112,102,5.5
2020,CB2020,005,2,Bronx,20406003002,387,164,223,5.51
2020,CB2020,005,2,Bronx,20407011000,559,273,286,3.22
2020,CB2020,005,2,Bronx,20407011001,492,243,249,1.47
2020,CB2020,005,2,Bronx,20407011002,0,0,0,0.26
2020,CB2020,005,2,Bronx,20407012000,650,323,327,3.65
2020,CB2020,005,2,Bronx,20407012001,0,0,0,0.38
2020,CB2020,005,2,Bronx,20407013000,1534,747,787,4.61
2020,CB2020,005,2,Bronx,20407013001,0,0,0,0.8
2020,CB2020,005,2,Bronx,20407021000,57,33,24,1.86
2020,CB2020,005,2,Bronx,20407021001,228,105,123,2.01
2020,CB2020,005,2,Bronx,20407021002,376,166,210,1.76
2020,CB2020,005,2,Bronx,20407022000,567,233,334,11.57
2020,CB2020,005,2,Bronx,20407022001,244,100,144,1.51
2020,CB2020,005,2,Bronx,20407022002,183,72,111,1.45
2020,CB2020,005,2,Bronx,20407022003,414,240,174,1.84
2020,CB2020,005,2,Bronx,20407023000,0,0,0,0.45
2020,CB2020,005,2,Bronx,20407023001,601,264,337,2.35
2020,CB2020,005,2,Bronx,20407023002,1563,754,809,5.48
2020,CB2020,005,2,Bronx,20407023003,0,0,0,1.02
2020,CB2020,005,2,Bronx,20407024000,378,185,193,2
2020,CB2020,005,2,Bronx,20407024001,549,268,281,2.47
2020,CB2020,005,2,Bronx,20407024002,721,393,328,4.21
2020,CB2020,005,2,Bronx,20407025000,1087,524,563,5.04
2020,CB2020,005,2,Bronx,20408001000,714,311,403,3.59
2020,CB2020,005,2,Bronx,20408002000,154,85,69,1.92
2020,CB2020,005,2,Bronx,20408002001,254,91,163,3.86
2020,CB2020,005,2,Bronx,20408002002,508,246,262,3.57
2020,CB2020,005,2,Bronx,20408003000,402,210,192,1.67
2020,CB2020,005,2,Bronx,20408003001,549,244,305,3.44
2020,CB2020,005,2,Bronx,20408004000,533,256,277,3.6
2020,CB2020,005,2,Bronx,20408004001,636,285,351,5.51
2020,CB2020,005,2,Bronx,20408004002,725,337,388,3.49
2020,CB2020,005,2,Bronx,20409001000,0,0,0,0.39
2020,CB2020,005,2,Bronx,20409001001,28,12,16,32.65
2020,CB2020,005,2,Bronx,20409001002,0,0,0,19.08
2020,CB2020,005,2,Bronx,20409001003,0,0,0,15.1
2020,CB2020,005,2,Bronx,20409001004,3139,1411,1728,19.14
2020,CB2020,005,2,Bronx,20409001005,0,0,0,18.97
2020,CB2020,005,2,Bronx,20409001006,0,0,0,44.89
2020,CB2020,005,2,Bronx,20409001007,0,0,0,0.35
2020,CB2020,005,2,Bronx,20409002000,249,115,134,51.15
2020,CB2020,005,2,Bronx,20409002001,0,0,0,0
2020,CB2020,005,2,Bronx,20409002002,164,71,93,2.31
2020,CB2020,005,2,Bronx,20411001000,0,0,0,1.47
2020,CB2020,005,2,Bronx,20411001001,431,243,188,3.96
2020,CB2020,005,2,Bronx,20411001002,0,0,0,0.67
2020,CB2020,005,2,Bronx,20411001003,0,0,0,1.05
2020,CB2020,005,2,Bronx,20411001004,744,310,434,4.09
2020,CB2020,005,2,Bronx,20411002000,262,140,122,3.36
2020,CB2020,005,2,Bronx,20411002001,375,177,198,1.7
2020,CB2020,005,2,Bronx,20411002002,144,79,65,1.61
2020,CB2020,005,2,Bronx,20411002003,0,0,0,0.35
2020,CB2020,005,2,Bronx,20411003000,0,0,0,1.25
2020,CB2020,005,2,Bronx,20411003001,993,481,512,5.68
2020,CB2020,005,2,Bronx,20411003002,266,131,135,4.85
2020,CB2020,005,2,Bronx,20413001000,1023,498,525,5.19
2020,CB2020,005,2,Bronx,20413001001,0,0,0,0.29
2020,CB2020,005,2,Bronx,20413001002,0,0,0,0.3
2020,CB2020,005,2,Bronx,20413001003,0,0,0,0.3
2020,CB2020,005,2,Bronx,20413001004,374,174,200,2.4
2020,CB2020,005,2,Bronx,20413001005,377,199,178,3.08
2020,CB2020,005,2,Bronx,20413002000,631,310,321,2.61
2020,CB2020,005,2,Bronx,20413002001,0,0,0,0.31
2020,CB2020,005,2,Bronx,20413003000,817,424,393,4.12
2020,CB2020,005,2,Bronx,20413003001,0,0,0,0.27
2020,CB2020,005,2,Bronx,20413003002,61,23,38,0.48
2020,CB2020,005,2,Bronx,20413004000,27,12,15,0.37
2020,CB2020,005,2,Bronx,20413004001,262,120,142,1.79
2020,CB2020,005,2,Bronx,20413004002,507,253,254,2.96
2020,CB2020,005,2,Bronx,20413004003,361,185,176,1.94
2020,CB2020,005,2,Bronx,20413004004,36,23,13,0.65
2020,CB2020,005,2,Bronx,20413005000,942,474,468,3.72
2020,CB2020,005,2,Bronx,20413006000,602,272,330,3.07
2020,CB2020,005,2,Bronx,20413006001,626,292,334,2.39
2020,CB2020,005,2,Bronx,20413007000,597,265,332,2.66
2020,CB2020,005,2,Bronx,20413007001,0,0,0,0.33
2020,CB2020,005,2,Bronx,20413007002,0,0,0,0.35
2020,CB2020,005,2,Bronx,20413007003,538,245,293,3.3
2020,CB2020,005,2,Bronx,20414001000,168,75,93,4.86
2020,CB2020,005,2,Bronx,20414001001,119,76,43,4.88
2020,CB2020,005,2,Bronx,20414001002,291,144,147,6.47
2020,CB2020,005,2,Bronx,20414001003,244,150,94,5.37
2020,CB2020,005,2,Bronx,20414001004,285,113,172,4
2020,CB2020,005,2,Bronx,20414001005,269,141,128,4.07
2020,CB2020,005,2,Bronx,20414002000,524,267,257,5.35
2020,CB2020,005,2,Bronx,20414002001,196,105,91,4.36
2020,CB2020,005,2,Bronx,20414002002,215,100,115,3.43
2020,CB2020,005,2,Bronx,20414002003,297,138,159,3.44
2020,CB2020,005,2,Bronx,20414003000,75,39,36,1.11
2020,CB2020,005,2,Bronx,20414003001,119,62,57,2.18
2020,CB2020,005,2,Bronx,20414003002,55,28,27,2.05
2020,CB2020,005,2,Bronx,20414003003,393,156,237,4.58
2020,CB2020,005,2,Bronx,20414003004,257,111,146,4.42
2020,CB2020,005,2,Bronx,20414003005,27,13,14,0.32
2020,CB2020,005,2,Bronx,20414004000,0,0,0,0.54
2020,CB2020,005,2,Bronx,20414004001,28,12,16,13.78
2020,CB2020,005,2,Bronx,20414004002,43,14,29,2.71
2020,CB2020,005,2,Bronx,20414004003,264,131,133,4.02
2020,CB2020,005,2,Bronx,20414004004,202,169,33,2.25
2020,CB2020,005,2,Bronx,20414004005,152,70,82,2.07
2020,CB2020,005,2,Bronx,20414004006,0,0,0,4.31
2020,CB2020,005,2,Bronx,20414004007,0,0,0,10.8
2020,CB2020,005,2,Bronx,20414004008,0,0,0,0.17
2020,CB2020,005,2,Bronx,20414004009,0,0,0,4.39
2020,CB2020,005,2,Bronx,20414004010,0,0,0,3.14
2020,CB2020,005,2,Bronx,20414004011,162,81,81,3.33
2020,CB2020,005,2,Bronx,20414004012,338,173,165,4.89
2020,CB2020,005,2,Bronx,20414004013,257,110,147,3.45
2020,CB2020,005,2,Bronx,20414004014,21,7,14,3.86
2020,CB2020,005,2,Bronx,20414004015,341,155,186,4.2
2020,CB2020,005,2,Bronx,20415001000,431,199,232,2.15
2020,CB2020,005,2,Bronx,20415001001,1133,522,611,4.18
2020,CB2020,005,2,Bronx,20415002000,703,354,349,4.38
2020,CB2020,005,2,Bronx,20415003000,719,320,399,4.14
2020,CB2020,005,2,Bronx,20415004000,166,55,111,3.6
2020,CB2020,005,2,Bronx,20415004001,434,206,228,3.09
2020,CB2020,005,2,Bronx,20415005000,1004,477,527,4.29
2020,CB2020,005,2,Bronx,20415006000,426,206,220,1.69
2020,CB2020,005,2,Bronx,20415006001,275,116,159,1.31
2020,CB2020,005,2,Bronx,20415006002,581,291,290,4.75
2020,CB2020,005,2,Bronx,20418001000,96,31,65,3.17
2020,CB2020,005,2,Bronx,20418001001,324,173,151,2.94
2020,CB2020,005,2,Bronx,20418001002,382,172,210,2.95
2020,CB2020,005,2,Bronx,20418001003,154,116,38,2.94
2020,CB2020,005,2,Bronx,20418001004,29,13,16,3.02
2020,CB2020,005,2,Bronx,20418001005,0,0,0,8.41
2020,CB2020,005,2,Bronx,20418001006,41,10,31,4.36
2020,CB2020,005,2,Bronx,20418001007,0,0,0,0.89
2020,CB2020,005,2,Bronx,20418001008,0,0,0,5.57
2020,CB2020,005,2,Bronx,20418001009,50,20,30,0.54
2020,CB2020,005,2,Bronx,20418002000,410,196,214,5.09
2020,CB2020,005,2,Bronx,20418002001,316,145,171,3.96
2020,CB2020,005,2,Bronx,20418002002,277,119,158,4.08
2020,CB2020,005,2,Bronx,20418002003,198,100,98,4.16
2020,CB2020,005,2,Bronx,20418003000,549,258,291,5.57
2020,CB2020,005,2,Bronx,20418003001,150,66,84,3.25
2020,CB2020,005,2,Bronx,20418004000,776,352,424,5.54
2020,CB2020,005,2,Bronx,20419001000,235,107,128,3.88
2020,CB2020,005,2,Bronx,20419001001,90,32,58,4.1
2020,CB2020,005,2,Bronx,20419001002,134,57,77,3.98
2020,CB2020,005,2,Bronx,20419001003,474,226,248,3
2020,CB2020,005,2,Bronx,20419001004,238,106,132,1.12
2020,CB2020,005,2,Bronx,20419002000,640,267,373,3.25
2020,CB2020,005,2,Bronx,20419003000,422,191,231,3.41
2020,CB2020,005,2,Bronx,20419003001,1147,528,619,4.14
2020,CB2020,005,2,Bronx,20419004000,1116,547,569,3.8
2020,CB2020,005,2,Bronx,20419004001,0,0,0,12.34
2020,CB2020,005,2,Bronx,20419004002,0,0,0,0.56
2020,CB2020,005,2,Bronx,20419004003,0,0,0,1.1
2020,CB2020,005,2,Bronx,20419004004,0,0,0,0.71
2020,CB2020,005,2,Bronx,20419004005,0,0,0,0.34
2020,CB2020,005,2,Bronx,20419004006,0,0,0,2.16
2020,CB2020,005,2,Bronx,20419004007,0,0,0,7.56
2020,CB2020,005,2,Bronx,20419004008,0,0,0,5.1
2020,CB2020,005,2,Bronx,20419004009,0,0,0,5.65
2020,CB2020,005,2,Bronx,20419005000,775,364,411,4.03
2020,CB2020,005,2,Bronx,20419006000,964,442,522,3.43
2020,CB2020,005,2,Bronx,20419007000,655,318,337,2.73
2020,CB2020,005,2,Bronx,20419007001,315,155,160,4.14
2020,CB2020,005,2,Bronx,20420001000,1016,474,542,6.04
2020,CB2020,005,2,Bronx,20420001001,0,0,0,2.08
2020,CB2020,005,2,Bronx,20420001002,0,0,0,7.38
2020,CB2020,005,2,Bronx,20420002000,856,387,469,5.07
2020,CB2020,005,2,Bronx,20420002001,679,270,409,5.52
2020,CB2020,005,2,Bronx,20420003000,908,389,519,5.56
2020,CB2020,005,2,Bronx,20420003001,68,39,29,1.93
2020,CB2020,005,2,Bronx,20420003002,378,183,195,3.6
2020,CB2020,005,2,Bronx,20421001000,12,7,5,12.34
2020,CB2020,005,2,Bronx,20421001001,42,21,21,3.22
2020,CB2020,005,2,Bronx,20421001002,838,376,462,2.94
2020,CB2020,005,2,Bronx,20421002000,1014,476,538,6.45
2020,CB2020,005,2,Bronx,20421003000,889,391,498,6.2
2020,CB2020,005,2,Bronx,20421003001,395,175,220,1.41
2020,CB2020,005,2,Bronx,20421004000,1756,797,959,4.9
2020,CB2020,005,2,Bronx,20421005000,1189,531,658,3.29
2020,CB2020,005,2,Bronx,20421005001,0,0,0,14.67
2020,CB2020,005,2,Bronx,20421005002,0,0,0,0.4
2020,CB2020,005,2,Bronx,20421005003,0,0,0,0.28
2020,CB2020,005,2,Bronx,20421005004,0,0,0,4.37
2020,CB2020,005,2,Bronx,20421005005,0,0,0,0.37
2020,CB2020,005,2,Bronx,20422001000,205,71,134,3.61
2020,CB2020,005,2,Bronx,20422001001,81,33,48,1.31
2020,CB2020,005,2,Bronx,20422001002,48,25,23,0.92
2020,CB2020,005,2,Bronx,20422001003,93,41,52,4.11
2020,CB2020,005,2,Bronx,20422001004,376,134,242,5.57
2020,CB2020,005,2,Bronx,20422001005,498,263,235,5.55
2020,CB2020,005,2,Bronx,20422001006,412,185,227,5.53
2020,CB2020,005,2,Bronx,20422002000,712,296,416,5.52
2020,CB2020,005,2,Bronx,20422002001,379,185,194,5.52
2020,CB2020,005,2,Bronx,20422002002,407,163,244,5.53
2020,CB2020,005,2,Bronx,20423001000,880,406,474,2.83
2020,CB2020,005,2,Bronx,20423001001,333,192,141,1.55
2020,CB2020,005,2,Bronx,20423002000,511,263,248,4.39
2020,CB2020,005,2,Bronx,20423002001,0,0,0,20.44
2020,CB2020,005,2,Bronx,20423002002,0,0,0,0.72
2020,CB2020,005,2,Bronx,20423002003,1083,529,554,5.96
2020,CB2020,005,2,Bronx,20423003000,569,282,287,4.67
2020,CB2020,005,2,Bronx,20423003001,803,410,393,4.01
2020,CB2020,005,2,Bronx,20424001000,329,166,163,4.97
2020,CB2020,005,2,Bronx,20424001001,332,162,170,5.45
2020,CB2020,005,2,Bronx,20424001002,248,87,161,5.5
2020,CB2020,005,2,Bronx,20424001003,342,168,174,5.4
2020,CB2020,005,2,Bronx,20424002000,229,100,129,5.29
2020,CB2020,005,2,Bronx,20424002001,362,156,206,5.55
2020,CB2020,005,2,Bronx,20424002002,382,152,230,5.56
2020,CB2020,005,2,Bronx,20424002003,329,145,184,5.54
2020,CB2020,005,2,Bronx,20425001000,900,459,441,6.74
2020,CB2020,005,2,Bronx,20425002000,1377,689,688,5.05
2020,CB2020,005,2,Bronx,20425003000,0,0,0,2.36
2020,CB2020,005,2,Bronx,20425003001,0,0,0,2.12
2020,CB2020,005,2,Bronx,20425003002,0,0,0,3.17
2020,CB2020,005,2,Bronx,20425003003,0,0,0,4.69
2020,CB2020,005,2,Bronx,20425003004,0,0,0,3.43
2020,CB2020,005,2,Bronx,20425003005,696,317,379,9.05
2020,CB2020,005,2,Bronx,20425003006,0,0,0,6.81
2020,CB2020,005,2,Bronx,20425003007,500,237,263,1.59
2020,CB2020,005,2,Bronx,20425004000,857,426,431,4.03
2020,CB2020,005,2,Bronx,20425005000,599,274,325,5.56
2020,CB2020,005,2,Bronx,20425005001,373,163,210,4.6
2020,CB2020,005,2,Bronx,20425006000,347,156,191,2.28
2020,CB2020,005,2,Bronx,20425006001,541,294,247,3.47
2020,CB2020,005,2,Bronx,20425007000,638,304,334,3.34
2020,CB2020,005,2,Bronx,20425007001,839,410,429,4.31
2020,CB2020,005,2,Bronx,20426001000,553,281,272,5.96
2020,CB2020,005,2,Bronx,20426001001,439,167,272,6.11
2020,CB2020,005,2,Bronx,20426001002,361,178,183,6.06
2020,CB2020,005,2,Bronx,20426001003,0,0,0,5.11
2020,CB2020,005,2,Bronx,20426001004,190,92,98,3.81
2020,CB2020,005,2,Bronx,20426001005,109,59,50,1.7
2020,CB2020,005,2,Bronx,20426001006,17,9,8,0.61
2020,CB2020,005,2,Bronx,20426002000,354,162,192,6
2020,CB2020,005,2,Bronx,20426002001,436,194,242,5.62
2020,CB2020,005,2,Bronx,20426002002,269,132,137,4.4
2020,CB2020,005,2,Bronx,20426002003,128,48,80,3.28
2020,CB2020,005,2,Bronx,20426002004,115,67,48,2.53
2020,CB2020,005,2,Bronx,20426002005,0,0,0,0.65
2020,CB2020,005,2,Bronx,20426002006,171,88,83,2.74
2020,CB2020,005,2,Bronx,20426002007,132,41,91,1.72
2020,CB2020,005,2,Bronx,20426002008,194,87,107,3.22
2020,CB2020,005,2,Bronx,20426002009,0,0,0,1.37
2020,CB2020,005,2,Bronx,20426003000,330,165,165,5.3
2020,CB2020,005,2,Bronx,20426003001,273,123,150,5.3
2020,CB2020,005,2,Bronx,20426003002,326,158,168,5.09
2020,CB2020,005,2,Bronx,20426004000,307,109,198,5.64
2020,CB2020,005,2,Bronx,20426004001,263,135,128,6.04
2020,CB2020,005,2,Bronx,20426004002,159,77,82,5.97
2020,CB2020,005,2,Bronx,20426005000,293,124,169,4.8
2020,CB2020,005,2,Bronx,20426005001,236,105,131,4.29
2020,CB2020,005,2,Bronx,20426005002,264,133,131,3.96
2020,CB2020,005,2,Bronx,20426006000,373,177,196,6.09
2020,CB2020,005,2,Bronx,20426006001,350,142,208,6.08
2020,CB2020,005,2,Bronx,20426006002,340,180,160,5.97
2020,CB2020,005,2,Bronx,20428001000,71,34,37,2.84
2020,CB2020,005,2,Bronx,20428001001,249,131,118,2.8
2020,CB2020,005,2,Bronx,20428001002,0,0,0,2.87
2020,CB2020,005,2,Bronx,20428001003,177,80,97,2.97
2020,CB2020,005,2,Bronx,20428001004,186,69,117,3.2
2020,CB2020,005,2,Bronx,20428001005,302,115,187,5.52
2020,CB2020,005,2,Bronx,20428002000,285,125,160,5.61
2020,CB2020,005,2,Bronx,20428002001,297,148,149,5.52
2020,CB2020,005,2,Bronx,20428002002,345,154,191,5.27
2020,CB2020,005,2,Bronx,20428002003,318,130,188,5.21
2020,CB2020,005,2,Bronx,20429011000,76,29,47,2.32
2020,CB2020,005,2,Bronx,20429011001,69,34,35,6.23
2020,CB2020,005,2,Bronx,20429011002,0,0,0,1.78
2020,CB2020,005,2,Bronx,20429011003,1157,553,604,4.51
2020,CB2020,005,2,Bronx,20429011004,648,306,342,3.08
2020,CB2020,005,2,Bronx,20429012000,845,410,435,3.53
2020,CB2020,005,2,Bronx,20429013000,916,458,458,3.82
2020,CB2020,005,2,Bronx,20429021000,983,468,515,5.89
2020,CB2020,005,2,Bronx,20429021001,1072,538,534,5.18
2020,CB2020,005,2,Bronx,20429021002,331,171,160,3.71
2020,CB2020,005,2,Bronx,20429022000,1005,501,504,4.61
2020,CB2020,005,2,Bronx,20429023000,943,430,513,3.98
2020,CB2020,005,2,Bronx,20430001000,344,156,188,5.11
2020,CB2020,005,2,Bronx,20430001001,299,125,174,4.93
2020,CB2020,005,2,Bronx,20430001002,228,123,105,4.76
2020,CB2020,005,2,Bronx,20430001003,252,124,128,4.59
2020,CB2020,005,2,Bronx,20430001004,214,105,109,4.12
2020,CB2020,005,2,Bronx,20430002000,137,63,74,3.32
2020,CB2020,005,2,Bronx,20430002001,195,76,119,3.44
2020,CB2020,005,2,Bronx,20430002002,174,65,109,3.64
2020,CB2020,005,2,Bronx,20430002003,211,108,103,3.73
2020,CB2020,005,2,Bronx,20430003000,299,124,175,4.37
2020,CB2020,005,2,Bronx,20430003001,100,44,56,1.39
2020,CB2020,005,2,Bronx,20430003002,101,48,53,2.73
2020,CB2020,005,2,Bronx,20430003003,118,63,55,2.81
2020,CB2020,005,2,Bronx,20430003004,280,136,144,2.01
2020,CB2020,005,2,Bronx,20431011000,258,132,126,5.33
2020,CB2020,005,2,Bronx,20431011001,814,353,461,2.85
2020,CB2020,005,2,Bronx,20431011002,390,187,203,2.23
2020,CB2020,005,2,Bronx,20431012000,918,436,482,4.69
2020,CB2020,005,2,Bronx,20431013000,1364,655,709,4.98
2020,CB2020,005,2,Bronx,20431014000,1441,698,743,5.35
2020,CB2020,005,2,Bronx,20431021000,746,328,418,3.78
2020,CB2020,005,2,Bronx,20431021001,614,295,319,3.25
2020,CB2020,005,2,Bronx,20431021002,723,357,366,2.82
2020,CB2020,005,2,Bronx,20431022000,355,182,173,3.96
2020,CB2020,005,2,Bronx,20431022001,487,212,275,1.64
2020,CB2020,005,2,Bronx,20431023000,57,27,30,2.69
2020,CB2020,005,2,Bronx,20431023001,514,248,266,3.55
2020,CB2020,005,2,Bronx,20431023002,1008,476,532,3.36
2020,CB2020,005,2,Bronx,20431023003,546,247,299,2.53
2020,CB2020,005,2,Bronx,20434001000,76,29,47,3.81
2020,CB2020,005,2,Bronx,20434001001,93,47,46,27.02
2020,CB2020,005,2,Bronx,20434001002,75,37,38,5.2
2020,CB2020,005,2,Bronx,20434001003,99,30,69,1.99
2020,CB2020,005,2,Bronx,20434001004,60,24,36,1.9
2020,CB2020,005,2,Bronx,20434001005,302,117,185,3.65
2020,CB2020,005,2,Bronx,20434001006,175,114,61,2.95
2020,CB2020,005,2,Bronx,20434002000,320,151,169,4.05
2020,CB2020,005,2,Bronx,20434002001,449,178,271,2.77
2020,CB2020,005,2,Bronx,20434002002,138,56,82,3.14
2020,CB2020,005,2,Bronx,20434003000,152,64,88,2.41
2020,CB2020,005,2,Bronx,20434003001,366,170,196,3.67
2020,CB2020,005,2,Bronx,20434003002,181,85,96,3.98
2020,CB2020,005,2,Bronx,20434004000,35,16,19,2.76
2020,CB2020,005,2,Bronx,20434004001,123,64,59,2.37
2020,CB2020,005,2,Bronx,20434004002,326,144,182,3.45
2020,CB2020,005,2,Bronx,20434004003,241,107,134,3.29
2020,CB2020,005,2,Bronx,20434004004,216,128,88,3.58
2020,CB2020,005,2,Bronx,20434004005,97,40,57,2.46
2020,CB2020,005,2,Bronx,20434004006,125,45,80,2.26
2020,CB2020,005,2,Bronx,20435011000,11,7,4,33.52
2020,CB2020,005,2,Bronx,20435011001,0,0,0,19.25
2020,CB2020,005,2,Bronx,20435011002,0,0,0,5.81
2020,CB2020,005,2,Bronx,20435011003,0,0,0,24.83
2020,CB2020,005,2,Bronx,20435011004,1181,522,659,14.94
2020,CB2020,005,2,Bronx,20435021000,2,0,2,409.25
2020,CB2020,005,2,Bronx,20435031000,0,0,0,144.59
2020,CB2020,005,2,Bronx,20435031001,0,0,0,5.24
2020,CB2020,005,2,Bronx,20435031002,0,0,0,4.6
2020,CB2020,005,2,Bronx,20435031003,0,0,0,8.23
2020,CB2020,005,2,Bronx,20435031004,0,0,0,194.25
2020,CB2020,005,2,Bronx,20435031005,0,0,0,1.79
2020,CB2020,005,2,Bronx,20435031006,0,0,0,18.82
2020,CB2020,005,2,Bronx,20435031007,0,0,0,202.15
2020,CB2020,005,2,Bronx,20435031008,0,0,0,0.98
2020,CB2020,005,2,Bronx,20435031009,122,49,73,313.9
2020,CB2020,005,2,Bronx,20435031010,0,0,0,0.35
2020,CB2020,005,2,Bronx,20435031011,0,0,0,0.46
2020,CB2020,005,2,Bronx,20435031012,0,0,0,2.24
2020,CB2020,005,2,Bronx,20435031013,0,0,0,4.03
2020,CB2020,005,2,Bronx,20435031014,0,0,0,0.15
2020,CB2020,005,2,Bronx,20435031015,0,0,0,1.45
2020,CB2020,005,2,Bronx,20435031016,0,0,0,174.85
2020,CB2020,005,2,Bronx,20435031017,0,0,0,3.53
2020,CB2020,005,2,Bronx,20435031018,0,0,0,58.37
2020,CB2020,005,2,Bronx,20435031019,0,0,0,4.9
2020,CB2020,005,2,Bronx,20435031020,0,0,0,1.16
2020,CB2020,005,2,Bronx,20435031021,0,0,0,1.15
2020,CB2020,005,2,Bronx,20435031022,0,0,0,4.47
2020,CB2020,005,2,Bronx,20436001000,68,30,38,2.11
2020,CB2020,005,2,Bronx,20436001001,68,39,29,2.37
2020,CB2020,005,2,Bronx,20436001002,177,78,99,1.82
2020,CB2020,005,2,Bronx,20436001003,0,0,0,0.51
2020,CB2020,005,2,Bronx,20436001004,285,119,166,5.67
2020,CB2020,005,2,Bronx,20436001005,338,163,175,5.56
2020,CB2020,005,2,Bronx,20436002000,333,125,208,5.69
2020,CB2020,005,2,Bronx,20436002001,330,171,159,5.65
2020,CB2020,005,2,Bronx,20436002002,258,134,124,4.76
2020,CB2020,005,2,Bronx,20436002003,147,67,80,3.05
2020,CB2020,005,2,Bronx,20436002004,57,18,39,1.05
2020,CB2020,005,2,Bronx,20442001000,61,20,41,1.45
2020,CB2020,005,2,Bronx,20442001001,715,313,402,3.29
2020,CB2020,005,2,Bronx,20442002000,259,129,130,3.5
2020,CB2020,005,2,Bronx,20442002001,111,41,70,3.18
2020,CB2020,005,2,Bronx,20442002002,193,59,134,3.47
2020,CB2020,005,2,Bronx,20442002003,216,106,110,2
2020,CB2020,005,2,Bronx,20442003000,44,35,9,0.27
2020,CB2020,005,2,Bronx,20442003001,169,89,80,1.95
2020,CB2020,005,2,Bronx,20442003002,155,68,87,2.01
2020,CB2020,005,2,Bronx,20442003003,67,25,42,1.01
2020,CB2020,005,2,Bronx,20442003004,174,84,90,2.68
2020,CB2020,005,2,Bronx,20442003005,74,24,50,1.2
2020,CB2020,005,2,Bronx,20442003006,61,25,36,0.71
2020,CB2020,005,2,Bronx,20442003007,67,34,33,1.78
2020,CB2020,005,2,Bronx,20442004000,176,75,101,3.18
2020,CB2020,005,2,Bronx,20442004001,145,64,81,3.11
2020,CB2020,005,2,Bronx,20442004002,195,102,93,3.12
2020,CB2020,005,2,Bronx,20442004003,204,93,111,3
2020,CB2020,005,2,Bronx,20442004004,109,57,52,3
2020,CB2020,005,2,Bronx,20442005000,130,57,73,2.99
2020,CB2020,005,2,Bronx,20442005001,194,80,114,3.78
2020,CB2020,005,2,Bronx,20442005002,101,40,61,2.13
2020,CB2020,005,2,Bronx,20442005003,51,33,18,1.15
2020,CB2020,005,2,Bronx,20442005004,100,41,59,2.76
2020,CB2020,005,2,Bronx,20442005005,45,30,15,1.43
2020,CB2020,005,2,Bronx,20442005006,61,28,33,1.87
2020,CB2020,005,2,Bronx,20444001000,262,113,149,3.77
2020,CB2020,005,2,Bronx,20444001001,87,39,48,2.44
2020,CB2020,005,2,Bronx,20444001002,269,125,144,5.68
2020,CB2020,005,2,Bronx,20444001003,490,225,265,5.68
2020,CB2020,005,2,Bronx,20444002000,298,134,164,5.08
2020,CB2020,005,2,Bronx,20444002001,167,80,87,2.57
2020,CB2020,005,2,Bronx,20444002002,264,121,143,3.8
2020,CB2020,005,2,Bronx,20444002003,158,60,98,2.83
2020,CB2020,005,2,Bronx,20444003000,227,92,135,5.69
2020,CB2020,005,2,Bronx,20444003001,313,147,166,5.11
2020,CB2020,005,2,Bronx,20444003002,434,196,238,6.02
2020,CB2020,005,2,Bronx,20444004000,232,108,124,3.62
2020,CB2020,005,2,Bronx,20444004001,329,165,164,5.17
2020,CB2020,005,2,Bronx,20444004002,214,89,125,5.14
2020,CB2020,005,2,Bronx,20444004003,212,91,121,5.1
2020,CB2020,005,2,Bronx,20444004004,28,22,6,22.5
2020,CB2020,005,2,Bronx,20448001000,243,107,136,4.41
2020,CB2020,005,2,Bronx,20448001001,146,74,72,3.25
2020,CB2020,005,2,Bronx,20448001002,113,53,60,2.79
2020,CB2020,005,2,Bronx,20448001003,376,151,225,5.59
2020,CB2020,005,2,Bronx,20448001004,158,60,98,4.99
2020,CB2020,005,2,Bronx,20448001005,166,82,84,3.97
2020,CB2020,005,2,Bronx,20448002000,119,45,74,2.81
2020,CB2020,005,2,Bronx,20448002001,120,53,67,2.05
2020,CB2020,005,2,Bronx,20448002002,36,17,19,0.61
2020,CB2020,005,2,Bronx,20448002003,254,130,124,5.47
2020,CB2020,005,2,Bronx,20448002004,276,124,152,5.6
2020,CB2020,005,2,Bronx,20449011000,72,32,40,2.69
2020,CB2020,005,2,Bronx,20449011001,0,0,0,0.34
2020,CB2020,005,2,Bronx,20449011002,224,105,119,2.64
2020,CB2020,005,2,Bronx,20449011003,155,71,84,3.15
2020,CB2020,005,2,Bronx,20449011004,160,73,87,3.17
2020,CB2020,005,2,Bronx,20449011005,146,82,64,3.23
2020,CB2020,005,2,Bronx,20449011006,49,20,29,1.13
2020,CB2020,005,2,Bronx,20449012000,138,61,77,3.16
2020,CB2020,005,2,Bronx,20449012001,145,86,59,3.52
2020,CB2020,005,2,Bronx,20449012002,105,60,45,2.19
2020,CB2020,005,2,Bronx,20449012003,177,73,104,5.04
2020,CB2020,005,2,Bronx,20449012004,275,138,137,3.16
2020,CB2020,005,2,Bronx,20449012005,141,45,96,3.15
2020,CB2020,005,2,Bronx,20449012006,159,64,95,2.51
2020,CB2020,005,2,Bronx,20449021000,42,4,38,1.02
2020,CB2020,005,2,Bronx,20449021001,145,70,75,2.67
2020,CB2020,005,2,Bronx,20449021002,240,122,118,4.87
2020,CB2020,005,2,Bronx,20449021003,336,158,178,5.46
2020,CB2020,005,2,Bronx,20449021004,356,191,165,5.44
2020,CB2020,005,2,Bronx,20449022000,381,214,167,5.46
2020,CB2020,005,2,Bronx,20449022001,329,154,175,5.45
2020,CB2020,005,2,Bronx,20449022002,356,154,202,5.4
2020,CB2020,005,2,Bronx,20449022003,44,16,28,2.94
2020,CB2020,005,2,Bronx,20451011000,134,45,89,2.23
2020,CB2020,005,2,Bronx,20451011001,139,63,76,3.78
2020,CB2020,005,2,Bronx,20451011002,180,99,81,3.78
2020,CB2020,005,2,Bronx,20451011003,73,47,26,1.59
2020,CB2020,005,2,Bronx,20451011004,276,137,139,2.57
2020,CB2020,005,2,Bronx,20451012000,0,0,0,9.24
2020,CB2020,005,2,Bronx,20451012001,343,185,158,2.66
2020,CB2020,005,2,Bronx,20451012002,348,131,217,4.72
2020,CB2020,005,2,Bronx,20451012003,86,29,57,6.25
2020,CB2020,005,2,Bronx,20451012004,50,25,25,3.5
2020,CB2020,005,2,Bronx,20451012005,188,112,76,3.18
2020,CB2020,005,2,Bronx,20451021000,154,95,59,3.04
2020,CB2020,005,2,Bronx,20451021001,33,6,27,0.84
2020,CB2020,005,2,Bronx,20451021002,124,58,66,3.78
2020,CB2020,005,2,Bronx,20451021003,215,96,119,3.77
2020,CB2020,005,2,Bronx,20451021004,190,96,94,3.78
2020,CB2020,005,2,Bronx,20451021005,73,46,27,3.77
2020,CB2020,005,2,Bronx,20451022000,0,0,0,7.49
2020,CB2020,005,2,Bronx,20451022001,0,0,0,1.28
2020,CB2020,005,2,Bronx,20451022002,0,0,0,2.33
2020,CB2020,005,2,Bronx,20451022003,659,306,353,7.84
2020,CB2020,005,2,Bronx,20451022004,322,169,153,4.23
2020,CB2020,005,2,Bronx,20451022005,101,47,54,2.28
2020,CB2020,005,2,Bronx,20451022006,128,45,83,3.56
2020,CB2020,005,2,Bronx,20451022007,143,92,51,2.92
2020,CB2020,005,2,Bronx,20456001000,70,46,24,2.66
2020,CB2020,005,2,Bronx,20456001001,127,69,58,3.46
2020,CB2020,005,2,Bronx,20456001002,250,114,136,4.53
2020,CB2020,005,2,Bronx,20456001003,272,95,177,5.23
2020,CB2020,005,2,Bronx,20456001004,240,121,119,4.53
2020,CB2020,005,2,Bronx,20456001005,61,24,37,1.58
2020,CB2020,005,2,Bronx,20456002000,0,0,0,20.27
2020,CB2020,005,2,Bronx,20456002001,116,56,60,17.27
2020,CB2020,005,2,Bronx,20456002002,36,15,21,2.75
2020,CB2020,005,2,Bronx,20456002003,136,52,84,3.07
2020,CB2020,005,2,Bronx,20456002004,332,147,185,6.28
2020,CB2020,005,2,Bronx,20456002005,293,151,142,8.55
2020,CB2020,005,2,Bronx,20456002006,0,0,0,0.22
2020,CB2020,005,2,Bronx,20456002007,110,49,61,3.09
2020,CB2020,005,2,Bronx,20456003000,11,4,7,1.38
2020,CB2020,005,2,Bronx,20456003001,49,30,19,5.1
2020,CB2020,005,2,Bronx,20456003002,3,1,2,0.66
2020,CB2020,005,2,Bronx,20456003003,34,12,22,6.21
2020,CB2020,005,2,Bronx,20456003004,0,0,0,8.14
2020,CB2020,005,2,Bronx,20456003005,17,9,8,22.68
2020,CB2020,005,2,Bronx,20456003006,14,9,5,1.26
2020,CB2020,005,2,Bronx,20456003007,39,14,25,1.21
2020,CB2020,005,2,Bronx,20456003008,37,17,20,1.32
2020,CB2020,005,2,Bronx,20456003009,28,12,16,1.25
2020,CB2020,005,2,Bronx,20456003010,0,0,0,25.21
2020,CB2020,005,2,Bronx,20456003011,70,46,24,2.3
2020,CB2020,005,2,Bronx,20456003012,56,18,38,1.88
2020,CB2020,005,2,Bronx,20456003013,109,47,62,3.07
2020,CB2020,005,2,Bronx,20456003014,39,28,11,1.55
2020,CB2020,005,2,Bronx,20456003015,98,58,40,2.8
2020,CB2020,005,2,Bronx,20456003016,38,8,30,0.6
2020,CB2020,005,2,Bronx,20456003017,74,32,42,3.22
2020,CB2020,005,2,Bronx,20456003018,0,0,0,0.96
2020,CB2020,005,2,Bronx,20456003019,0,0,0,13.84
2020,CB2020,005,2,Bronx,20456003020,0,0,0,0
2020,CB2020,005,2,Bronx,20456003021,0,0,0,1.66
2020,CB2020,005,2,Bronx,20456003022,0,0,0,0
2020,CB2020,005,2,Bronx,20456003023,0,0,0,0
2020,CB2020,005,2,Bronx,20456003024,123,56,67,5.17
2020,CB2020,005,2,Bronx,20456003025,174,97,77,5.18
2020,CB2020,005,2,Bronx,20458001000,1559,647,912,20.37
2020,CB2020,005,2,Bronx,20458002000,1325,499,826,7.08
2020,CB2020,005,2,Bronx,20458003000,174,76,98,2.84
2020,CB2020,005,2,Bronx,20458004000,2279,931,1348,23.31
2020,CB2020,005,2,Bronx,20458004001,325,132,193,5.63
2020,CB2020,005,2,Bronx,20460001000,17,4,13,17.05
2020,CB2020,005,2,Bronx,20460001001,860,329,531,10.65
2020,CB2020,005,2,Bronx,20460001002,573,286,287,14.44
2020,CB2020,005,2,Bronx,20460001003,38,13,25,0.36
2020,CB2020,005,2,Bronx,20460001004,259,154,105,3.48
2020,CB2020,005,2,Bronx,20460001005,121,42,79,3.39
2020,CB2020,005,2,Bronx,20460001006,213,100,113,3.69
2020,CB2020,005,2,Bronx,20460001007,158,75,83,6.17
2020,CB2020,005,2,Bronx,20460002000,222,76,146,3.67
2020,CB2020,005,2,Bronx,20460002001,317,160,157,5.16
2020,CB2020,005,2,Bronx,20460002002,50,23,27,1.5
2020,CB2020,005,2,Bronx,20460002003,62,39,23,1.55
2020,CB2020,005,2,Bronx,20462031000,2872,1166,1706,12.5
2020,CB2020,005,2,Bronx,20462032000,1143,487,656,2.42
2020,CB2020,005,2,Bronx,20462032001,0,0,0,5.31
2020,CB2020,005,2,Bronx,20462033000,0,0,0,0
2020,CB2020,005,2,Bronx,20462033001,23,15,8,57.51
2020,CB2020,005,2,Bronx,20462033002,0,0,0,9.17
2020,CB2020,005,2,Bronx,20462033003,0,0,0,0
2020,CB2020,005,2,Bronx,20462033004,0,0,0,0
2020,CB2020,005,2,Bronx,20462033005,420,165,255,5.1
2020,CB2020,005,2,Bronx,20462033006,22,19,3,11.63
2020,CB2020,005,2,Bronx,20462033007,0,0,0,8.8
2020,CB2020,005,2,Bronx,20462033008,39,14,25,4.01
2020,CB2020,005,2,Bronx,20462033009,63,29,34,3.89
2020,CB2020,005,2,Bronx,20462033010,0,0,0,2.84
2020,CB2020,005,2,Bronx,20462033011,0,0,0,0.32
2020,CB2020,005,2,Bronx,20462033012,0,0,0,1.73
2020,CB2020,005,2,Bronx,20462033013,0,0,0,10.42
2020,CB2020,005,2,Bronx,20462033014,0,0,0,3.06
2020,CB2020,005,2,Bronx,20462033015,35,21,14,16.36
2020,CB2020,005,2,Bronx,20462033016,1028,497,531,25.99
2020,CB2020,005,2,Bronx,20462033017,954,400,554,10.17
2020,CB2020,005,2,Bronx,20462041000,762,297,465,4.39
2020,CB2020,005,2,Bronx,20462041001,1077,483,594,2.37
2020,CB2020,005,2,Bronx,20462042000,1002,432,570,2.96
2020,CB2020,005,2,Bronx,20462042001,97,29,68,4.73
2020,CB2020,005,2,Bronx,20462043000,64,30,34,3.55
2020,CB2020,005,2,Bronx,20462043001,0,0,0,5.26
2020,CB2020,005,2,Bronx,20462043002,145,69,76,4.72
2020,CB2020,005,2,Bronx,20462044000,2405,1037,1368,5.8
2020,CB2020,005,2,Bronx,20462051000,804,322,482,2.58
2020,CB2020,005,2,Bronx,20462052000,870,394,476,2.3
2020,CB2020,005,2,Bronx,20462053000,887,363,524,43.26
2020,CB2020,005,2,Bronx,20462053001,0,0,0,7.37
2020,CB2020,005,2,Bronx,20462053002,0,0,0,6.5
2020,CB2020,005,2,Bronx,20462054000,950,402,548,8.37
2020,CB2020,005,2,Bronx,20462055000,0,0,0,1.35
2020,CB2020,005,2,Bronx,20462055001,0,0,0,1.4
2020,CB2020,005,2,Bronx,20462055002,0,0,0,16.81
2020,CB2020,005,2,Bronx,20462055003,795,341,454,2.97
2020,CB2020,005,2,Bronx,20462055004,0,0,0,4.22
2020,CB2020,005,2,Bronx,20462055005,139,33,106,21.4
2020,CB2020,005,2,Bronx,20462055006,0,0,0,76.13
2020,CB2020,005,2,Bronx,20462055007,0,0,0,3.77
2020,CB2020,005,2,Bronx,20462055008,0,0,0,11.6
2020,CB2020,005,2,Bronx,20462055009,0,0,0,1.84
2020,CB2020,005,2,Bronx,20462055010,0,0,0,4.24
2020,CB2020,005,2,Bronx,20462061000,768,310,458,3.32
2020,CB2020,005,2,Bronx,20462062000,2172,907,1265,2.14
2020,CB2020,005,2,Bronx,20462063000,255,115,140,9.89
2020,CB2020,005,2,Bronx,20462064000,1239,520,719,1.79
2020,CB2020,005,2,Bronx,20462071000,0,0,0,1.14
2020,CB2020,005,2,Bronx,20462071001,0,0,0,5.34
2020,CB2020,005,2,Bronx,20462071002,0,0,0,3.29
2020,CB2020,005,2,Bronx,20462071003,815,302,513,5.57
2020,CB2020,005,2,Bronx,20462072000,0,0,0,7.82
2020,CB2020,005,2,Bronx,20462072001,1467,582,885,2.4
2020,CB2020,005,2,Bronx,20462073000,3946,1656,2290,20.93
2020,CB2020,005,2,Bronx,20462081000,273,129,144,10.36
2020,CB2020,005,2,Bronx,20462081001,201,98,103,4.93
2020,CB2020,005,2,Bronx,20462081002,261,125,136,5.06
2020,CB2020,005,2,Bronx,20462081003,85,34,51,2.63
2020,CB2020,005,2,Bronx,20462081004,0,0,0,0.48
2020,CB2020,005,2,Bronx,20462081005,36,18,18,1.96
2020,CB2020,005,2,Bronx,20462081006,257,124,133,8.1
2020,CB2020,005,2,Bronx,20462082000,223,93,130,3.88
2020,CB2020,005,2,Bronx,20462082001,310,116,194,4.11
2020,CB2020,005,2,Bronx,20462082002,219,87,132,4.61
2020,CB2020,005,2,Bronx,20462082003,71,38,33,2.85
2020,CB2020,005,2,Bronx,20462082004,0,0,0,0.49
2020,CB2020,005,2,Bronx,20462082005,92,49,43,1.78
2020,CB2020,005,2,Bronx,20462082006,325,180,145,3.73
2020,CB2020,005,2,Bronx,20462082007,0,0,0,12.38
2020,CB2020,005,2,Bronx,20462082008,0,0,0,1.3
2020,CB2020,005,2,Bronx,20462083000,69,27,42,3.42
2020,CB2020,005,2,Bronx,20462083001,264,109,155,3.8
2020,CB2020,005,2,Bronx,20462083002,436,169,267,3.81
2020,CB2020,005,2,Bronx,20462083003,203,85,118,3.75
2020,CB2020,005,2,Bronx,20462083004,239,93,146,4.24
2020,CB2020,005,2,Bronx,20462083005,176,99,77,4.03
2020,CB2020,005,2,Bronx,20462083006,271,137,134,4.09
2020,CB2020,005,2,Bronx,20462084000,165,72,93,7.71
2020,CB2020,005,2,Bronx,20462084001,349,169,180,4.02
2020,CB2020,005,2,Bronx,20462084002,181,91,90,3.84
2020,CB2020,005,2,Bronx,20462084003,324,138,186,4.06
2020,CB2020,005,2,Bronx,20462084004,125,52,73,4.41
2020,CB2020,005,2,Bronx,20462091000,0,0,0,0
2020,CB2020,005,2,Bronx,20462091001,0,0,0,5.84
2020,CB2020,005,2,Bronx,20462091002,0,0,0,1.75
2020,CB2020,005,2,Bronx,20462091003,10,3,7,4.34
2020,CB2020,005,2,Bronx,20462091004,0,0,0,3.29
2020,CB2020,005,2,Bronx,20462091005,0,0,0,3.52
2020,CB2020,005,2,Bronx,20462091006,0,0,0,3.06
2020,CB2020,005,2,Bronx,20462091007,61,30,31,7.27
2020,CB2020,005,2,Bronx,20462091008,53,30,23,3.08
2020,CB2020,005,2,Bronx,20462091009,29,11,18,2.44
2020,CB2020,005,2,Bronx,20462091010,0,0,0,0.93
2020,CB2020,005,2,Bronx,20462091011,628,279,349,13.98
2020,CB2020,005,2,Bronx,20462091012,0,0,0,0.13
2020,CB2020,005,2,Bronx,20462091013,0,0,0,0
2020,CB2020,005,2,Bronx,20462091014,34,21,13,4.67
2020,CB2020,005,2,Bronx,20462091015,0,0,0,2.34
2020,CB2020,005,2,Bronx,20462091016,13,9,4,2.79
2020,CB2020,005,2,Bronx,20462091017,181,80,101,5.53
2020,CB2020,005,2,Bronx,20462092000,0,0,0,0.36
2020,CB2020,005,2,Bronx,20462092001,180,72,108,6.64
2020,CB2020,005,2,Bronx,20462092002,472,234,238,3.71
2020,CB2020,005,2,Bronx,20462092003,545,239,306,8
2020,CB2020,005,2,Bronx,20462092004,0,0,0,7.68
2020,CB2020,005,2,Bronx,20462093000,1362,607,755,17.82
2020,CB2020,005,2,Bronx,20462093001,139,63,76,5.03
2020,CB2020,005,2,Bronx,20484011000,103,56,47,3.22
2020,CB2020,005,2,Bronx,20484011001,241,111,130,5.61
2020,CB2020,005,2,Bronx,20484011002,391,163,228,5.74
2020,CB2020,005,2,Bronx,20484011003,157,74,83,2.95
2020,CB2020,005,2,Bronx,20484011004,188,84,104,3.03
2020,CB2020,005,2,Bronx,20484011005,306,134,172,5.61
2020,CB2020,005,2,Bronx,20484011006,39,18,21,0.68
2020,CB2020,005,2,Bronx,20484011007,61,47,14,0.56
2020,CB2020,005,2,Bronx,20484012000,0,0,0,6.65
2020,CB2020,005,2,Bronx,20484012001,0,0,0,5.46
2020,CB2020,005,2,Bronx,20484012002,50,28,22,6.33
2020,CB2020,005,2,Bronx,20484012003,14,9,5,1.88
2020,CB2020,005,2,Bronx,20484012004,64,35,29,3.17
2020,CB2020,005,2,Bronx,20484012005,140,58,82,5.25
2020,CB2020,005,2,Bronx,20484012006,95,35,60,1.86
2020,CB2020,005,2,Bronx,20484012007,114,62,52,2.15
2020,CB2020,005,2,Bronx,20484012008,95,31,64,2.61
2020,CB2020,005,2,Bronx,20484012009,0,0,0,6.69
2020,CB2020,005,2,Bronx,20484012010,144,85,59,2.87
2020,CB2020,005,2,Bronx,20484012011,44,24,20,3.03
2020,CB2020,005,2,Bronx,20484012012,67,28,39,3.4
2020,CB2020,005,2,Bronx,20484012013,32,11,21,5.23
2020,CB2020,005,2,Bronx,20484012014,0,0,0,1.1
2020,CB2020,005,2,Bronx,20484012015,0,0,0,4.07
2020,CB2020,005,2,Bronx,20484012016,0,0,0,2.06
2020,CB2020,005,2,Bronx,20484013000,231,95,136,2.71
2020,CB2020,005,2,Bronx,20484013001,224,97,127,4.1
2020,CB2020,005,2,Bronx,20484013002,353,145,208,4.85
2020,CB2020,005,2,Bronx,20484013003,113,49,64,2.49
2020,CB2020,005,2,Bronx,20484013004,135,74,61,3.02
2020,CB2020,005,2,Bronx,20484013005,104,48,56,2.87
2020,CB2020,005,2,Bronx,20484013006,282,135,147,10.14
2020,CB2020,005,2,Bronx,20484013007,101,46,55,3.37
2020,CB2020,005,2,Bronx,20484021000,41,18,23,46.93
2020,CB2020,005,2,Bronx,20504000001,0,0,0,0
2020,CB2020,005,2,Bronx,20504000002,0,0,0,0
2020,CB2020,005,2,Bronx,20504000003,0,0,0,0
2020,CB2020,005,2,Bronx,20504000004,0,0,0,0
2020,CB2020,005,2,Bronx,20504000005,4,2,2,0
2020,CB2020,005,2,Bronx,20504000006,0,0,0,0
2020,CB2020,005,2,Bronx,20504001000,0,0,0,0.7
2020,CB2020,005,2,Bronx,20504001001,0,0,0,0
2020,CB2020,005,2,Bronx,20504001002,0,0,0,6.84
2020,CB2020,005,2,Bronx,20504001003,0,0,0,340.21
2020,CB2020,005,2,Bronx,20504001004,0,0,0,256.92
2020,CB2020,005,2,Bronx,20504001005,1,0,1,679.25
2020,CB2020,005,2,Bronx,20504001006,0,0,0,3.46
2020,CB2020,005,2,Bronx,20504001007,0,0,0,2.1
2020,CB2020,005,2,Bronx,20504001008,0,0,0,2.8
2020,CB2020,005,2,Bronx,20504001009,0,0,0,6.65
2020,CB2020,005,2,Bronx,20504001010,0,0,0,24.89
2020,CB2020,005,2,Bronx,20504001011,0,0,0,1.48
2020,CB2020,005,2,Bronx,20504001012,0,0,0,44.59
2020,CB2020,005,2,Bronx,20504001013,0,0,0,192.56
2020,CB2020,005,2,Bronx,20504001014,0,0,0,107.48
2020,CB2020,005,2,Bronx,20504001015,0,0,0,102.96
2020,CB2020,005,2,Bronx,20504001016,0,0,0,0
2020,CB2020,005,2,Bronx,20504001017,0,0,0,1.69
2020,CB2020,005,2,Bronx,20504001018,0,0,0,12.45
2020,CB2020,005,2,Bronx,20504001019,0,0,0,0.36
2020,CB2020,005,2,Bronx,20504001020,0,0,0,2.52
2020,CB2020,005,2,Bronx,20516010001,0,0,0,0
2020,CB2020,005,2,Bronx,20516011000,115,62,53,12.49
2020,CB2020,005,2,Bronx,20516011001,61,42,19,3.29
2020,CB2020,005,2,Bronx,20516011002,135,59,76,7.81
2020,CB2020,005,2,Bronx,20516011003,61,15,46,2.59
2020,CB2020,005,2,Bronx,20516011004,0,0,0,0.38
2020,CB2020,005,2,Bronx,20516011005,44,20,24,1.9
2020,CB2020,005,2,Bronx,20516011006,72,28,44,4.65
2020,CB2020,005,2,Bronx,20516011007,61,18,43,2.87
2020,CB2020,005,2,Bronx,20516011008,89,43,46,2.98
2020,CB2020,005,2,Bronx,20516011009,119,79,40,2.7
2020,CB2020,005,2,Bronx,20516011010,65,25,40,2.69
2020,CB2020,005,2,Bronx,20516011011,24,9,15,1.84
2020,CB2020,005,2,Bronx,20516011012,60,39,21,2.55
2020,CB2020,005,2,Bronx,20516011013,52,13,39,2.6
2020,CB2020,005,2,Bronx,20516011014,40,26,14,2.7
2020,CB2020,005,2,Bronx,20516011015,54,31,23,2.23
2020,CB2020,005,2,Bronx,20516012000,67,35,32,18.52
2020,CB2020,005,2,Bronx,20516012001,55,28,27,2.38
2020,CB2020,005,2,Bronx,20516012002,62,29,33,6.63
2020,CB2020,005,2,Bronx,20516012003,84,37,47,4.37
2020,CB2020,005,2,Bronx,20516012004,125,58,67,4.03
2020,CB2020,005,2,Bronx,20516012005,112,50,62,4.31
2020,CB2020,005,2,Bronx,20516012006,61,20,41,4.23
2020,CB2020,005,2,Bronx,20516012007,50,33,17,3.11
2020,CB2020,005,2,Bronx,20516012008,83,38,45,2.93
2020,CB2020,005,2,Bronx,20516012009,137,62,75,6.39
2020,CB2020,005,2,Bronx,20516012010,80,50,30,3.62
2020,CB2020,005,2,Bronx,20516012011,77,27,50,2.81
2020,CB2020,005,2,Bronx,20516013000,57,21,36,8.88
2020,CB2020,005,2,Bronx,20516013001,78,30,48,3.79
2020,CB2020,005,2,Bronx,20516013002,51,24,27,3.48
2020,CB2020,005,2,Bronx,20516013003,169,93,76,6.25
2020,CB2020,005,2,Bronx,20516013004,247,100,147,11.13
2020,CB2020,005,2,Bronx,20516013005,106,58,48,3.49
2020,CB2020,005,2,Bronx,20516013006,160,85,75,4.67
2020,CB2020,005,2,Bronx,20516013007,229,80,149,28.04
2020,CB2020,005,2,Bronx,20516013008,51,33,18,2.67
2020,CB2020,005,2,Bronx,20516013009,58,23,35,4.04
2020,CB2020,005,2,Bronx,20516013010,28,18,10,2.74
2020,CB2020,005,2,Bronx,20516013011,17,14,3,1.18
2020,CB2020,005,2,Bronx,20516014000,93,54,39,3.62
2020,CB2020,005,2,Bronx,20516014001,57,11,46,2.62
2020,CB2020,005,2,Bronx,20516014002,131,54,77,5.98
2020,CB2020,005,2,Bronx,20516014003,189,81,108,5.47
2020,CB2020,005,2,Bronx,20516014004,99,44,55,5.24
2020,CB2020,005,2,Bronx,20516014005,110,40,70,4.91
2020,CB2020,005,2,Bronx,20516014006,64,34,30,4.52
2020,CB2020,005,2,Bronx,20516014007,196,88,108,4.36
2020,CB2020,005,2,Bronx,20516014008,85,63,22,3.91
2020,CB2020,005,2,Bronx,20516014009,51,43,8,2.54
2020,CB2020,005,2,Bronx,20516014010,56,20,36,2.83
2020,CB2020,005,2,Bronx,20516014011,18,13,5,8.65
2020,CB2020,005,2,Bronx,20516015000,0,0,0,9.54
2020,CB2020,005,2,Bronx,20516020001,0,0,0,0
2020,CB2020,005,2,Bronx,20516020002,0,0,0,0
2020,CB2020,005,2,Bronx,20516021000,0,0,0,112.15
2020,CB2020,005,2,Bronx,20516021001,0,0,0,3.86
2020,CB2020,047,3,Brooklyn,30001001000,25,5,20,0.55
2020,CB2020,047,3,Brooklyn,30001001001,36,11,25,0.8
2020,CB2020,047,3,Brooklyn,30001001002,0,0,0,3.67
2020,CB2020,047,3,Brooklyn,30001001003,0,0,0,0.38
2020,CB2020,047,3,Brooklyn,30001001004,14,13,1,0.66
2020,CB2020,047,3,Brooklyn,30001001005,182,77,105,1.47
2020,CB2020,047,3,Brooklyn,30001001006,17,7,10,3.93
2020,CB2020,047,3,Brooklyn,30001001007,271,156,115,5.76
2020,CB2020,047,3,Brooklyn,30001001008,19,3,16,1.9
2020,CB2020,047,3,Brooklyn,30001001009,112,66,46,1.36
2020,CB2020,047,3,Brooklyn,30001001010,111,57,54,1.45
2020,CB2020,047,3,Brooklyn,30001001011,117,62,55,1.21
2020,CB2020,047,3,Brooklyn,30001002000,187,87,100,1.42
2020,CB2020,047,3,Brooklyn,30001002001,166,83,83,1.49
2020,CB2020,047,3,Brooklyn,30001002002,223,96,127,1.51
2020,CB2020,047,3,Brooklyn,30001002003,128,59,69,1.41
2020,CB2020,047,3,Brooklyn,30001003000,0,0,0,0.38
2020,CB2020,047,3,Brooklyn,30001003001,255,118,137,2.34
2020,CB2020,047,3,Brooklyn,30001003002,174,74,100,2.71
2020,CB2020,047,3,Brooklyn,30001003003,227,120,107,2.74
2020,CB2020,047,3,Brooklyn,30001003004,218,130,88,2.71
2020,CB2020,047,3,Brooklyn,30001003005,614,270,344,2.71
2020,CB2020,047,3,Brooklyn,30001004000,474,190,284,1.62
2020,CB2020,047,3,Brooklyn,30001004001,525,219,306,4.65
2020,CB2020,047,3,Brooklyn,30001004002,521,235,286,2.51
2020,CB2020,047,3,Brooklyn,30002001000,61,12,49,4.74
2020,CB2020,047,3,Brooklyn,30002001001,19,12,7,9
2020,CB2020,047,3,Brooklyn,30002001002,0,0,0,0.8
2020,CB2020,047,3,Brooklyn,30002001003,0,0,0,1.23
2020,CB2020,047,3,Brooklyn,30002001004,55,16,39,1.57
2020,CB2020,047,3,Brooklyn,30002001005,0,0,0,1.18
2020,CB2020,047,3,Brooklyn,30002001006,0,0,0,0.94
2020,CB2020,047,3,Brooklyn,30002001007,0,0,0,0.97
2020,CB2020,047,3,Brooklyn,30002001008,75,39,36,4.69
2020,CB2020,047,3,Brooklyn,30002001009,34,4,30,4.65
2020,CB2020,047,3,Brooklyn,30002001010,0,0,0,4.63
2020,CB2020,047,3,Brooklyn,30002001011,152,100,52,4.68
2020,CB2020,047,3,Brooklyn,30002001012,102,53,49,4.72
2020,CB2020,047,3,Brooklyn,30002001013,167,97,70,4.69
2020,CB2020,047,3,Brooklyn,30002001014,333,163,170,4.69
2020,CB2020,047,3,Brooklyn,30002001015,91,39,52,4.7
2020,CB2020,047,3,Brooklyn,30002001016,85,49,36,4.86
2020,CB2020,047,3,Brooklyn,30002001017,31,24,7,4.67
2020,CB2020,047,3,Brooklyn,30002001018,0,0,0,0.5
2020,CB2020,047,3,Brooklyn,30002001019,0,0,0,0.52
2020,CB2020,047,3,Brooklyn,30003011000,207,96,111,1.47
2020,CB2020,047,3,Brooklyn,30003011001,680,353,327,4.17
2020,CB2020,047,3,Brooklyn,30003012000,111,40,71,1.43
2020,CB2020,047,3,Brooklyn,30003012001,736,340,396,4.47
2020,CB2020,047,3,Brooklyn,30003013000,444,191,253,2.68
2020,CB2020,047,3,Brooklyn,30003013001,413,216,197,2.76
2020,CB2020,047,3,Brooklyn,30003014000,0,0,0,7.27
2020,CB2020,047,3,Brooklyn,30003014001,0,0,0,0.48
2020,CB2020,047,3,Brooklyn,30003014002,356,164,192,3.43
2020,CB2020,047,3,Brooklyn,30003014003,399,189,210,3.87
2020,CB2020,047,3,Brooklyn,30003015000,0,0,0,9.55
2020,CB2020,047,3,Brooklyn,30003015001,0,0,0,0.93
2020,CB2020,047,3,Brooklyn,30003015002,58,17,41,1.09
2020,CB2020,047,3,Brooklyn,30003015003,307,144,163,3.35
2020,CB2020,047,3,Brooklyn,30003015004,38,18,20,1.29
2020,CB2020,047,3,Brooklyn,30003015005,101,56,45,1.23
2020,CB2020,047,3,Brooklyn,30003015006,0,0,0,0.19
2020,CB2020,047,3,Brooklyn,30005011000,1663,779,884,2.67
2020,CB2020,047,3,Brooklyn,30005011001,886,393,493,6.42
2020,CB2020,047,3,Brooklyn,30005012000,540,191,349,1.84
2020,CB2020,047,3,Brooklyn,30005012001,511,256,255,2.74
2020,CB2020,047,3,Brooklyn,30005013000,170,78,92,2.83
2020,CB2020,047,3,Brooklyn,30005013001,634,319,315,4.18
2020,CB2020,047,3,Brooklyn,30005021000,895,390,505,5.1
2020,CB2020,047,3,Brooklyn,30005021001,520,287,233,4.71
2020,CB2020,047,3,Brooklyn,30005021002,0,0,0,3.24
2020,CB2020,047,3,Brooklyn,30005022000,203,112,91,3.31
2020,CB2020,047,3,Brooklyn,30005022001,230,114,116,3.3
2020,CB2020,047,3,Brooklyn,30005022002,792,363,429,4.26
2020,CB2020,047,3,Brooklyn,30007001000,249,110,139,2.63
2020,CB2020,047,3,Brooklyn,30007001001,458,202,256,5.12
2020,CB2020,047,3,Brooklyn,30007001002,0,0,0,0.75
2020,CB2020,047,3,Brooklyn,30007001003,32,20,12,1.43
2020,CB2020,047,3,Brooklyn,30007001004,1212,596,616,5.32
2020,CB2020,047,3,Brooklyn,30007001005,0,0,0,3.09
2020,CB2020,047,3,Brooklyn,30007001006,236,122,114,2.71
2020,CB2020,047,3,Brooklyn,30007002000,344,167,177,3.62
2020,CB2020,047,3,Brooklyn,30007002001,335,143,192,3.25
2020,CB2020,047,3,Brooklyn,30007002002,242,112,130,3.48
2020,CB2020,047,3,Brooklyn,30007003000,252,125,127,1.7
2020,CB2020,047,3,Brooklyn,30007003001,446,215,231,3.96
2020,CB2020,047,3,Brooklyn,30007003002,339,171,168,3.24
2020,CB2020,047,3,Brooklyn,30007003003,270,155,115,3.38
2020,CB2020,047,3,Brooklyn,30009001000,260,120,140,3.02
2020,CB2020,047,3,Brooklyn,30009001001,793,398,395,3.53
2020,CB2020,047,3,Brooklyn,30009001002,112,66,46,3.32
2020,CB2020,047,3,Brooklyn,30009001003,432,195,237,4.33
2020,CB2020,047,3,Brooklyn,30009001004,314,156,158,4.18
2020,CB2020,047,3,Brooklyn,30009001005,0,0,0,1.27
2020,CB2020,047,3,Brooklyn,30009001006,0,0,0,0.32
2020,CB2020,047,3,Brooklyn,30009001007,0,0,0,0.33
2020,CB2020,047,3,Brooklyn,30009001008,735,364,371,3.28
2020,CB2020,047,3,Brooklyn,30009001009,397,174,223,3.2
2020,CB2020,047,3,Brooklyn,30009002000,826,487,339,2.64
2020,CB2020,047,3,Brooklyn,30009002001,220,107,113,3.37
2020,CB2020,047,3,Brooklyn,30009002002,289,155,134,3.44
2020,CB2020,047,3,Brooklyn,30009002003,764,336,428,3.24
2020,CB2020,047,3,Brooklyn,30009002004,25,16,9,0.93
2020,CB2020,047,3,Brooklyn,30011001000,26,10,16,7.01
2020,CB2020,047,3,Brooklyn,30011001001,0,0,0,10.12
2020,CB2020,047,3,Brooklyn,30011001002,0,0,0,1.01
2020,CB2020,047,3,Brooklyn,30011001003,15,5,10,10.41
2020,CB2020,047,3,Brooklyn,30011001004,0,0,0,0.72
2020,CB2020,047,3,Brooklyn,30011001005,6,1,5,1.29
2020,CB2020,047,3,Brooklyn,30011001006,59,16,43,2.3
2020,CB2020,047,3,Brooklyn,30011001007,34,13,21,2.13
2020,CB2020,047,3,Brooklyn,30011001008,0,0,0,1.57
2020,CB2020,047,3,Brooklyn,30011001009,0,0,0,0.28
2020,CB2020,047,3,Brooklyn,30011001010,681,385,296,1.77
2020,CB2020,047,3,Brooklyn,30011001011,757,396,361,3.03
2020,CB2020,047,3,Brooklyn,30013001000,0,0,0,2.64
2020,CB2020,047,3,Brooklyn,30013001001,0,0,0,0.7
2020,CB2020,047,3,Brooklyn,30013001002,1569,741,828,9.97
2020,CB2020,047,3,Brooklyn,30013001003,408,228,180,1.92
2020,CB2020,047,3,Brooklyn,30013001004,0,0,0,0.51
2020,CB2020,047,3,Brooklyn,30013001005,17,4,13,2
2020,CB2020,047,3,Brooklyn,30013001006,0,0,0,1
2020,CB2020,047,3,Brooklyn,30013001007,0,0,0,0.55
2020,CB2020,047,3,Brooklyn,30013001008,1,0,1,2.01
2020,CB2020,047,3,Brooklyn,30013001009,0,0,0,3.21
2020,CB2020,047,3,Brooklyn,30013001010,0,0,0,1.05
2020,CB2020,047,3,Brooklyn,30013001011,410,218,192,4.59
2020,CB2020,047,3,Brooklyn,30013001012,0,0,0,0.44
2020,CB2020,047,3,Brooklyn,30013001013,14,6,8,3.64
2020,CB2020,047,3,Brooklyn,30013001014,0,0,0,0.34
2020,CB2020,047,3,Brooklyn,30013001015,0,0,0,0.38
2020,CB2020,047,3,Brooklyn,30013001016,0,0,0,0.66
2020,CB2020,047,3,Brooklyn,30013001017,0,0,0,1.78
2020,CB2020,047,3,Brooklyn,30013001018,0,0,0,2.2
2020,CB2020,047,3,Brooklyn,30013001019,11,3,8,13.63
2020,CB2020,047,3,Brooklyn,30013001020,26,8,18,2.64
2020,CB2020,047,3,Brooklyn,30013001021,0,0,0,2.22
2020,CB2020,047,3,Brooklyn,30013001022,0,0,0,0.6
2020,CB2020,047,3,Brooklyn,30013001023,0,0,0,0.27
2020,CB2020,047,3,Brooklyn,30013001024,9,7,2,7.71
2020,CB2020,047,3,Brooklyn,30013002000,0,0,0,0.33
2020,CB2020,047,3,Brooklyn,30013002001,0,0,0,0.68
2020,CB2020,047,3,Brooklyn,30013002002,0,0,0,1.01
2020,CB2020,047,3,Brooklyn,30013002003,0,0,0,0.5
2020,CB2020,047,3,Brooklyn,30013002004,0,0,0,0.5
2020,CB2020,047,3,Brooklyn,30013002005,0,0,0,1.63
2020,CB2020,047,3,Brooklyn,30013002006,0,0,0,1.15
2020,CB2020,047,3,Brooklyn,30015011000,209,124,85,1.82
2020,CB2020,047,3,Brooklyn,30015011001,351,185,166,1.81
2020,CB2020,047,3,Brooklyn,30015011002,82,43,39,2.5
2020,CB2020,047,3,Brooklyn,30015011003,163,93,70,3.14
2020,CB2020,047,3,Brooklyn,30015011004,844,369,475,2.71
2020,CB2020,047,3,Brooklyn,30015011005,0,0,0,0.33
2020,CB2020,047,3,Brooklyn,30015011006,0,0,0,0.55
2020,CB2020,047,3,Brooklyn,30015011007,0,0,0,0.42
2020,CB2020,047,3,Brooklyn,30015011008,0,0,0,0.44
2020,CB2020,047,3,Brooklyn,30015011009,0,0,0,1.99
2020,CB2020,047,3,Brooklyn,30015011010,397,186,211,2.05
2020,CB2020,047,3,Brooklyn,30015011011,625,301,324,2.28
2020,CB2020,047,3,Brooklyn,30015012000,0,0,0,1.97
2020,CB2020,047,3,Brooklyn,30015012001,0,0,0,0.47
2020,CB2020,047,3,Brooklyn,30015012002,0,0,0,3.06
2020,CB2020,047,3,Brooklyn,30015012003,0,0,0,1.36
2020,CB2020,047,3,Brooklyn,30015012004,0,0,0,0.3
2020,CB2020,047,3,Brooklyn,30015012005,555,238,317,1.91
2020,CB2020,047,3,Brooklyn,30015012006,548,168,380,2.84
2020,CB2020,047,3,Brooklyn,30015012007,174,88,86,0.77
2020,CB2020,047,3,Brooklyn,30015012008,151,64,87,1.35
2020,CB2020,047,3,Brooklyn,30015012009,232,92,140,1.1
2020,CB2020,047,3,Brooklyn,30015012010,269,134,135,2.18
2020,CB2020,047,3,Brooklyn,30015012011,204,73,131,1.27
2020,CB2020,047,3,Brooklyn,30015012012,357,178,179,2.21
2020,CB2020,047,3,Brooklyn,30015021000,1067,524,543,2.3
2020,CB2020,047,3,Brooklyn,30015021001,0,0,0,0.59
2020,CB2020,047,3,Brooklyn,30015021002,0,0,0,0.48
2020,CB2020,047,3,Brooklyn,30015021003,0,0,0,0.56
2020,CB2020,047,3,Brooklyn,30015021004,0,0,0,3.24
2020,CB2020,047,3,Brooklyn,30015021005,418,255,163,1.36
2020,CB2020,047,3,Brooklyn,30015021006,0,0,0,0.66
2020,CB2020,047,3,Brooklyn,30015021007,0,0,0,1.4
2020,CB2020,047,3,Brooklyn,30015021008,0,0,0,0.29
2020,CB2020,047,3,Brooklyn,30015021009,0,0,0,1.46
2020,CB2020,047,3,Brooklyn,30015021010,0,0,0,0.32
2020,CB2020,047,3,Brooklyn,30015021011,1092,558,534,6.57
2020,CB2020,047,3,Brooklyn,30015021012,450,245,205,4.36
2020,CB2020,047,3,Brooklyn,30015021013,0,0,0,3.03
2020,CB2020,047,3,Brooklyn,30015021014,631,326,305,1.97
2020,CB2020,047,3,Brooklyn,30015021015,1783,864,919,3.64
2020,CB2020,047,3,Brooklyn,30015021016,22,3,19,0.52
2020,CB2020,047,3,Brooklyn,30015021017,17,1,16,1.64
2020,CB2020,047,3,Brooklyn,30015021018,321,175,146,0.72
2020,CB2020,047,3,Brooklyn,30018010001,0,0,0,0
2020,CB2020,047,3,Brooklyn,30018010002,0,0,0,0
2020,CB2020,047,3,Brooklyn,30018011000,0,0,0,0.39
2020,CB2020,047,3,Brooklyn,30018011001,0,0,0,2.15
2020,CB2020,047,3,Brooklyn,30018011002,0,0,0,1.72
2020,CB2020,047,3,Brooklyn,30018011003,0,0,0,87.9
2020,CB2020,047,3,Brooklyn,30018011004,0,0,0,2.19
2020,CB2020,047,3,Brooklyn,30018011005,0,0,0,3.91
2020,CB2020,047,3,Brooklyn,30018011006,0,0,0,0.6
2020,CB2020,047,3,Brooklyn,30018011007,0,0,0,3.21
2020,CB2020,047,3,Brooklyn,30018011008,0,0,0,1
2020,CB2020,047,3,Brooklyn,30018011009,1,1,0,1.46
2020,CB2020,047,3,Brooklyn,30018011010,0,0,0,4.43
2020,CB2020,047,3,Brooklyn,30018012000,2562,2462,100,5.15
2020,CB2020,047,3,Brooklyn,30018012001,0,0,0,0.2
2020,CB2020,047,3,Brooklyn,30018012002,0,0,0,0.31
2020,CB2020,047,3,Brooklyn,30018012003,0,0,0,0.26
2020,CB2020,047,3,Brooklyn,30018020001,0,0,0,0
2020,CB2020,047,3,Brooklyn,30018021000,0,0,0,92.92
2020,CB2020,047,3,Brooklyn,30018021001,0,0,0,4.68
2020,CB2020,047,3,Brooklyn,30018021002,4,2,2,4.61
2020,CB2020,047,3,Brooklyn,30018021003,0,0,0,4.62
2020,CB2020,047,3,Brooklyn,30018021004,0,0,0,4.61
2020,CB2020,047,3,Brooklyn,30018021005,0,0,0,5.05
2020,CB2020,047,3,Brooklyn,30018021006,0,0,0,4.16
2020,CB2020,047,3,Brooklyn,30018021007,0,0,0,0.91
2020,CB2020,047,3,Brooklyn,30018021008,0,0,0,1.77
2020,CB2020,047,3,Brooklyn,30018021009,0,0,0,2.15
2020,CB2020,047,3,Brooklyn,30018021010,0,0,0,12.78
2020,CB2020,047,3,Brooklyn,30018021011,2,2,0,9.5
2020,CB2020,047,3,Brooklyn,30018030001,0,0,0,0
2020,CB2020,047,3,Brooklyn,30018030002,0,0,0,0
2020,CB2020,047,3,Brooklyn,30018031000,3,2,1,73.47
2020,CB2020,047,3,Brooklyn,30018031001,0,0,0,4.67
2020,CB2020,047,3,Brooklyn,30018031002,5,5,0,4.68
2020,CB2020,047,3,Brooklyn,30018031003,0,0,0,4.68
2020,CB2020,047,3,Brooklyn,30018031004,0,0,0,4.74
2020,CB2020,047,3,Brooklyn,30018031005,0,0,0,13.97
2020,CB2020,047,3,Brooklyn,30018031006,0,0,0,26.99
2020,CB2020,047,3,Brooklyn,30018031007,5,4,1,4.66
2020,CB2020,047,3,Brooklyn,30018031008,3,1,2,4.66
2020,CB2020,047,3,Brooklyn,30018031009,0,0,0,4.66
2020,CB2020,047,3,Brooklyn,30018031010,0,0,0,4.64
2020,CB2020,047,3,Brooklyn,30018040001,0,0,0,0
2020,CB2020,047,3,Brooklyn,30018041000,0,0,0,83.76
2020,CB2020,047,3,Brooklyn,30018041001,0,0,0,0.94
2020,CB2020,047,3,Brooklyn,30020001000,43,26,17,4.69
2020,CB2020,047,3,Brooklyn,30020001001,242,191,51,4.69
2020,CB2020,047,3,Brooklyn,30020001002,207,112,95,4.69
2020,CB2020,047,3,Brooklyn,30020001003,287,166,121,4.88
2020,CB2020,047,3,Brooklyn,30020001004,0,0,0,0.59
2020,CB2020,047,3,Brooklyn,30020001005,0,0,0,0.77
2020,CB2020,047,3,Brooklyn,30020001006,26,13,13,0.96
2020,CB2020,047,3,Brooklyn,30020001007,0,0,0,0.3
2020,CB2020,047,3,Brooklyn,30020001008,0,0,0,0.23
2020,CB2020,047,3,Brooklyn,30020002000,246,119,127,4.67
2020,CB2020,047,3,Brooklyn,30020002001,166,59,107,4.75
2020,CB2020,047,3,Brooklyn,30020002002,444,248,196,4.81
2020,CB2020,047,3,Brooklyn,30020002003,0,0,0,0.31
2020,CB2020,047,3,Brooklyn,30020002004,0,0,0,0.49
2020,CB2020,047,3,Brooklyn,30020002005,0,0,0,0.44
2020,CB2020,047,3,Brooklyn,30020002006,0,0,0,0.23
2020,CB2020,047,3,Brooklyn,30020002007,33,22,11,0.59
2020,CB2020,047,3,Brooklyn,30021001000,0,0,0,0
2020,CB2020,047,3,Brooklyn,30021001001,20,7,13,11.51
2020,CB2020,047,3,Brooklyn,30021001002,0,0,0,0.43
2020,CB2020,047,3,Brooklyn,30021001003,0,0,0,2.02
2020,CB2020,047,3,Brooklyn,30021001004,89,46,43,1.82
2020,CB2020,047,3,Brooklyn,30021001005,0,0,0,0.32
2020,CB2020,047,3,Brooklyn,30021001006,0,0,0,0.69
2020,CB2020,047,3,Brooklyn,30021001007,0,0,0,0.51
2020,CB2020,047,3,Brooklyn,30021001008,0,0,0,1.37
2020,CB2020,047,3,Brooklyn,30021001009,625,320,305,3.18
2020,CB2020,047,3,Brooklyn,30021001010,210,92,118,1.58
2020,CB2020,047,3,Brooklyn,30021001011,447,231,216,1.71
2020,CB2020,047,3,Brooklyn,30021001012,0,0,0,0.23
2020,CB2020,047,3,Brooklyn,30021001013,0,0,0,1.68
2020,CB2020,047,3,Brooklyn,30021001014,0,0,0,0.44
2020,CB2020,047,3,Brooklyn,30021001015,0,0,0,1.39
2020,CB2020,047,3,Brooklyn,30021001016,0,0,0,1.34
2020,CB2020,047,3,Brooklyn,30021001017,590,283,307,3.53
2020,CB2020,047,3,Brooklyn,30021002000,124,64,60,3.29
2020,CB2020,047,3,Brooklyn,30021002001,0,0,0,0
2020,CB2020,047,3,Brooklyn,30021002002,0,0,0,0.44
2020,CB2020,047,3,Brooklyn,30021002003,0,0,0,0.45
2020,CB2020,047,3,Brooklyn,30021002004,0,0,0,0.35
2020,CB2020,047,3,Brooklyn,30021002005,191,115,76,1.37
2020,CB2020,047,3,Brooklyn,30021002006,13,10,3,1.48
2020,CB2020,047,3,Brooklyn,30021002007,42,10,32,1.44
2020,CB2020,047,3,Brooklyn,30021002008,12,4,8,0.87
2020,CB2020,047,3,Brooklyn,30021002009,12,3,9,1.7
2020,CB2020,047,3,Brooklyn,30021002010,0,0,0,0.34
2020,CB2020,047,3,Brooklyn,30021002011,0,0,0,0.6
2020,CB2020,047,3,Brooklyn,30021002012,0,0,0,0.42
2020,CB2020,047,3,Brooklyn,30021002013,0,0,0,0.26
2020,CB2020,047,3,Brooklyn,30021002014,0,0,0,0.67
2020,CB2020,047,3,Brooklyn,30021002015,342,162,180,1.06
2020,CB2020,047,3,Brooklyn,30021002016,0,0,0,0.72
2020,CB2020,047,3,Brooklyn,30021002017,0,0,0,1.48
2020,CB2020,047,3,Brooklyn,30021002018,337,183,154,2.02
2020,CB2020,047,3,Brooklyn,30021002019,188,95,93,1.55
2020,CB2020,047,3,Brooklyn,30021002020,0,0,0,0.68
2020,CB2020,047,3,Brooklyn,30021002021,0,0,0,0.26
2020,CB2020,047,3,Brooklyn,30021002022,0,0,0,0.43
2020,CB2020,047,3,Brooklyn,30021002023,0,0,0,1.65
2020,CB2020,047,3,Brooklyn,30021002024,0,0,0,1.27
2020,CB2020,047,3,Brooklyn,30021002025,0,0,0,0.62
2020,CB2020,047,3,Brooklyn,30021002026,0,0,0,0.21
2020,CB2020,047,3,Brooklyn,30021002027,0,0,0,0.32
2020,CB2020,047,3,Brooklyn,30021002028,0,0,0,0.43
2020,CB2020,047,3,Brooklyn,30021002029,568,279,289,1.74
2020,CB2020,047,3,Brooklyn,30021003000,20,6,14,21.35
2020,CB2020,047,3,Brooklyn,30021003001,70,41,29,3
2020,CB2020,047,3,Brooklyn,30021003002,0,0,0,3.06
2020,CB2020,047,3,Brooklyn,30021003003,0,0,0,2.39
2020,CB2020,047,3,Brooklyn,30021003004,0,0,0,1.9
2020,CB2020,047,3,Brooklyn,30021003005,109,57,52,1.14
2020,CB2020,047,3,Brooklyn,30021003006,30,14,16,2.46
2020,CB2020,047,3,Brooklyn,30021003007,185,124,61,2.98
2020,CB2020,047,3,Brooklyn,30021003008,489,264,225,3.03
2020,CB2020,047,3,Brooklyn,30021003009,446,214,232,3.13
2020,CB2020,047,3,Brooklyn,30021003010,91,39,52,3.01
2020,CB2020,047,3,Brooklyn,30021003011,58,10,48,2.56
2020,CB2020,047,3,Brooklyn,30021003012,54,42,12,2.71
2020,CB2020,047,3,Brooklyn,30021003013,212,94,118,3.9
2020,CB2020,047,3,Brooklyn,30021003014,241,138,103,4.08
2020,CB2020,047,3,Brooklyn,30021003015,133,51,82,4.18
2020,CB2020,047,3,Brooklyn,30021003016,27,19,8,3.19
2020,CB2020,047,3,Brooklyn,30021003017,0,0,0,0.27
2020,CB2020,047,3,Brooklyn,30021003018,0,0,0,0.53
2020,CB2020,047,3,Brooklyn,30022001000,42,13,29,4.66
2020,CB2020,047,3,Brooklyn,30022001001,15,5,10,4.65
2020,CB2020,047,3,Brooklyn,30022001002,95,54,41,4.67
2020,CB2020,047,3,Brooklyn,30022001003,27,13,14,4.87
2020,CB2020,047,3,Brooklyn,30022001004,596,291,305,4.41
2020,CB2020,047,3,Brooklyn,30022001005,545,275,270,4.62
2020,CB2020,047,3,Brooklyn,30022001006,0,0,0,0.48
2020,CB2020,047,3,Brooklyn,30022001007,0,0,0,0.73
2020,CB2020,047,3,Brooklyn,30022001008,0,0,0,0.33
2020,CB2020,047,3,Brooklyn,30022001009,0,0,0,0.13
2020,CB2020,047,3,Brooklyn,30022001010,0,0,0,0.14
2020,CB2020,047,3,Brooklyn,30022002000,588,285,303,4.18
2020,CB2020,047,3,Brooklyn,30022002001,285,127,158,4.69
2020,CB2020,047,3,Brooklyn,30022002002,26,18,8,4.22
2020,CB2020,047,3,Brooklyn,30022002003,297,173,124,4.53
2020,CB2020,047,3,Brooklyn,30022002004,44,30,14,1.15
2020,CB2020,047,3,Brooklyn,30022002005,0,0,0,0.59
2020,CB2020,047,3,Brooklyn,30022002006,0,0,0,1.14
2020,CB2020,047,3,Brooklyn,30022002007,0,0,0,0.76
2020,CB2020,047,3,Brooklyn,30022003000,418,217,201,4.63
2020,CB2020,047,3,Brooklyn,30022003001,514,246,268,4.55
2020,CB2020,047,3,Brooklyn,30022003002,141,54,87,4.29
2020,CB2020,047,3,Brooklyn,30022003003,28,17,11,4.02
2020,CB2020,047,3,Brooklyn,30022003004,160,93,67,3.06
2020,CB2020,047,3,Brooklyn,30022003005,0,0,0,0.34
2020,CB2020,047,3,Brooklyn,30022003006,0,0,0,1.53
2020,CB2020,047,3,Brooklyn,30022003007,0,0,0,0.27
2020,CB2020,047,3,Brooklyn,30022003008,0,0,0,0.13
2020,CB2020,047,3,Brooklyn,30022003009,0,0,0,0.18
2020,CB2020,047,3,Brooklyn,30022003010,0,0,0,0.19
2020,CB2020,047,3,Brooklyn,30022003011,46,28,18,0.49
2020,CB2020,047,3,Brooklyn,30022004000,0,0,0,1.15
2020,CB2020,047,3,Brooklyn,30022004001,0,0,0,4.32
2020,CB2020,047,3,Brooklyn,30022004002,0,0,0,0.16
2020,CB2020,047,3,Brooklyn,30022004003,722,320,402,1.91
2020,CB2020,047,3,Brooklyn,30022004004,0,0,0,1.85
2020,CB2020,047,3,Brooklyn,30023001000,1372,584,788,7.36
2020,CB2020,047,3,Brooklyn,30023001001,0,0,0,0.26
2020,CB2020,047,3,Brooklyn,30023001002,0,0,0,1.64
2020,CB2020,047,3,Brooklyn,30023001003,0,0,0,0.14
2020,CB2020,047,3,Brooklyn,30023001004,0,0,0,0.76
2020,CB2020,047,3,Brooklyn,30023001005,0,0,0,0.17
2020,CB2020,047,3,Brooklyn,30023002000,1486,635,851,8.74
2020,CB2020,047,3,Brooklyn,30023003000,1047,423,624,8.23
2020,CB2020,047,3,Brooklyn,30023003001,0,0,0,2.53
2020,CB2020,047,3,Brooklyn,30023003002,0,0,0,0.51
2020,CB2020,047,3,Brooklyn,30023003003,0,0,0,6.77
2020,CB2020,047,3,Brooklyn,30023003004,0,0,0,0.44
2020,CB2020,047,3,Brooklyn,30023003005,0,0,0,0.49
2020,CB2020,047,3,Brooklyn,30023003006,0,0,0,2.09
2020,CB2020,047,3,Brooklyn,30023003007,35,12,23,3.9
2020,CB2020,047,3,Brooklyn,30023003008,0,0,0,0.2
2020,CB2020,047,3,Brooklyn,30023003009,0,0,0,0.8
2020,CB2020,047,3,Brooklyn,30029011000,0,0,0,0.52
2020,CB2020,047,3,Brooklyn,30029011001,0,0,0,0.44
2020,CB2020,047,3,Brooklyn,30029011002,0,0,0,0.64
2020,CB2020,047,3,Brooklyn,30029011003,841,330,511,2.22
2020,CB2020,047,3,Brooklyn,30029011004,623,262,361,2.87
2020,CB2020,047,3,Brooklyn,30029011005,335,144,191,1.85
2020,CB2020,047,3,Brooklyn,30029011006,379,187,192,2.21
2020,CB2020,047,3,Brooklyn,30029011007,284,129,155,2.54
2020,CB2020,047,3,Brooklyn,30029012000,0,0,0,0.45
2020,CB2020,047,3,Brooklyn,30029012001,46,18,28,0.44
2020,CB2020,047,3,Brooklyn,30029012002,0,0,0,0.56
2020,CB2020,047,3,Brooklyn,30029012003,0,0,0,4.31
2020,CB2020,047,3,Brooklyn,30029012004,123,61,62,3.7
2020,CB2020,047,3,Brooklyn,30029012005,194,96,98,1.18
2020,CB2020,047,3,Brooklyn,30029012006,199,93,106,1.25
2020,CB2020,047,3,Brooklyn,30029012007,125,38,87,1.83
2020,CB2020,047,3,Brooklyn,30030001000,0,0,0,0.42
2020,CB2020,047,3,Brooklyn,30030001001,0,0,0,3.65
2020,CB2020,047,3,Brooklyn,30030001002,125,57,68,2.17
2020,CB2020,047,3,Brooklyn,30030001003,103,66,37,2.35
2020,CB2020,047,3,Brooklyn,30030001004,243,102,141,2.98
2020,CB2020,047,3,Brooklyn,30030001005,418,198,220,4.71
2020,CB2020,047,3,Brooklyn,30030002000,361,208,153,4.65
2020,CB2020,047,3,Brooklyn,30030002001,561,249,312,6.3
2020,CB2020,047,3,Brooklyn,30031011000,928,391,537,4.92
2020,CB2020,047,3,Brooklyn,30031011001,1838,857,981,9.64
2020,CB2020,047,3,Brooklyn,30031011002,350,177,173,1.08
2020,CB2020,047,3,Brooklyn,30031012000,229,117,112,14.25
2020,CB2020,047,3,Brooklyn,30031012001,18,10,8,0.11
2020,CB2020,047,3,Brooklyn,30031013000,32,14,18,7.03
2020,CB2020,047,3,Brooklyn,30031021000,0,0,0,33.68
2020,CB2020,047,3,Brooklyn,30033001000,537,256,281,5.93
2020,CB2020,047,3,Brooklyn,30033001001,300,137,163,6.21
2020,CB2020,047,3,Brooklyn,30033002000,544,235,309,4.71
2020,CB2020,047,3,Brooklyn,30033002001,350,155,195,3.61
2020,CB2020,047,3,Brooklyn,30033002002,360,186,174,3.66
2020,CB2020,047,3,Brooklyn,30033002003,582,300,282,3.05
2020,CB2020,047,3,Brooklyn,30033002004,0,0,0,1.98
2020,CB2020,047,3,Brooklyn,30033002005,0,0,0,0.43
2020,CB2020,047,3,Brooklyn,30033002006,36,20,16,2.1
2020,CB2020,047,3,Brooklyn,30033002007,0,0,0,0.35
2020,CB2020,047,3,Brooklyn,30033002008,1219,565,654,2.63
2020,CB2020,047,3,Brooklyn,30033002009,772,395,377,3.62
2020,CB2020,047,3,Brooklyn,30033002010,0,0,0,0.78
2020,CB2020,047,3,Brooklyn,30033002011,107,47,60,1.6
2020,CB2020,047,3,Brooklyn,30034000001,0,0,0,0
2020,CB2020,047,3,Brooklyn,30034001000,0,0,0,31.46
2020,CB2020,047,3,Brooklyn,30034001001,0,0,0,0.49
2020,CB2020,047,3,Brooklyn,30034001002,0,0,0,1.52
2020,CB2020,047,3,Brooklyn,30034001003,0,0,0,4.35
2020,CB2020,047,3,Brooklyn,30034001004,0,0,0,0.66
2020,CB2020,047,3,Brooklyn,30034001005,0,0,0,28.09
2020,CB2020,047,3,Brooklyn,30034001006,198,99,99,4.44
2020,CB2020,047,3,Brooklyn,30034001007,219,110,109,2.23
2020,CB2020,047,3,Brooklyn,30034001008,379,170,209,2.81
2020,CB2020,047,3,Brooklyn,30034001009,137,76,61,1.86
2020,CB2020,047,3,Brooklyn,30034001010,0,0,0,2.07
2020,CB2020,047,3,Brooklyn,30034001011,0,0,0,0.66
2020,CB2020,047,3,Brooklyn,30034001012,0,0,0,5.38
2020,CB2020,047,3,Brooklyn,30034002000,269,134,135,2.83
2020,CB2020,047,3,Brooklyn,30034002001,150,72,78,1.85
2020,CB2020,047,3,Brooklyn,30034002002,698,331,367,6.86
2020,CB2020,047,3,Brooklyn,30034002003,237,126,111,3.53
2020,CB2020,047,3,Brooklyn,30034002004,79,37,42,1.14
2020,CB2020,047,3,Brooklyn,30034003000,417,206,211,4.12
2020,CB2020,047,3,Brooklyn,30034003001,0,0,0,3.31
2020,CB2020,047,3,Brooklyn,30034003002,383,182,201,3.64
2020,CB2020,047,3,Brooklyn,30034003003,323,160,163,4.66
2020,CB2020,047,3,Brooklyn,30035001000,446,208,238,7.15
2020,CB2020,047,3,Brooklyn,30035001001,414,216,198,3.53
2020,CB2020,047,3,Brooklyn,30035001002,572,277,295,3.02
2020,CB2020,047,3,Brooklyn,30035001003,0,0,0,5.4
2020,CB2020,047,3,Brooklyn,30035001004,0,0,0,6.17
2020,CB2020,047,3,Brooklyn,30035002000,141,61,80,1.39
2020,CB2020,047,3,Brooklyn,30035002001,347,159,188,2.47
2020,CB2020,047,3,Brooklyn,30035002002,482,229,253,3.74
2020,CB2020,047,3,Brooklyn,30036001000,529,265,264,4.67
2020,CB2020,047,3,Brooklyn,30036001001,198,106,92,2.7
2020,CB2020,047,3,Brooklyn,30036001002,121,52,69,2.43
2020,CB2020,047,3,Brooklyn,30036001003,360,156,204,2.45
2020,CB2020,047,3,Brooklyn,30036002000,736,343,393,4.66
2020,CB2020,047,3,Brooklyn,30036002001,1097,505,592,4.64
2020,CB2020,047,3,Brooklyn,30036003000,319,161,158,4.66
2020,CB2020,047,3,Brooklyn,30036003001,599,279,320,4.73
2020,CB2020,047,3,Brooklyn,30037001000,31,22,9,1.92
2020,CB2020,047,3,Brooklyn,30037001001,142,75,67,3.2
2020,CB2020,047,3,Brooklyn,30037001002,0,0,0,2.32
2020,CB2020,047,3,Brooklyn,30037001003,51,11,40,3.18
2020,CB2020,047,3,Brooklyn,30037001004,29,12,17,2.83
2020,CB2020,047,3,Brooklyn,30037001005,24,12,12,3.75
2020,CB2020,047,3,Brooklyn,30037001006,0,0,0,2.33
2020,CB2020,047,3,Brooklyn,30037001007,224,124,100,3.05
2020,CB2020,047,3,Brooklyn,30037001008,0,0,0,1.1
2020,CB2020,047,3,Brooklyn,30037001009,1284,629,655,3.38
2020,CB2020,047,3,Brooklyn,30037001010,1190,620,570,3.93
2020,CB2020,047,3,Brooklyn,30037001011,1150,562,588,3.89
2020,CB2020,047,3,Brooklyn,30037001012,440,225,215,3.84
2020,CB2020,047,3,Brooklyn,30037001013,0,0,0,2.42
2020,CB2020,047,3,Brooklyn,30038000001,0,0,0,0
2020,CB2020,047,3,Brooklyn,30038001000,261,129,132,4.66
2020,CB2020,047,3,Brooklyn,30038001001,650,317,333,7.13
2020,CB2020,047,3,Brooklyn,30038001002,0,0,0,6.52
2020,CB2020,047,3,Brooklyn,30038001003,0,0,0,0.63
2020,CB2020,047,3,Brooklyn,30038001004,0,0,0,1.22
2020,CB2020,047,3,Brooklyn,30038001005,229,121,108,4.66
2020,CB2020,047,3,Brooklyn,30038001006,209,107,102,4.73
2020,CB2020,047,3,Brooklyn,30038001007,180,76,104,1.95
2020,CB2020,047,3,Brooklyn,30039001000,19,13,6,2.79
2020,CB2020,047,3,Brooklyn,30039001001,169,94,75,3.71
2020,CB2020,047,3,Brooklyn,30039001002,575,165,410,3.65
2020,CB2020,047,3,Brooklyn,30039001003,435,196,239,4.37
2020,CB2020,047,3,Brooklyn,30039002000,467,230,237,3.65
2020,CB2020,047,3,Brooklyn,30039002001,0,0,0,3.65
2020,CB2020,047,3,Brooklyn,30039002002,305,153,152,3.65
2020,CB2020,047,3,Brooklyn,30039003000,253,129,124,4.4
2020,CB2020,047,3,Brooklyn,30039003001,170,91,79,4.44
2020,CB2020,047,3,Brooklyn,30039003002,251,122,129,4.46
2020,CB2020,047,3,Brooklyn,30041001000,198,107,91,3.88
2020,CB2020,047,3,Brooklyn,30041001001,331,158,173,1.82
2020,CB2020,047,3,Brooklyn,30041001002,157,57,100,2.05
2020,CB2020,047,3,Brooklyn,30041001003,381,172,209,4.04
2020,CB2020,047,3,Brooklyn,30041001004,386,181,205,4.03
2020,CB2020,047,3,Brooklyn,30041002000,304,164,140,4.04
2020,CB2020,047,3,Brooklyn,30041002001,390,171,219,4.03
2020,CB2020,047,3,Brooklyn,30041002002,294,120,174,4.04
2020,CB2020,047,3,Brooklyn,30041003000,308,154,154,4.04
2020,CB2020,047,3,Brooklyn,30041003001,338,168,170,4.03
2020,CB2020,047,3,Brooklyn,30041003002,311,145,166,4.03
2020,CB2020,047,3,Brooklyn,30043001000,0,0,0,2.55
2020,CB2020,047,3,Brooklyn,30043002000,654,351,303,3.89
2020,CB2020,047,3,Brooklyn,30043002001,187,94,93,2.43
2020,CB2020,047,3,Brooklyn,30043002002,378,177,201,4.03
2020,CB2020,047,3,Brooklyn,30043003000,322,175,147,4.04
2020,CB2020,047,3,Brooklyn,30043003001,64,36,28,0.98
2020,CB2020,047,3,Brooklyn,30043003002,105,49,56,3.05
2020,CB2020,047,3,Brooklyn,30043003003,444,211,233,4.07
2020,CB2020,047,3,Brooklyn,30043004000,197,85,112,2.6
2020,CB2020,047,3,Brooklyn,30043004001,249,115,134,2.51
2020,CB2020,047,3,Brooklyn,30043004002,228,108,120,2.71
2020,CB2020,047,3,Brooklyn,30043004003,252,120,132,2.7
2020,CB2020,047,3,Brooklyn,30043004004,330,179,151,2.69
2020,CB2020,047,3,Brooklyn,30043004005,400,202,198,2.62
2020,CB2020,047,3,Brooklyn,30044000001,0,0,0,0
2020,CB2020,047,3,Brooklyn,30044001000,186,83,103,4.83
2020,CB2020,047,3,Brooklyn,30044001001,84,52,32,4.71
2020,CB2020,047,3,Brooklyn,30044001002,0,0,0,14.64
2020,CB2020,047,3,Brooklyn,30044001003,99,59,40,4.14
2020,CB2020,047,3,Brooklyn,30044001004,0,0,0,1.48
2020,CB2020,047,3,Brooklyn,30044001005,0,0,0,3.17
2020,CB2020,047,3,Brooklyn,30044001006,150,59,91,4.99
2020,CB2020,047,3,Brooklyn,30044001007,178,100,78,5
2020,CB2020,047,3,Brooklyn,30044001008,133,51,82,5.03
2020,CB2020,047,3,Brooklyn,30044001009,129,50,79,4.19
2020,CB2020,047,3,Brooklyn,30044001010,121,72,49,5.78
2020,CB2020,047,3,Brooklyn,30044001011,77,40,37,4.09
2020,CB2020,047,3,Brooklyn,30044001012,99,52,47,6.86
2020,CB2020,047,3,Brooklyn,30044001013,90,46,44,4.98
2020,CB2020,047,3,Brooklyn,30044002000,420,189,231,4.83
2020,CB2020,047,3,Brooklyn,30044002001,103,46,57,4.99
2020,CB2020,047,3,Brooklyn,30044002002,158,73,85,4.99
2020,CB2020,047,3,Brooklyn,30044002003,136,81,55,4.95
2020,CB2020,047,3,Brooklyn,30044002004,168,99,69,5.02
2020,CB2020,047,3,Brooklyn,30044002005,117,66,51,4.99
2020,CB2020,047,3,Brooklyn,30045001000,246,122,124,3.44
2020,CB2020,047,3,Brooklyn,30045001001,360,177,183,3.22
2020,CB2020,047,3,Brooklyn,30045001002,233,94,139,3.3
2020,CB2020,047,3,Brooklyn,30045001003,354,175,179,3.5
2020,CB2020,047,3,Brooklyn,30045002000,234,94,140,3.6
2020,CB2020,047,3,Brooklyn,30045002001,273,136,137,3.38
2020,CB2020,047,3,Brooklyn,30045002002,62,28,34,1.49
2020,CB2020,047,3,Brooklyn,30045002003,196,93,103,2.39
2020,CB2020,047,3,Brooklyn,30045003000,424,199,225,4.59
2020,CB2020,047,3,Brooklyn,30045003001,272,141,131,3.36
2020,CB2020,047,3,Brooklyn,30045004000,352,137,215,3.17
2020,CB2020,047,3,Brooklyn,30045004001,105,48,57,2.75
2020,CB2020,047,3,Brooklyn,30045004002,74,49,25,0.49
2020,CB2020,047,3,Brooklyn,30045004003,186,67,119,2.29
2020,CB2020,047,3,Brooklyn,30045004004,105,69,36,1.16
2020,CB2020,047,3,Brooklyn,30046000001,0,0,0,0
2020,CB2020,047,3,Brooklyn,30046001000,316,166,150,5.05
2020,CB2020,047,3,Brooklyn,30046001001,100,60,40,4.99
2020,CB2020,047,3,Brooklyn,30046001002,131,65,66,4.99
2020,CB2020,047,3,Brooklyn,30046001003,70,41,29,4.99
2020,CB2020,047,3,Brooklyn,30046001004,80,39,41,4.66
2020,CB2020,047,3,Brooklyn,30046001005,30,25,5,3.17
2020,CB2020,047,3,Brooklyn,30046001006,0,0,0,5.94
2020,CB2020,047,3,Brooklyn,30046001007,0,0,0,0.8
2020,CB2020,047,3,Brooklyn,30046001008,0,0,0,2.04
2020,CB2020,047,3,Brooklyn,30046001009,112,43,69,4.66
2020,CB2020,047,3,Brooklyn,30046001010,119,59,60,4.64
2020,CB2020,047,3,Brooklyn,30046001011,47,14,33,19.68
2020,CB2020,047,3,Brooklyn,30046001012,149,62,87,5.83
2020,CB2020,047,3,Brooklyn,30047001000,17,10,7,2.77
2020,CB2020,047,3,Brooklyn,30047001001,0,0,0,0.87
2020,CB2020,047,3,Brooklyn,30047001002,0,0,0,5.63
2020,CB2020,047,3,Brooklyn,30047001003,15,8,7,43.07
2020,CB2020,047,3,Brooklyn,30047001004,188,94,94,1.33
2020,CB2020,047,3,Brooklyn,30047001005,96,42,54,1.03
2020,CB2020,047,3,Brooklyn,30047001006,247,118,129,2.23
2020,CB2020,047,3,Brooklyn,30047001007,707,349,358,4.69
2020,CB2020,047,3,Brooklyn,30047001008,313,151,162,2.45
2020,CB2020,047,3,Brooklyn,30047001009,0,0,0,0.46
2020,CB2020,047,3,Brooklyn,30047001010,0,0,0,0.63
2020,CB2020,047,3,Brooklyn,30047001011,0,0,0,0.48
2020,CB2020,047,3,Brooklyn,30047001012,0,0,0,0.81
2020,CB2020,047,3,Brooklyn,30047001013,0,0,0,0.89
2020,CB2020,047,3,Brooklyn,30047001014,0,0,0,0.53
2020,CB2020,047,3,Brooklyn,30047001015,368,152,216,2.3
2020,CB2020,047,3,Brooklyn,30049001000,150,64,86,2.65
2020,CB2020,047,3,Brooklyn,30049001001,0,0,0,2.73
2020,CB2020,047,3,Brooklyn,30049001002,228,115,113,2.76
2020,CB2020,047,3,Brooklyn,30049001003,451,192,259,2.89
2020,CB2020,047,3,Brooklyn,30049002000,121,74,47,1.37
2020,CB2020,047,3,Brooklyn,30049002001,242,118,124,1.24
2020,CB2020,047,3,Brooklyn,30049002002,257,104,153,1.64
2020,CB2020,047,3,Brooklyn,30049002003,121,76,45,1.02
2020,CB2020,047,3,Brooklyn,30049003000,399,161,238,3.86
2020,CB2020,047,3,Brooklyn,30049003001,443,222,221,3.95
2020,CB2020,047,3,Brooklyn,30050000001,0,0,0,0
2020,CB2020,047,3,Brooklyn,30050001000,67,42,25,2.65
2020,CB2020,047,3,Brooklyn,30050001001,0,0,0,5.55
2020,CB2020,047,3,Brooklyn,30050001002,0,0,0,1.15
2020,CB2020,047,3,Brooklyn,30050001003,0,0,0,2.72
2020,CB2020,047,3,Brooklyn,30050001004,313,151,162,2.04
2020,CB2020,047,3,Brooklyn,30050001005,331,135,196,2.01
2020,CB2020,047,3,Brooklyn,30050002000,141,64,77,5.01
2020,CB2020,047,3,Brooklyn,30050002001,153,72,81,4.66
2020,CB2020,047,3,Brooklyn,30050002002,181,89,92,4.66
2020,CB2020,047,3,Brooklyn,30050002003,470,217,253,4.65
2020,CB2020,047,3,Brooklyn,30050003000,112,54,58,4.66
2020,CB2020,047,3,Brooklyn,30050003001,121,65,56,5.92
2020,CB2020,047,3,Brooklyn,30050003002,269,126,143,5.02
2020,CB2020,047,3,Brooklyn,30050003003,377,167,210,4.65
2020,CB2020,047,3,Brooklyn,30051001000,0,0,0,0.29
2020,CB2020,047,3,Brooklyn,30051001001,0,0,0,0.18
2020,CB2020,047,3,Brooklyn,30051001002,228,94,134,2.58
2020,CB2020,047,3,Brooklyn,30051001003,87,37,50,3.72
2020,CB2020,047,3,Brooklyn,30051001004,152,68,84,3.83
2020,CB2020,047,3,Brooklyn,30051001005,252,133,119,2.41
2020,CB2020,047,3,Brooklyn,30051001006,0,0,0,0.19
2020,CB2020,047,3,Brooklyn,30051001007,0,0,0,0.21
2020,CB2020,047,3,Brooklyn,30051001008,0,0,0,0.25
2020,CB2020,047,3,Brooklyn,30051002000,0,0,0,0.39
2020,CB2020,047,3,Brooklyn,30051002001,0,0,0,0.48
2020,CB2020,047,3,Brooklyn,30051002002,0,0,0,0.39
2020,CB2020,047,3,Brooklyn,30051002003,204,118,86,2.39
2020,CB2020,047,3,Brooklyn,30051002004,241,111,130,3.82
2020,CB2020,047,3,Brooklyn,30051002005,305,132,173,3.82
2020,CB2020,047,3,Brooklyn,30051002006,262,138,124,2.42
2020,CB2020,047,3,Brooklyn,30051003000,0,0,0,0.52
2020,CB2020,047,3,Brooklyn,30051003001,0,0,0,1
2020,CB2020,047,3,Brooklyn,30051003002,37,14,23,2.09
2020,CB2020,047,3,Brooklyn,30051003003,269,126,143,2.38
2020,CB2020,047,3,Brooklyn,30051003004,198,110,88,2.4
2020,CB2020,047,3,Brooklyn,30051003005,244,126,118,3.7
2020,CB2020,047,3,Brooklyn,30051003006,63,35,28,2.06
2020,CB2020,047,3,Brooklyn,30051003007,0,0,0,0.54
2020,CB2020,047,3,Brooklyn,30051003008,116,66,50,2.34
2020,CB2020,047,3,Brooklyn,30052010001,0,0,0,0
2020,CB2020,047,3,Brooklyn,30052011000,28,11,17,9.3
2020,CB2020,047,3,Brooklyn,30052011001,1028,373,655,9.32
2020,CB2020,047,3,Brooklyn,30052011002,0,0,0,3.79
2020,CB2020,047,3,Brooklyn,30052011003,0,0,0,0.67
2020,CB2020,047,3,Brooklyn,30052011004,0,0,0,1.11
2020,CB2020,047,3,Brooklyn,30052011005,279,114,165,4.65
2020,CB2020,047,3,Brooklyn,30052011006,544,240,304,4.2
2020,CB2020,047,3,Brooklyn,30052020001,0,0,0,0
2020,CB2020,047,3,Brooklyn,30052021000,1126,467,659,7.55
2020,CB2020,047,3,Brooklyn,30052021001,0,0,0,2.71
2020,CB2020,047,3,Brooklyn,30052021002,0,0,0,0.6
2020,CB2020,047,3,Brooklyn,30052021003,0,0,0,1.46
2020,CB2020,047,3,Brooklyn,30052022000,370,172,198,3.9
2020,CB2020,047,3,Brooklyn,30052022001,567,235,332,4.19
2020,CB2020,047,3,Brooklyn,30052022002,202,102,100,2.47
2020,CB2020,047,3,Brooklyn,30052022003,403,188,215,4.16
2020,CB2020,047,3,Brooklyn,30052022004,0,0,0,4.27
2020,CB2020,047,3,Brooklyn,30052022005,0,0,0,0.46
2020,CB2020,047,3,Brooklyn,30052022006,0,0,0,1.17
2020,CB2020,047,3,Brooklyn,30053010001,0,0,0,0
2020,CB2020,047,3,Brooklyn,30053010002,0,0,0,0
2020,CB2020,047,3,Brooklyn,30053011000,0,0,0,3.27
2020,CB2020,047,3,Brooklyn,30053011001,24,10,14,3.29
2020,CB2020,047,3,Brooklyn,30053011002,31,12,19,3.35
2020,CB2020,047,3,Brooklyn,30053011003,33,16,17,3.34
2020,CB2020,047,3,Brooklyn,30053011004,66,41,25,3.34
2020,CB2020,047,3,Brooklyn,30053011005,143,64,79,2.72
2020,CB2020,047,3,Brooklyn,30053011006,113,61,52,2.72
2020,CB2020,047,3,Brooklyn,30053011007,126,53,73,2.72
2020,CB2020,047,3,Brooklyn,30053011008,95,44,51,2.71
2020,CB2020,047,3,Brooklyn,30053011009,47,11,36,2.68
2020,CB2020,047,3,Brooklyn,30053011010,95,58,37,3.35
2020,CB2020,047,3,Brooklyn,30053011011,174,96,78,3.35
2020,CB2020,047,3,Brooklyn,30053011012,0,0,0,3.31
2020,CB2020,047,3,Brooklyn,30053011013,261,125,136,3.37
2020,CB2020,047,3,Brooklyn,30053011014,147,80,67,3.32
2020,CB2020,047,3,Brooklyn,30053012000,0,0,0,2.81
2020,CB2020,047,3,Brooklyn,30053012001,15,4,11,16.32
2020,CB2020,047,3,Brooklyn,30053012002,0,0,0,1.31
2020,CB2020,047,3,Brooklyn,30053012003,20,13,7,3.36
2020,CB2020,047,3,Brooklyn,30053012004,144,76,68,2.72
2020,CB2020,047,3,Brooklyn,30053012005,87,47,40,25.06
2020,CB2020,047,3,Brooklyn,30053012006,0,0,0,3.17
2020,CB2020,047,3,Brooklyn,30053012007,33,14,19,2.66
2020,CB2020,047,3,Brooklyn,30053012008,79,43,36,2.72
2020,CB2020,047,3,Brooklyn,30053012009,16,3,13,3.49
2020,CB2020,047,3,Brooklyn,30053012010,52,31,21,3.31
2020,CB2020,047,3,Brooklyn,30053012011,43,28,15,3.35
2020,CB2020,047,3,Brooklyn,30053012012,107,44,63,3.36
2020,CB2020,047,3,Brooklyn,30053012013,139,70,69,3.39
2020,CB2020,047,3,Brooklyn,30053012014,22,14,8,0.98
2020,CB2020,047,3,Brooklyn,30053012015,20,5,15,1.57
2020,CB2020,047,3,Brooklyn,30053012016,19,8,11,2.18
2020,CB2020,047,3,Brooklyn,30053012017,13,10,3,2.92
2020,CB2020,047,3,Brooklyn,30053012018,0,0,0,10.69
2020,CB2020,047,3,Brooklyn,30053020001,0,0,0,0
2020,CB2020,047,3,Brooklyn,30053020002,0,0,0,0
2020,CB2020,047,3,Brooklyn,30053020003,0,0,0,0
2020,CB2020,047,3,Brooklyn,30053020004,0,0,0,0
2020,CB2020,047,3,Brooklyn,30053021000,0,0,0,0.34
2020,CB2020,047,3,Brooklyn,30053021001,0,0,0,1.01
2020,CB2020,047,3,Brooklyn,30053021002,5,2,3,2.51
2020,CB2020,047,3,Brooklyn,30053021003,0,0,0,0.38
2020,CB2020,047,3,Brooklyn,30053021004,0,0,0,0.51
2020,CB2020,047,3,Brooklyn,30053021005,0,0,0,0.5
2020,CB2020,047,3,Brooklyn,30053021006,22,10,12,3.48
2020,CB2020,047,3,Brooklyn,30053021007,0,0,0,0.25
2020,CB2020,047,3,Brooklyn,30053021008,0,0,0,1.02
2020,CB2020,047,3,Brooklyn,30053021009,0,0,0,2.1
2020,CB2020,047,3,Brooklyn,30053021010,0,0,0,3.28
2020,CB2020,047,3,Brooklyn,30053021011,0,0,0,3.45
2020,CB2020,047,3,Brooklyn,30053021012,0,0,0,1.73
2020,CB2020,047,3,Brooklyn,30053021013,0,0,0,0.41
2020,CB2020,047,3,Brooklyn,30053022000,0,0,0,6.43
2020,CB2020,047,3,Brooklyn,30053022001,0,0,0,5.55
2020,CB2020,047,3,Brooklyn,30053022002,10,5,5,97.39
2020,CB2020,047,3,Brooklyn,30053022003,0,0,0,7.01
2020,CB2020,047,3,Brooklyn,30053022004,0,0,0,1.86
2020,CB2020,047,3,Brooklyn,30053022005,0,0,0,1.92
2020,CB2020,047,3,Brooklyn,30053022006,0,0,0,2.21
2020,CB2020,047,3,Brooklyn,30053022007,0,0,0,3.25
2020,CB2020,047,3,Brooklyn,30053022008,0,0,0,11.4
2020,CB2020,047,3,Brooklyn,30053022009,0,0,0,0.49
2020,CB2020,047,3,Brooklyn,30053022010,0,0,0,6.56
2020,CB2020,047,3,Brooklyn,30053022011,0,0,0,1.2
2020,CB2020,047,3,Brooklyn,30053022012,0,0,0,2.15
2020,CB2020,047,3,Brooklyn,30053022013,2,1,1,3.7
2020,CB2020,047,3,Brooklyn,30053023000,45,29,16,2.96
2020,CB2020,047,3,Brooklyn,30053023001,0,0,0,3.2
2020,CB2020,047,3,Brooklyn,30053023002,0,0,0,3.3
2020,CB2020,047,3,Brooklyn,30053023003,2,1,1,3.2
2020,CB2020,047,3,Brooklyn,30053023004,0,0,0,4.74
2020,CB2020,047,3,Brooklyn,30053023005,0,0,0,3.03
2020,CB2020,047,3,Brooklyn,30053031000,0,0,0,10.3
2020,CB2020,047,3,Brooklyn,30053031001,0,0,0,1.08
2020,CB2020,047,3,Brooklyn,30053031002,0,0,0,33.54
2020,CB2020,047,3,Brooklyn,30053031003,0,0,0,0
2020,CB2020,047,3,Brooklyn,30053031004,0,0,0,2.54
2020,CB2020,047,3,Brooklyn,30053031005,0,0,0,2.4
2020,CB2020,047,3,Brooklyn,30053031006,0,0,0,2.38
2020,CB2020,047,3,Brooklyn,30053031007,0,0,0,2.49
2020,CB2020,047,3,Brooklyn,30053031008,0,0,0,18.74
2020,CB2020,047,3,Brooklyn,30054000001,0,0,0,0
2020,CB2020,047,3,Brooklyn,30054001000,537,266,271,4.34
2020,CB2020,047,3,Brooklyn,30054001001,501,202,299,4.32
2020,CB2020,047,3,Brooklyn,30054001002,524,236,288,4.18
2020,CB2020,047,3,Brooklyn,30054001003,0,0,0,5.52
2020,CB2020,047,3,Brooklyn,30054001004,0,0,0,0.37
2020,CB2020,047,3,Brooklyn,30054001005,0,0,0,0.99
2020,CB2020,047,3,Brooklyn,30054002000,246,132,114,4.59
2020,CB2020,047,3,Brooklyn,30054002001,53,30,23,1.03
2020,CB2020,047,3,Brooklyn,30054002002,304,122,182,4.39
2020,CB2020,047,3,Brooklyn,30054003000,710,349,361,4.98
2020,CB2020,047,3,Brooklyn,30054003001,551,249,302,4.89
2020,CB2020,047,3,Brooklyn,30054003002,0,0,0,0.41
2020,CB2020,047,3,Brooklyn,30056010001,0,0,0,0
2020,CB2020,047,3,Brooklyn,30056011000,480,213,267,4.27
2020,CB2020,047,3,Brooklyn,30056011001,642,301,341,7.49
2020,CB2020,047,3,Brooklyn,30056011002,119,52,67,1.51
2020,CB2020,047,3,Brooklyn,30056011003,19,11,8,12.58
2020,CB2020,047,3,Brooklyn,30056011004,0,0,0,0.74
2020,CB2020,047,3,Brooklyn,30056011005,0,0,0,2.38
2020,CB2020,047,3,Brooklyn,30056012000,266,83,183,2.83
2020,CB2020,047,3,Brooklyn,30056012001,497,249,248,4.5
2020,CB2020,047,3,Brooklyn,30056012002,147,76,71,1.69
2020,CB2020,047,3,Brooklyn,30056012003,130,67,63,2.24
2020,CB2020,047,3,Brooklyn,30056012004,392,174,218,2.63
2020,CB2020,047,3,Brooklyn,30056020001,0,0,0,0
2020,CB2020,047,3,Brooklyn,30056020002,0,0,0,0
2020,CB2020,047,3,Brooklyn,30056021000,370,186,184,3.66
2020,CB2020,047,3,Brooklyn,30056021001,331,145,186,4.42
2020,CB2020,047,3,Brooklyn,30056021002,310,150,160,3.29
2020,CB2020,047,3,Brooklyn,30056021003,330,137,193,2.93
2020,CB2020,047,3,Brooklyn,30056021004,354,164,190,3.73
2020,CB2020,047,3,Brooklyn,30056021005,39,24,15,9.13
2020,CB2020,047,3,Brooklyn,30056021006,0,0,0,1.01
2020,CB2020,047,3,Brooklyn,30056021007,0,0,0,5.19
2020,CB2020,047,3,Brooklyn,30058001000,326,172,154,4.7
2020,CB2020,047,3,Brooklyn,30058001001,605,313,292,5.52
2020,CB2020,047,3,Brooklyn,30058001002,56,33,23,2.31
2020,CB2020,047,3,Brooklyn,30058001003,65,27,38,2.38
2020,CB2020,047,3,Brooklyn,30058002000,459,215,244,5.26
2020,CB2020,047,3,Brooklyn,30058002001,391,217,174,4.65
2020,CB2020,047,3,Brooklyn,30058002002,502,235,267,6.1
2020,CB2020,047,3,Brooklyn,30058002003,320,164,156,4.69
2020,CB2020,047,3,Brooklyn,30058002004,33,31,2,2.83
2020,CB2020,047,3,Brooklyn,30058003000,256,117,139,4.67
2020,CB2020,047,3,Brooklyn,30058003001,437,202,235,4.66
2020,CB2020,047,3,Brooklyn,30059001000,61,28,33,2.88
2020,CB2020,047,3,Brooklyn,30059001001,37,25,12,3.33
2020,CB2020,047,3,Brooklyn,30059001002,29,8,21,3.6
2020,CB2020,047,3,Brooklyn,30059001003,196,105,91,3.33
2020,CB2020,047,3,Brooklyn,30059001004,17,4,13,3.32
2020,CB2020,047,3,Brooklyn,30059001005,153,75,78,3.34
2020,CB2020,047,3,Brooklyn,30059001006,55,26,29,2.87
2020,CB2020,047,3,Brooklyn,30059001007,242,126,116,3.36
2020,CB2020,047,3,Brooklyn,30059001008,72,37,35,0.85
2020,CB2020,047,3,Brooklyn,30059002000,0,0,0,0.48
2020,CB2020,047,3,Brooklyn,30059002001,0,0,0,0.67
2020,CB2020,047,3,Brooklyn,30059002002,0,0,0,2.23
2020,CB2020,047,3,Brooklyn,30059002003,0,0,0,0.75
2020,CB2020,047,3,Brooklyn,30059002004,0,0,0,1.28
2020,CB2020,047,3,Brooklyn,30059002005,0,0,0,1.97
2020,CB2020,047,3,Brooklyn,30059002006,0,0,0,2.34
2020,CB2020,047,3,Brooklyn,30059002007,13,6,7,2.63
2020,CB2020,047,3,Brooklyn,30059002008,0,0,0,0.5
2020,CB2020,047,3,Brooklyn,30059002009,0,0,0,0.75
2020,CB2020,047,3,Brooklyn,30059002010,0,0,0,2.02
2020,CB2020,047,3,Brooklyn,30059002011,0,0,0,3.31
2020,CB2020,047,3,Brooklyn,30059002012,0,0,0,2.87
2020,CB2020,047,3,Brooklyn,30059002013,47,22,25,3.33
2020,CB2020,047,3,Brooklyn,30059002014,211,177,34,3
2020,CB2020,047,3,Brooklyn,30059002015,0,0,0,2.17
2020,CB2020,047,3,Brooklyn,30059002016,0,0,0,0.19
2020,CB2020,047,3,Brooklyn,30059002017,100,63,37,2.33
2020,CB2020,047,3,Brooklyn,30059002018,71,32,39,2.9
2020,CB2020,047,3,Brooklyn,30059002019,0,0,0,1.62
2020,CB2020,047,3,Brooklyn,30059002020,0,0,0,1.14
2020,CB2020,047,3,Brooklyn,30059002021,0,0,0,0.3
2020,CB2020,047,3,Brooklyn,30059002022,0,0,0,2.89
2020,CB2020,047,3,Brooklyn,30059002023,0,0,0,1.55
2020,CB2020,047,3,Brooklyn,30059002024,149,83,66,2.59
2020,CB2020,047,3,Brooklyn,30059002025,0,0,0,1.43
2020,CB2020,047,3,Brooklyn,30059002026,0,0,0,1.95
2020,CB2020,047,3,Brooklyn,30059002027,0,0,0,0.71
2020,CB2020,047,3,Brooklyn,30059002028,0,0,0,0.28
2020,CB2020,047,3,Brooklyn,30059002029,0,0,0,2.67
2020,CB2020,047,3,Brooklyn,30059002030,77,28,49,2.93
2020,CB2020,047,3,Brooklyn,30059002031,122,56,66,2.45
2020,CB2020,047,3,Brooklyn,30059002032,90,34,56,2.66
2020,CB2020,047,3,Brooklyn,30060001000,545,280,265,5.01
2020,CB2020,047,3,Brooklyn,30060001001,279,150,129,5.02
2020,CB2020,047,3,Brooklyn,30060001002,367,201,166,4.71
2020,CB2020,047,3,Brooklyn,30060002000,405,206,199,4.72
2020,CB2020,047,3,Brooklyn,30060002001,284,138,146,3.63
2020,CB2020,047,3,Brooklyn,30060002002,235,99,136,4.66
2020,CB2020,047,3,Brooklyn,30060002003,0,0,0,0.57
2020,CB2020,047,3,Brooklyn,30060003000,409,192,217,4.65
2020,CB2020,047,3,Brooklyn,30060003001,352,158,194,4.66
2020,CB2020,047,3,Brooklyn,30062001000,229,90,139,4.79
2020,CB2020,047,3,Brooklyn,30062001001,487,250,237,4.66
2020,CB2020,047,3,Brooklyn,30062001002,453,203,250,4.71
2020,CB2020,047,3,Brooklyn,30062002000,1032,537,495,6.05
2020,CB2020,047,3,Brooklyn,30062002001,256,135,121,5.92
2020,CB2020,047,3,Brooklyn,30062003000,150,76,74,4.66
2020,CB2020,047,3,Brooklyn,30062003001,212,72,140,4.65
2020,CB2020,047,3,Brooklyn,30062003002,139,72,67,4.65
2020,CB2020,047,3,Brooklyn,30063001000,358,134,224,2.75
2020,CB2020,047,3,Brooklyn,30063001001,221,123,98,2.75
2020,CB2020,047,3,Brooklyn,30063001002,385,190,195,2.76
2020,CB2020,047,3,Brooklyn,30063002000,291,132,159,2.74
2020,CB2020,047,3,Brooklyn,30063002001,154,75,79,2.86
2020,CB2020,047,3,Brooklyn,30063002002,336,139,197,2.84
2020,CB2020,047,3,Brooklyn,30063002003,231,131,100,2.79
2020,CB2020,047,3,Brooklyn,30063002004,0,0,0,2.53
2020,CB2020,047,3,Brooklyn,30063002005,0,0,0,2.51
2020,CB2020,047,3,Brooklyn,30063002006,31,17,14,0.97
2020,CB2020,047,3,Brooklyn,30064001000,279,130,149,5.06
2020,CB2020,047,3,Brooklyn,30064001001,166,84,82,4.99
2020,CB2020,047,3,Brooklyn,30064001002,405,217,188,4.98
2020,CB2020,047,3,Brooklyn,30064001003,331,167,164,5.05
2020,CB2020,047,3,Brooklyn,30064002000,436,230,206,5.05
2020,CB2020,047,3,Brooklyn,30064002001,380,199,181,4.99
2020,CB2020,047,3,Brooklyn,30064002002,241,105,136,4.98
2020,CB2020,047,3,Brooklyn,30064003000,577,278,299,5.06
2020,CB2020,047,3,Brooklyn,30064003001,533,236,297,5.04
2020,CB2020,047,3,Brooklyn,30064003002,275,138,137,4.99
2020,CB2020,047,3,Brooklyn,30065001000,356,174,182,3.49
2020,CB2020,047,3,Brooklyn,30065001001,457,220,237,3.27
2020,CB2020,047,3,Brooklyn,30065002000,398,177,221,3.9
2020,CB2020,047,3,Brooklyn,30065002001,342,172,170,3.63
2020,CB2020,047,3,Brooklyn,30065003000,410,193,217,4.27
2020,CB2020,047,3,Brooklyn,30065003001,342,171,171,3.99
2020,CB2020,047,3,Brooklyn,30065004000,403,190,213,4.28
2020,CB2020,047,3,Brooklyn,30065004001,265,133,132,3.98
2020,CB2020,047,3,Brooklyn,30065005000,342,163,179,4.27
2020,CB2020,047,3,Brooklyn,30065005001,285,122,163,3.98
2020,CB2020,047,3,Brooklyn,30065006000,358,174,184,3.83
2020,CB2020,047,3,Brooklyn,30065006001,322,141,181,3.66
2020,CB2020,047,3,Brooklyn,30065006002,221,113,108,2.15
2020,CB2020,047,3,Brooklyn,30065006003,366,188,178,3.37
2020,CB2020,047,3,Brooklyn,30065007000,287,136,151,3.4
2020,CB2020,047,3,Brooklyn,30065007001,0,0,0,0.73
2020,CB2020,047,3,Brooklyn,30065007002,191,84,107,2.91
2020,CB2020,047,3,Brooklyn,30065007003,116,42,74,1.57
2020,CB2020,047,3,Brooklyn,30065007004,0,0,0,0.25
2020,CB2020,047,3,Brooklyn,30065007005,0,0,0,0.39
2020,CB2020,047,3,Brooklyn,30065007006,0,0,0,0.45
2020,CB2020,047,3,Brooklyn,30066001000,687,318,369,4.79
2020,CB2020,047,3,Brooklyn,30066001001,162,99,63,4.65
2020,CB2020,047,3,Brooklyn,30066001002,447,227,220,4.79
2020,CB2020,047,3,Brooklyn,30066002000,469,228,241,4.9
2020,CB2020,047,3,Brooklyn,30066002001,524,247,277,4.84
2020,CB2020,047,3,Brooklyn,30066003000,569,284,285,4.65
2020,CB2020,047,3,Brooklyn,30066003001,434,211,223,4.66
2020,CB2020,047,3,Brooklyn,30066003002,682,328,354,4.72
2020,CB2020,047,3,Brooklyn,30067001000,280,133,147,4.56
2020,CB2020,047,3,Brooklyn,30067001001,384,171,213,4.65
2020,CB2020,047,3,Brooklyn,30067002000,326,171,155,3.52
2020,CB2020,047,3,Brooklyn,30067002001,505,237,268,3.53
2020,CB2020,047,3,Brooklyn,30067003000,297,138,159,3.51
2020,CB2020,047,3,Brooklyn,30067003001,365,188,177,3.27
2020,CB2020,047,3,Brooklyn,30067004000,376,175,201,3.28
2020,CB2020,047,3,Brooklyn,30067004001,366,174,192,3.27
2020,CB2020,047,3,Brooklyn,30067005000,303,152,151,4.49
2020,CB2020,047,3,Brooklyn,30067005001,416,202,214,4.51
2020,CB2020,047,3,Brooklyn,30068001000,486,228,258,5.07
2020,CB2020,047,3,Brooklyn,30068001001,1048,538,510,4.92
2020,CB2020,047,3,Brooklyn,30068002000,1105,554,551,5.71
2020,CB2020,047,3,Brooklyn,30068002001,506,248,258,3.2
2020,CB2020,047,3,Brooklyn,30068002002,279,126,153,4.81
2020,CB2020,047,3,Brooklyn,30068003000,544,282,262,4.51
2020,CB2020,047,3,Brooklyn,30068003001,187,82,105,4.65
2020,CB2020,047,3,Brooklyn,30068004000,688,357,331,6.3
2020,CB2020,047,3,Brooklyn,30068004001,504,237,267,4.42
2020,CB2020,047,3,Brooklyn,30068004002,144,76,68,2.25
2020,CB2020,047,3,Brooklyn,30069011000,366,162,204,4.13
2020,CB2020,047,3,Brooklyn,30069011001,363,205,158,4.07
2020,CB2020,047,3,Brooklyn,30069012000,354,179,175,5.27
2020,CB2020,047,3,Brooklyn,30069012001,548,270,278,4.92
2020,CB2020,047,3,Brooklyn,30069021000,142,57,85,4.1
2020,CB2020,047,3,Brooklyn,30069021001,469,218,251,3.8
2020,CB2020,047,3,Brooklyn,30069021002,371,182,189,4.07
2020,CB2020,047,3,Brooklyn,30069021003,107,60,47,0.32
2020,CB2020,047,3,Brooklyn,30069022000,505,265,240,4.73
2020,CB2020,047,3,Brooklyn,30069022001,58,29,29,4.54
2020,CB2020,047,3,Brooklyn,30069022002,310,126,184,4.32
2020,CB2020,047,3,Brooklyn,30070001000,0,0,0,0.3
2020,CB2020,047,3,Brooklyn,30070001001,0,0,0,2.7
2020,CB2020,047,3,Brooklyn,30070001002,0,0,0,0.45
2020,CB2020,047,3,Brooklyn,30070001003,0,0,0,0.5
2020,CB2020,047,3,Brooklyn,30070001004,143,81,62,3.46
2020,CB2020,047,3,Brooklyn,30070001005,676,315,361,2.97
2020,CB2020,047,3,Brooklyn,30070001006,0,0,0,4.05
2020,CB2020,047,3,Brooklyn,30070001007,0,0,0,4.06
2020,CB2020,047,3,Brooklyn,30070001008,508,241,267,4.4
2020,CB2020,047,3,Brooklyn,30070001009,0,0,0,0.53
2020,CB2020,047,3,Brooklyn,30070002000,242,131,111,4.76
2020,CB2020,047,3,Brooklyn,30070002001,432,206,226,4.68
2020,CB2020,047,3,Brooklyn,30070002002,453,205,248,4.01
2020,CB2020,047,3,Brooklyn,30071001000,317,144,173,4.07
2020,CB2020,047,3,Brooklyn,30071001001,358,164,194,4.05
2020,CB2020,047,3,Brooklyn,30071001002,413,194,219,4.04
2020,CB2020,047,3,Brooklyn,30071002000,203,99,104,4.09
2020,CB2020,047,3,Brooklyn,30071002001,68,34,34,4.09
2020,CB2020,047,3,Brooklyn,30071002002,1531,623,908,7.9
2020,CB2020,047,3,Brooklyn,30071002003,76,34,42,5.25
2020,CB2020,047,3,Brooklyn,30071002004,0,0,0,0
2020,CB2020,047,3,Brooklyn,30071003000,1396,550,846,7.91
2020,CB2020,047,3,Brooklyn,30072001000,686,366,320,4.08
2020,CB2020,047,3,Brooklyn,30072001001,0,0,0,0.62
2020,CB2020,047,3,Brooklyn,30072001002,0,0,0,0.46
2020,CB2020,047,3,Brooklyn,30072001003,0,0,0,0.15
2020,CB2020,047,3,Brooklyn,30072001004,652,317,335,3.88
2020,CB2020,047,3,Brooklyn,30072001005,308,168,140,3.34
2020,CB2020,047,3,Brooklyn,30072001006,436,198,238,2.33
2020,CB2020,047,3,Brooklyn,30072001007,0,0,0,0.59
2020,CB2020,047,3,Brooklyn,30074001000,866,472,394,4.78
2020,CB2020,047,3,Brooklyn,30074001001,769,391,378,4.77
2020,CB2020,047,3,Brooklyn,30074002000,793,409,384,4.77
2020,CB2020,047,3,Brooklyn,30074002001,1003,491,512,4.95
2020,CB2020,047,3,Brooklyn,30074003000,36,21,15,0.41
2020,CB2020,047,3,Brooklyn,30074003001,785,401,384,3.71
2020,CB2020,047,3,Brooklyn,30074003002,0,0,0,3.88
2020,CB2020,047,3,Brooklyn,30074004000,0,0,0,0.29
2020,CB2020,047,3,Brooklyn,30074004001,712,321,391,3.5
2020,CB2020,047,3,Brooklyn,30074004002,865,432,433,3.85
2020,CB2020,047,3,Brooklyn,30075001000,19,7,12,1.9
2020,CB2020,047,3,Brooklyn,30075001001,361,176,185,4.06
2020,CB2020,047,3,Brooklyn,30075001002,298,154,144,4.09
2020,CB2020,047,3,Brooklyn,30075001003,331,134,197,4.18
2020,CB2020,047,3,Brooklyn,30075002000,0,0,0,1.94
2020,CB2020,047,3,Brooklyn,30075002001,109,65,44,1.57
2020,CB2020,047,3,Brooklyn,30075002002,106,39,67,2.46
2020,CB2020,047,3,Brooklyn,30075002003,347,160,187,4.06
2020,CB2020,047,3,Brooklyn,30075002004,412,208,204,3.94
2020,CB2020,047,3,Brooklyn,30075003000,22,13,9,1.9
2020,CB2020,047,3,Brooklyn,30075003001,249,134,115,4.04
2020,CB2020,047,3,Brooklyn,30075003002,367,149,218,4.06
2020,CB2020,047,3,Brooklyn,30075003003,105,52,53,4.03
2020,CB2020,047,3,Brooklyn,30075003004,0,0,0,1.98
2020,CB2020,047,3,Brooklyn,30075003005,18,11,7,1.85
2020,CB2020,047,3,Brooklyn,30075003006,461,218,243,4.03
2020,CB2020,047,3,Brooklyn,30075004000,465,222,243,4.74
2020,CB2020,047,3,Brooklyn,30075004001,347,150,197,4.85
2020,CB2020,047,3,Brooklyn,30075005000,352,193,159,3.75
2020,CB2020,047,3,Brooklyn,30075005001,322,144,178,3.55
2020,CB2020,047,3,Brooklyn,30075005002,0,0,0,2.9
2020,CB2020,047,3,Brooklyn,30076001000,490,268,222,3.68
2020,CB2020,047,3,Brooklyn,30076001001,697,333,364,4.78
2020,CB2020,047,3,Brooklyn,30076001002,661,372,289,4.78
2020,CB2020,047,3,Brooklyn,30076002000,662,358,304,4.78
2020,CB2020,047,3,Brooklyn,30076002001,531,292,239,4.78
2020,CB2020,047,3,Brooklyn,30076003000,533,280,253,3.72
2020,CB2020,047,3,Brooklyn,30076003001,636,311,325,3.72
2020,CB2020,047,3,Brooklyn,30076003002,662,352,310,3.94
2020,CB2020,047,3,Brooklyn,30077001000,358,169,189,2.36
2020,CB2020,047,3,Brooklyn,30077001001,303,103,200,3.53
2020,CB2020,047,3,Brooklyn,30077001002,356,159,197,4.71
2020,CB2020,047,3,Brooklyn,30077001003,302,150,152,3.32
2020,CB2020,047,3,Brooklyn,30077001004,607,308,299,2.71
2020,CB2020,047,3,Brooklyn,30077002000,345,165,180,4.08
2020,CB2020,047,3,Brooklyn,30077002001,349,157,192,3.94
2020,CB2020,047,3,Brooklyn,30077002002,19,10,9,3.55
2020,CB2020,047,3,Brooklyn,30077002003,394,205,189,3.71
2020,CB2020,047,3,Brooklyn,30077002004,56,46,10,2.85
2020,CB2020,047,3,Brooklyn,30077002005,0,0,0,3.07
2020,CB2020,047,3,Brooklyn,30077003000,144,71,73,3.77
2020,CB2020,047,3,Brooklyn,30077003001,32,18,14,13.06
2020,CB2020,047,3,Brooklyn,30077003002,208,98,110,3.1
2020,CB2020,047,3,Brooklyn,30077003003,57,38,19,0.94
2020,CB2020,047,3,Brooklyn,30077003004,50,17,33,1.75
2020,CB2020,047,3,Brooklyn,30077003005,206,93,113,2.68
2020,CB2020,047,3,Brooklyn,30077003006,458,231,227,2.73
2020,CB2020,047,3,Brooklyn,30077003007,0,0,0,2.81
2020,CB2020,047,3,Brooklyn,30077003008,0,0,0,3.47
2020,CB2020,047,3,Brooklyn,30077003009,310,149,161,2.66
2020,CB2020,047,3,Brooklyn,30077003010,103,58,45,2.68
2020,CB2020,047,3,Brooklyn,30077003011,0,0,0,1.44
2020,CB2020,047,3,Brooklyn,30077003012,0,0,0,0.94
2020,CB2020,047,3,Brooklyn,30077003013,0,0,0,2.4
2020,CB2020,047,3,Brooklyn,30077004000,130,60,70,3.56
2020,CB2020,047,3,Brooklyn,30077004001,389,203,186,3.61
2020,CB2020,047,3,Brooklyn,30077004002,209,88,121,3.2
2020,CB2020,047,3,Brooklyn,30077004003,305,151,154,3.59
2020,CB2020,047,3,Brooklyn,30078001000,541,277,264,3.7
2020,CB2020,047,3,Brooklyn,30078001001,815,415,400,4.78
2020,CB2020,047,3,Brooklyn,30078002000,883,432,451,4.78
2020,CB2020,047,3,Brooklyn,30078002001,664,330,334,4.78
2020,CB2020,047,3,Brooklyn,30078003000,588,291,297,3.8
2020,CB2020,047,3,Brooklyn,30078003001,644,332,312,4.78
2020,CB2020,047,3,Brooklyn,30078004000,666,332,334,3.74
2020,CB2020,047,3,Brooklyn,30078004001,532,285,247,3.77
2020,CB2020,047,3,Brooklyn,30080001000,410,204,206,3.86
2020,CB2020,047,3,Brooklyn,30080001001,699,365,334,4.77
2020,CB2020,047,3,Brooklyn,30080001002,535,284,251,4.79
2020,CB2020,047,3,Brooklyn,30080002000,548,252,296,4.76
2020,CB2020,047,3,Brooklyn,30080002001,746,392,354,4.78
2020,CB2020,047,3,Brooklyn,30080003000,520,230,290,3.83
2020,CB2020,047,3,Brooklyn,30080003001,77,51,26,3.81
2020,CB2020,047,3,Brooklyn,30080003002,489,245,244,3.76
2020,CB2020,047,3,Brooklyn,30082001000,617,317,300,4.79
2020,CB2020,047,3,Brooklyn,30082001001,760,399,361,4.79
2020,CB2020,047,3,Brooklyn,30082002000,658,297,361,4.79
2020,CB2020,047,3,Brooklyn,30082002001,271,136,135,3.07
2020,CB2020,047,3,Brooklyn,30082002002,262,115,147,1.71
2020,CB2020,047,3,Brooklyn,30082002003,210,119,91,2.3
2020,CB2020,047,3,Brooklyn,30082002004,232,91,141,1.53
2020,CB2020,047,3,Brooklyn,30082003000,0,0,0,3.84
2020,CB2020,047,3,Brooklyn,30082003001,728,374,354,3.88
2020,CB2020,047,3,Brooklyn,30082003002,270,134,136,3.81
2020,CB2020,047,3,Brooklyn,30084001000,578,310,268,4.79
2020,CB2020,047,3,Brooklyn,30084001001,184,90,94,9.51
2020,CB2020,047,3,Brooklyn,30084001002,309,147,162,4.83
2020,CB2020,047,3,Brooklyn,30084002000,74,44,30,4.81
2020,CB2020,047,3,Brooklyn,30084002001,167,87,80,4.76
2020,CB2020,047,3,Brooklyn,30084002002,546,284,262,4.78
2020,CB2020,047,3,Brooklyn,30084002003,406,219,187,3.75
2020,CB2020,047,3,Brooklyn,30084003000,527,272,255,3.83
2020,CB2020,047,3,Brooklyn,30084003001,92,50,42,3.87
2020,CB2020,047,3,Brooklyn,30084003002,87,58,29,3.82
2020,CB2020,047,3,Brooklyn,30084003003,82,47,35,3.84
2020,CB2020,047,3,Brooklyn,30084003004,206,158,48,3.71
2020,CB2020,047,3,Brooklyn,30084003005,53,34,19,3.98
2020,CB2020,047,3,Brooklyn,30085001000,0,0,0,9.84
2020,CB2020,047,3,Brooklyn,30085001001,944,379,565,6.81
2020,CB2020,047,3,Brooklyn,30085001002,1105,501,604,8.21
2020,CB2020,047,3,Brooklyn,30085001003,464,189,275,3.13
2020,CB2020,047,3,Brooklyn,30085001004,0,0,0,0.29
2020,CB2020,047,3,Brooklyn,30085002000,497,239,258,6.35
2020,CB2020,047,3,Brooklyn,30085002001,844,297,547,5.75
2020,CB2020,047,3,Brooklyn,30085002002,478,170,308,2.92
2020,CB2020,047,3,Brooklyn,30085003000,471,221,250,5.99
2020,CB2020,047,3,Brooklyn,30085003001,418,168,250,2.64
2020,CB2020,047,3,Brooklyn,30085003002,984,400,584,5.68
2020,CB2020,047,3,Brooklyn,30085003003,468,183,285,2.58
2020,CB2020,047,3,Brooklyn,30086001000,0,0,0,28.06
2020,CB2020,047,3,Brooklyn,30088001000,349,168,181,22.43
2020,CB2020,047,3,Brooklyn,30088001001,649,324,325,4.65
2020,CB2020,047,3,Brooklyn,30088001002,887,451,436,4.65
2020,CB2020,047,3,Brooklyn,30088002000,0,0,0,5.78
2020,CB2020,047,3,Brooklyn,30088002001,676,342,334,4.64
2020,CB2020,047,3,Brooklyn,30088002002,697,368,329,4.64
2020,CB2020,047,3,Brooklyn,30090011000,0,0,0,3.88
2020,CB2020,047,3,Brooklyn,30090011001,244,134,110,5.25
2020,CB2020,047,3,Brooklyn,30090011002,686,350,336,4.64
2020,CB2020,047,3,Brooklyn,30090011003,956,459,497,4.64
2020,CB2020,047,3,Brooklyn,30090021000,0,0,0,3.63
2020,CB2020,047,3,Brooklyn,30090021001,142,95,47,5.33
2020,CB2020,047,3,Brooklyn,30090021002,445,197,248,4.65
2020,CB2020,047,3,Brooklyn,30090021003,804,425,379,4.66
2020,CB2020,047,3,Brooklyn,30092011000,674,326,348,4.67
2020,CB2020,047,3,Brooklyn,30092012000,848,445,403,4.66
2020,CB2020,047,3,Brooklyn,30092012001,337,155,182,2.5
2020,CB2020,047,3,Brooklyn,30092012002,228,116,112,2.16
2020,CB2020,047,3,Brooklyn,30092021000,978,489,489,4.66
2020,CB2020,047,3,Brooklyn,30092021001,1370,720,650,4.66
2020,CB2020,047,3,Brooklyn,30092022000,676,331,345,2.52
2020,CB2020,047,3,Brooklyn,30092022001,400,195,205,2.15
2020,CB2020,047,3,Brooklyn,30094011000,699,350,349,4.67
2020,CB2020,047,3,Brooklyn,30094011001,878,423,455,4.65
2020,CB2020,047,3,Brooklyn,30094012000,742,362,380,4.66
2020,CB2020,047,3,Brooklyn,30094012001,808,417,391,4.67
2020,CB2020,047,3,Brooklyn,30094021000,748,383,365,4.67
2020,CB2020,047,3,Brooklyn,30094021001,590,287,303,4.66
2020,CB2020,047,3,Brooklyn,30094022000,816,456,360,4.65
2020,CB2020,047,3,Brooklyn,30094022001,1014,467,547,4.68
2020,CB2020,047,3,Brooklyn,30096001000,831,413,418,4.65
2020,CB2020,047,3,Brooklyn,30096001001,850,419,431,4.65
2020,CB2020,047,3,Brooklyn,30096002000,1109,544,565,4.67
2020,CB2020,047,3,Brooklyn,30096002001,702,376,326,4.66
2020,CB2020,047,3,Brooklyn,30096003000,763,396,367,4.64
2020,CB2020,047,3,Brooklyn,30096003001,603,314,289,4.67
2020,CB2020,047,3,Brooklyn,30096004000,885,449,436,4.64
2020,CB2020,047,3,Brooklyn,30096004001,719,354,365,4.66
2020,CB2020,047,3,Brooklyn,30098001000,1141,592,549,4.66
2020,CB2020,047,3,Brooklyn,30098001001,936,470,466,4.66
2020,CB2020,047,3,Brooklyn,30098002000,988,467,521,4.67
2020,CB2020,047,3,Brooklyn,30098002001,926,461,465,4.67
2020,CB2020,047,3,Brooklyn,30098003000,1012,495,517,4.67
2020,CB2020,047,3,Brooklyn,30098003001,887,432,455,4.66
2020,CB2020,047,3,Brooklyn,30098004000,719,370,349,4.66
2020,CB2020,047,3,Brooklyn,30098004001,831,414,417,4.66
2020,CB2020,047,3,Brooklyn,30100001000,960,468,492,4.66
2020,CB2020,047,3,Brooklyn,30100001001,882,450,432,4.67
2020,CB2020,047,3,Brooklyn,30100002000,1113,579,534,4.66
2020,CB2020,047,3,Brooklyn,30100002001,915,470,445,4.66
2020,CB2020,047,3,Brooklyn,30100003000,970,479,491,4.66
2020,CB2020,047,3,Brooklyn,30100003001,1188,620,568,4.66
2020,CB2020,047,3,Brooklyn,30100004000,948,496,452,4.66
2020,CB2020,047,3,Brooklyn,30100004001,765,387,378,4.67
2020,CB2020,047,3,Brooklyn,30101001000,13,10,3,4.8
2020,CB2020,047,3,Brooklyn,30101001001,155,99,56,4.79
2020,CB2020,047,3,Brooklyn,30101001002,311,137,174,4.77
2020,CB2020,047,3,Brooklyn,30101001003,142,61,81,4.79
2020,CB2020,047,3,Brooklyn,30101001004,389,176,213,4.79
2020,CB2020,047,3,Brooklyn,30101001005,405,197,208,4.77
2020,CB2020,047,3,Brooklyn,30101002000,289,148,141,4.78
2020,CB2020,047,3,Brooklyn,30101002001,605,333,272,4.77
2020,CB2020,047,3,Brooklyn,30101002002,233,85,148,3.76
2020,CB2020,047,3,Brooklyn,30101002003,220,151,69,3.78
2020,CB2020,047,3,Brooklyn,30101002004,402,179,223,4.76
2020,CB2020,047,3,Brooklyn,30101003000,110,54,56,3.95
2020,CB2020,047,3,Brooklyn,30101003001,191,184,7,3.92
2020,CB2020,047,3,Brooklyn,30101003002,245,146,99,3.88
2020,CB2020,047,3,Brooklyn,30101003003,184,92,92,3.86
2020,CB2020,047,3,Brooklyn,30101003004,81,45,36,3.84
2020,CB2020,047,3,Brooklyn,30101003005,272,131,141,3.88
2020,CB2020,047,3,Brooklyn,30101003006,343,219,124,3.87
2020,CB2020,047,3,Brooklyn,30102001000,1143,597,546,4.67
2020,CB2020,047,3,Brooklyn,30102001001,775,389,386,4.66
2020,CB2020,047,3,Brooklyn,30102001002,961,462,499,4.66
2020,CB2020,047,3,Brooklyn,30102002000,888,434,454,4.66
2020,CB2020,047,3,Brooklyn,30102002001,44,25,19,4.85
2020,CB2020,047,3,Brooklyn,30102002002,675,342,333,4.84
2020,CB2020,047,3,Brooklyn,30102003000,943,490,453,4.66
2020,CB2020,047,3,Brooklyn,30102003001,1149,588,561,4.66
2020,CB2020,047,3,Brooklyn,30104011000,709,331,378,4.66
2020,CB2020,047,3,Brooklyn,30104011001,675,348,327,4.66
2020,CB2020,047,3,Brooklyn,30104012000,768,386,382,4.66
2020,CB2020,047,3,Brooklyn,30104012001,863,427,436,4.84
2020,CB2020,047,3,Brooklyn,30104021000,608,283,325,4.66
2020,CB2020,047,3,Brooklyn,30104021001,788,395,393,4.84
2020,CB2020,047,3,Brooklyn,30104022000,840,380,460,4.66
2020,CB2020,047,3,Brooklyn,30104022001,729,373,356,4.67
2020,CB2020,047,3,Brooklyn,30106011000,815,429,386,4.65
2020,CB2020,047,3,Brooklyn,30106011001,768,388,380,4.66
2020,CB2020,047,3,Brooklyn,30106012000,838,418,420,4.66
2020,CB2020,047,3,Brooklyn,30106012001,616,294,322,4.67
2020,CB2020,047,3,Brooklyn,30106021000,690,365,325,4.67
2020,CB2020,047,3,Brooklyn,30106021001,701,309,392,4.66
2020,CB2020,047,3,Brooklyn,30106022000,766,380,386,4.66
2020,CB2020,047,3,Brooklyn,30106022001,663,341,322,4.66
2020,CB2020,047,3,Brooklyn,30108011000,479,230,249,4.67
2020,CB2020,047,3,Brooklyn,30108011001,731,367,364,4.67
2020,CB2020,047,3,Brooklyn,30108012000,717,375,342,4.66
2020,CB2020,047,3,Brooklyn,30108012001,949,492,457,4.66
2020,CB2020,047,3,Brooklyn,30108021000,913,449,464,4.66
2020,CB2020,047,3,Brooklyn,30108021001,737,357,380,4.66
2020,CB2020,047,3,Brooklyn,30108022000,326,148,178,4.66
2020,CB2020,047,3,Brooklyn,30108022001,864,428,436,4.67
2020,CB2020,047,3,Brooklyn,30110001000,23,15,8,4.48
2020,CB2020,047,3,Brooklyn,30110001001,50,40,10,4.4
2020,CB2020,047,3,Brooklyn,30110001002,0,0,0,0.43
2020,CB2020,047,3,Brooklyn,30110001003,245,124,121,2.09
2020,CB2020,047,3,Brooklyn,30110001004,293,134,159,2.54
2020,CB2020,047,3,Brooklyn,30110001005,358,183,175,4.51
2020,CB2020,047,3,Brooklyn,30110001006,73,34,39,5.57
2020,CB2020,047,3,Brooklyn,30110001007,133,83,50,0.74
2020,CB2020,047,3,Brooklyn,30110002000,561,309,252,4.95
2020,CB2020,047,3,Brooklyn,30110002001,420,215,205,4.69
2020,CB2020,047,3,Brooklyn,30110002002,35,6,29,1.01
2020,CB2020,047,3,Brooklyn,30110002003,518,285,233,3.65
2020,CB2020,047,3,Brooklyn,30112001000,1210,612,598,4.64
2020,CB2020,047,3,Brooklyn,30112001001,786,350,436,4.11
2020,CB2020,047,3,Brooklyn,30112001002,0,0,0,0.25
2020,CB2020,047,3,Brooklyn,30112001003,0,0,0,1.39
2020,CB2020,047,3,Brooklyn,30112001004,182,105,77,2.71
2020,CB2020,047,3,Brooklyn,30112001005,0,0,0,1.31
2020,CB2020,047,3,Brooklyn,30112001006,301,153,148,2.57
2020,CB2020,047,3,Brooklyn,30112002000,537,256,281,3.45
2020,CB2020,047,3,Brooklyn,30112002001,476,239,237,3.24
2020,CB2020,047,3,Brooklyn,30112003000,776,382,394,4.66
2020,CB2020,047,3,Brooklyn,30112003001,635,299,336,4.66
2020,CB2020,047,3,Brooklyn,30112004000,1062,486,576,4.68
2020,CB2020,047,3,Brooklyn,30112004001,671,330,341,4.65
2020,CB2020,047,3,Brooklyn,30114001000,735,357,378,4.65
2020,CB2020,047,3,Brooklyn,30114001001,346,169,177,2.96
2020,CB2020,047,3,Brooklyn,30114001002,76,46,30,2.67
2020,CB2020,047,3,Brooklyn,30114001003,0,0,0,2.39
2020,CB2020,047,3,Brooklyn,30114001004,487,198,289,2.11
2020,CB2020,047,3,Brooklyn,30114002000,587,303,284,4.66
2020,CB2020,047,3,Brooklyn,30114002001,542,252,290,4.65
2020,CB2020,047,3,Brooklyn,30114002002,162,80,82,1.54
2020,CB2020,047,3,Brooklyn,30114002003,167,87,80,1.83
2020,CB2020,047,3,Brooklyn,30114003000,440,206,234,4.67
2020,CB2020,047,3,Brooklyn,30114003001,17,11,6,4.66
2020,CB2020,047,3,Brooklyn,30114003002,591,291,300,4.67
2020,CB2020,047,3,Brooklyn,30116001000,679,365,314,5.93
2020,CB2020,047,3,Brooklyn,30116001001,98,36,62,1.07
2020,CB2020,047,3,Brooklyn,30116001002,139,30,109,4.56
2020,CB2020,047,3,Brooklyn,30116001003,989,493,496,5.36
2020,CB2020,047,3,Brooklyn,30116002000,600,293,307,5.07
2020,CB2020,047,3,Brooklyn,30116002001,669,329,340,4.79
2020,CB2020,047,3,Brooklyn,30116002002,872,420,452,4.52
2020,CB2020,047,3,Brooklyn,30116003000,769,389,380,4.22
2020,CB2020,047,3,Brooklyn,30116003001,714,334,380,4.08
2020,CB2020,047,3,Brooklyn,30117001000,109,39,70,4.68
2020,CB2020,047,3,Brooklyn,30117001001,64,31,33,4.6
2020,CB2020,047,3,Brooklyn,30117001002,488,225,263,4.51
2020,CB2020,047,3,Brooklyn,30117001003,412,196,216,4.51
2020,CB2020,047,3,Brooklyn,30117002000,41,16,25,4.63
2020,CB2020,047,3,Brooklyn,30117002001,323,159,164,4.51
2020,CB2020,047,3,Brooklyn,30117002002,409,218,191,4.52
2020,CB2020,047,3,Brooklyn,30117002003,45,15,30,4.66
2020,CB2020,047,3,Brooklyn,30117003000,77,27,50,3.75
2020,CB2020,047,3,Brooklyn,30117003001,278,132,146,4.52
2020,CB2020,047,3,Brooklyn,30117003002,426,234,192,3.92
2020,CB2020,047,3,Brooklyn,30117003003,0,0,0,0.92
2020,CB2020,047,3,Brooklyn,30118001000,16,5,11,4.13
2020,CB2020,047,3,Brooklyn,30118001001,0,0,0,9.17
2020,CB2020,047,3,Brooklyn,30118001002,19,8,11,4.39
2020,CB2020,047,3,Brooklyn,30118002000,873,421,452,4.84
2020,CB2020,047,3,Brooklyn,30118002001,493,265,228,4.63
2020,CB2020,047,3,Brooklyn,30118002002,0,0,0,4.94
2020,CB2020,047,3,Brooklyn,30118002003,41,24,17,4.8
2020,CB2020,047,3,Brooklyn,30118003000,636,328,308,4.83
2020,CB2020,047,3,Brooklyn,30118003001,281,120,161,4.83
2020,CB2020,047,3,Brooklyn,30118003002,219,95,124,3.79
2020,CB2020,047,3,Brooklyn,30118003003,0,0,0,3.83
2020,CB2020,047,3,Brooklyn,30119011000,83,39,44,5.62
2020,CB2020,047,3,Brooklyn,30119011001,0,0,0,0
2020,CB2020,047,3,Brooklyn,30119011002,0,0,0,3.78
2020,CB2020,047,3,Brooklyn,30119011003,0,0,0,4.49
2020,CB2020,047,3,Brooklyn,30119011004,0,0,0,9.01
2020,CB2020,047,3,Brooklyn,30119011005,14,3,11,13.5
2020,CB2020,047,3,Brooklyn,30119011006,10,8,2,12.17
2020,CB2020,047,3,Brooklyn,30119011007,0,0,0,0
2020,CB2020,047,3,Brooklyn,30119011008,20,9,11,4.61
2020,CB2020,047,3,Brooklyn,30119011009,225,105,120,4.51
2020,CB2020,047,3,Brooklyn,30119012000,18,11,7,4.42
2020,CB2020,047,3,Brooklyn,30119012001,10,10,0,3.65
2020,CB2020,047,3,Brooklyn,30119012002,4,3,1,3.63
2020,CB2020,047,3,Brooklyn,30119012003,31,14,17,1.55
2020,CB2020,047,3,Brooklyn,30119012004,0,0,0,0
2020,CB2020,047,3,Brooklyn,30119012005,78,46,32,2.82
2020,CB2020,047,3,Brooklyn,30119012006,113,46,67,0.84
2020,CB2020,047,3,Brooklyn,30119012007,21,18,3,1.51
2020,CB2020,047,3,Brooklyn,30119012008,0,0,0,3
2020,CB2020,047,3,Brooklyn,30119012009,0,0,0,0
2020,CB2020,047,3,Brooklyn,30119012010,97,60,37,4.44
2020,CB2020,047,3,Brooklyn,30119012011,50,27,23,4.43
2020,CB2020,047,3,Brooklyn,30119012012,260,162,98,4.45
2020,CB2020,047,3,Brooklyn,30119012013,71,15,56,3.65
2020,CB2020,047,3,Brooklyn,30119012014,199,88,111,3.63
2020,CB2020,047,3,Brooklyn,30119012015,135,80,55,4.44
2020,CB2020,047,3,Brooklyn,30119012016,105,62,43,2.07
2020,CB2020,047,3,Brooklyn,30119012017,9,8,1,2.03
2020,CB2020,047,3,Brooklyn,30119012018,36,12,24,2.54
2020,CB2020,047,3,Brooklyn,30119021000,0,0,0,0
2020,CB2020,047,3,Brooklyn,30119021001,0,0,0,1.41
2020,CB2020,047,3,Brooklyn,30119021002,0,0,0,18.88
2020,CB2020,047,3,Brooklyn,30119021003,0,0,0,2.09
2020,CB2020,047,3,Brooklyn,30119021004,0,0,0,0
2020,CB2020,047,3,Brooklyn,30119021005,0,0,0,14.95
2020,CB2020,047,3,Brooklyn,30119021006,0,0,0,4.91
2020,CB2020,047,3,Brooklyn,30119021007,0,0,0,0.36
2020,CB2020,047,3,Brooklyn,30119021008,0,0,0,0.35
2020,CB2020,047,3,Brooklyn,30119021009,0,0,0,1.99
2020,CB2020,047,3,Brooklyn,30119021010,0,0,0,2.85
2020,CB2020,047,3,Brooklyn,30119021011,0,0,0,2.82
2020,CB2020,047,3,Brooklyn,30119021012,0,0,0,0.27
2020,CB2020,047,3,Brooklyn,30120001000,335,155,180,4.68
2020,CB2020,047,3,Brooklyn,30120001001,12,8,4,4.67
2020,CB2020,047,3,Brooklyn,30120001002,70,34,36,5.01
2020,CB2020,047,3,Brooklyn,30120001003,0,0,0,5.04
2020,CB2020,047,3,Brooklyn,30120001004,7,1,6,4.63
2020,CB2020,047,3,Brooklyn,30120001005,24,13,11,2.25
2020,CB2020,047,3,Brooklyn,30120001006,0,0,0,0.58
2020,CB2020,047,3,Brooklyn,30120001007,84,40,44,4.83
2020,CB2020,047,3,Brooklyn,30120001008,0,0,0,5.16
2020,CB2020,047,3,Brooklyn,30120001009,0,0,0,2.39
2020,CB2020,047,3,Brooklyn,30120001010,80,62,18,2.68
2020,CB2020,047,3,Brooklyn,30120001011,213,115,98,2.79
2020,CB2020,047,3,Brooklyn,30120001012,351,154,197,3.07
2020,CB2020,047,3,Brooklyn,30121001000,43,25,18,4.63
2020,CB2020,047,3,Brooklyn,30121001001,478,239,239,4.52
2020,CB2020,047,3,Brooklyn,30121001002,349,149,200,4.56
2020,CB2020,047,3,Brooklyn,30121001003,251,128,123,4.67
2020,CB2020,047,3,Brooklyn,30121002000,110,44,66,4.59
2020,CB2020,047,3,Brooklyn,30121002001,157,77,80,2.91
2020,CB2020,047,3,Brooklyn,30121002002,0,0,0,1.55
2020,CB2020,047,3,Brooklyn,30121002003,375,177,198,4.51
2020,CB2020,047,3,Brooklyn,30121002004,153,68,85,4.64
2020,CB2020,047,3,Brooklyn,30122001000,1167,575,592,4.96
2020,CB2020,047,3,Brooklyn,30122001001,795,405,390,4.85
2020,CB2020,047,3,Brooklyn,30122002000,1074,537,537,4.77
2020,CB2020,047,3,Brooklyn,30122002001,778,412,366,4.64
2020,CB2020,047,3,Brooklyn,30122003000,0,0,0,3.01
2020,CB2020,047,3,Brooklyn,30122004000,645,315,330,4.77
2020,CB2020,047,3,Brooklyn,30122004001,457,194,263,4.81
2020,CB2020,047,3,Brooklyn,30122004002,129,63,66,3.51
2020,CB2020,047,3,Brooklyn,30122004003,74,43,31,4.9
2020,CB2020,047,3,Brooklyn,30122004004,402,203,199,4.67
2020,CB2020,047,3,Brooklyn,30126001000,0,0,0,0.98
2020,CB2020,047,3,Brooklyn,30126001001,0,0,0,1.02
2020,CB2020,047,3,Brooklyn,30126001002,0,0,0,4
2020,CB2020,047,3,Brooklyn,30126001003,0,0,0,2.22
2020,CB2020,047,3,Brooklyn,30126001004,0,0,0,1
2020,CB2020,047,3,Brooklyn,30126001005,0,0,0,1.02
2020,CB2020,047,3,Brooklyn,30126001006,419,217,202,5.12
2020,CB2020,047,3,Brooklyn,30126001007,826,412,414,5.49
2020,CB2020,047,3,Brooklyn,30126002000,0,0,0,1
2020,CB2020,047,3,Brooklyn,30126002001,0,0,0,1.31
2020,CB2020,047,3,Brooklyn,30126002002,243,128,115,4.02
2020,CB2020,047,3,Brooklyn,30126002003,54,37,17,4.29
2020,CB2020,047,3,Brooklyn,30126002004,453,219,234,4.2
2020,CB2020,047,3,Brooklyn,30126002005,375,182,193,4.22
2020,CB2020,047,3,Brooklyn,30126003000,0,0,0,1.03
2020,CB2020,047,3,Brooklyn,30126003001,0,0,0,0.94
2020,CB2020,047,3,Brooklyn,30126003002,0,0,0,3.88
2020,CB2020,047,3,Brooklyn,30126003003,289,135,154,4.01
2020,CB2020,047,3,Brooklyn,30126003004,426,223,203,3.01
2020,CB2020,047,3,Brooklyn,30126003005,0,0,0,1.09
2020,CB2020,047,3,Brooklyn,30126003006,0,0,0,0.95
2020,CB2020,047,3,Brooklyn,30126003007,0,0,0,3.51
2020,CB2020,047,3,Brooklyn,30127001000,576,281,295,4.44
2020,CB2020,047,3,Brooklyn,30127001001,136,75,61,3.64
2020,CB2020,047,3,Brooklyn,30127001002,551,262,289,4.44
2020,CB2020,047,3,Brooklyn,30127002000,757,332,425,4.41
2020,CB2020,047,3,Brooklyn,30127002001,260,115,145,4.47
2020,CB2020,047,3,Brooklyn,30127002002,193,185,8,3.68
2020,CB2020,047,3,Brooklyn,30127002003,24,14,10,3.65
2020,CB2020,047,3,Brooklyn,30127002004,247,130,117,4.44
2020,CB2020,047,3,Brooklyn,30127003000,431,174,257,3.62
2020,CB2020,047,3,Brooklyn,30127003001,861,356,505,3.59
2020,CB2020,047,3,Brooklyn,30128011000,0,0,0,3.69
2020,CB2020,047,3,Brooklyn,30128011001,0,0,0,4.4
2020,CB2020,047,3,Brooklyn,30128011002,698,354,344,4.78
2020,CB2020,047,3,Brooklyn,30128011003,530,267,263,3.4
2020,CB2020,047,3,Brooklyn,30128011004,373,171,202,2.71
2020,CB2020,047,3,Brooklyn,30128011005,885,450,435,4.64
2020,CB2020,047,3,Brooklyn,30128011006,81,31,50,1.33
2020,CB2020,047,3,Brooklyn,30128011007,0,0,0,1.65
2020,CB2020,047,3,Brooklyn,30128011008,0,0,0,1.81
2020,CB2020,047,3,Brooklyn,30129011000,0,0,0,0.6
2020,CB2020,047,3,Brooklyn,30129011001,52,24,28,2.69
2020,CB2020,047,3,Brooklyn,30129012000,486,227,259,4.8
2020,CB2020,047,3,Brooklyn,30129012001,426,206,220,4.8
2020,CB2020,047,3,Brooklyn,30129013000,514,225,289,4.81
2020,CB2020,047,3,Brooklyn,30129013001,0,0,0,1.37
2020,CB2020,047,3,Brooklyn,30129013002,114,73,41,3.23
2020,CB2020,047,3,Brooklyn,30129014000,393,189,204,4.67
2020,CB2020,047,3,Brooklyn,30129014001,348,174,174,4.8
2020,CB2020,047,3,Brooklyn,30129021000,446,200,246,4.65
2020,CB2020,047,3,Brooklyn,30129021001,310,161,149,4.65
2020,CB2020,047,3,Brooklyn,30129022000,1105,503,602,10.17
2020,CB2020,047,3,Brooklyn,30129022001,0,0,0,0.44
2020,CB2020,047,3,Brooklyn,30129022002,230,103,127,2.15
2020,CB2020,047,3,Brooklyn,30129022003,208,98,110,2.54
2020,CB2020,047,3,Brooklyn,30129022004,531,243,288,4.52
2020,CB2020,047,3,Brooklyn,30129022005,39,21,18,0.38
2020,CB2020,047,3,Brooklyn,30129022006,449,198,251,3.96
2020,CB2020,047,3,Brooklyn,30130001000,939,445,494,4.85
2020,CB2020,047,3,Brooklyn,30130001001,139,65,74,2.64
2020,CB2020,047,3,Brooklyn,30130001002,154,72,82,2.13
2020,CB2020,047,3,Brooklyn,30130002000,752,362,390,6.08
2020,CB2020,047,3,Brooklyn,30130002001,662,338,324,6.06
2020,CB2020,047,3,Brooklyn,30130003000,590,273,317,4.81
2020,CB2020,047,3,Brooklyn,30130003001,651,332,319,4.8
2020,CB2020,047,3,Brooklyn,30130004000,471,221,250,4.45
2020,CB2020,047,3,Brooklyn,30130004001,280,129,151,1.7
2020,CB2020,047,3,Brooklyn,30130004002,709,332,377,6.07
2020,CB2020,047,3,Brooklyn,30131001000,555,235,320,4.66
2020,CB2020,047,3,Brooklyn,30131001001,462,227,235,5
2020,CB2020,047,3,Brooklyn,30131002000,491,248,243,5.32
2020,CB2020,047,3,Brooklyn,30131002001,476,233,243,4.77
2020,CB2020,047,3,Brooklyn,30131003000,333,154,179,4.64
2020,CB2020,047,3,Brooklyn,30131003001,287,125,162,2.78
2020,CB2020,047,3,Brooklyn,30131003002,234,129,105,1.88
2020,CB2020,047,3,Brooklyn,30131004000,556,265,291,4.8
2020,CB2020,047,3,Brooklyn,30131004001,300,143,157,2.64
2020,CB2020,047,3,Brooklyn,30131004002,285,125,160,2.16
2020,CB2020,047,3,Brooklyn,30132001000,294,160,134,2.12
2020,CB2020,047,3,Brooklyn,30132001001,455,220,235,3.33
2020,CB2020,047,3,Brooklyn,30132001002,305,142,163,2.37
2020,CB2020,047,3,Brooklyn,30132002000,120,53,67,1.48
2020,CB2020,047,3,Brooklyn,30132002001,73,32,41,0.9
2020,CB2020,047,3,Brooklyn,30132002002,490,226,264,5.41
2020,CB2020,047,3,Brooklyn,30132002003,694,355,339,5.11
2020,CB2020,047,3,Brooklyn,30132002004,439,245,194,4.89
2020,CB2020,047,3,Brooklyn,30132002005,0,0,0,0.29
2020,CB2020,047,3,Brooklyn,30132002006,0,0,0,7.82
2020,CB2020,047,3,Brooklyn,30132002007,0,0,0,4.76
2020,CB2020,047,3,Brooklyn,30133001000,510,247,263,4.64
2020,CB2020,047,3,Brooklyn,30133001001,509,228,281,4.8
2020,CB2020,047,3,Brooklyn,30133002000,569,266,303,4.66
2020,CB2020,047,3,Brooklyn,30133002001,675,318,357,4.79
2020,CB2020,047,3,Brooklyn,30133003000,552,278,274,4.82
2020,CB2020,047,3,Brooklyn,30133003001,443,187,256,3.6
2020,CB2020,047,3,Brooklyn,30133004000,560,269,291,4.75
2020,CB2020,047,3,Brooklyn,30133004001,593,278,315,4.63
2020,CB2020,047,3,Brooklyn,30134001000,124,60,64,1.2
2020,CB2020,047,3,Brooklyn,30134001001,109,42,67,2.17
2020,CB2020,047,3,Brooklyn,30134001002,19,11,8,0.48
2020,CB2020,047,3,Brooklyn,30134001003,0,0,0,0.75
2020,CB2020,047,3,Brooklyn,30134001004,0,0,0,0.44
2020,CB2020,047,3,Brooklyn,30134001005,0,0,0,1.02
2020,CB2020,047,3,Brooklyn,30134001006,0,0,0,4.15
2020,CB2020,047,3,Brooklyn,30134001007,0,0,0,1.47
2020,CB2020,047,3,Brooklyn,30134001008,0,0,0,3.43
2020,CB2020,047,3,Brooklyn,30134001009,126,56,70,1.43
2020,CB2020,047,3,Brooklyn,30134001010,58,24,34,0.76
2020,CB2020,047,3,Brooklyn,30134001011,197,89,108,1.4
2020,CB2020,047,3,Brooklyn,30134001012,23,9,14,1.78
2020,CB2020,047,3,Brooklyn,30134001013,174,90,84,1.33
2020,CB2020,047,3,Brooklyn,30134001014,42,18,24,0.8
2020,CB2020,047,3,Brooklyn,30134001015,209,127,82,3.73
2020,CB2020,047,3,Brooklyn,30134001016,246,129,117,2.61
2020,CB2020,047,3,Brooklyn,30134001017,179,88,91,2.01
2020,CB2020,047,3,Brooklyn,30134002000,526,264,262,4.59
2020,CB2020,047,3,Brooklyn,30134002001,410,208,202,4.91
2020,CB2020,047,3,Brooklyn,30134002002,371,168,203,5.52
2020,CB2020,047,3,Brooklyn,30134003000,512,245,267,4.61
2020,CB2020,047,3,Brooklyn,30134003001,378,194,184,6.63
2020,CB2020,047,3,Brooklyn,30134003002,341,152,189,5.37
2020,CB2020,047,3,Brooklyn,30134003003,168,83,85,3.71
2020,CB2020,047,3,Brooklyn,30135001000,390,182,208,4.63
2020,CB2020,047,3,Brooklyn,30135001001,747,323,424,4.63
2020,CB2020,047,3,Brooklyn,30135002000,25,17,8,4.78
2020,CB2020,047,3,Brooklyn,30135002001,561,262,299,4.63
2020,CB2020,047,3,Brooklyn,30135002002,487,230,257,4.64
2020,CB2020,047,3,Brooklyn,30135002003,317,154,163,4.71
2020,CB2020,047,3,Brooklyn,30135003000,367,162,205,4.77
2020,CB2020,047,3,Brooklyn,30135003001,905,456,449,4.74
2020,CB2020,047,3,Brooklyn,30136001000,0,0,0,2.42
2020,CB2020,047,3,Brooklyn,30136001001,0,0,0,1.25
2020,CB2020,047,3,Brooklyn,30136001002,0,0,0,2.28
2020,CB2020,047,3,Brooklyn,30136001003,169,68,101,3.38
2020,CB2020,047,3,Brooklyn,30136001004,446,234,212,4.99
2020,CB2020,047,3,Brooklyn,30136001005,299,142,157,4.99
2020,CB2020,047,3,Brooklyn,30136001006,151,71,80,3.43
2020,CB2020,047,3,Brooklyn,30136002000,391,181,210,4.99
2020,CB2020,047,3,Brooklyn,30136002001,637,335,302,5
2020,CB2020,047,3,Brooklyn,30136003000,388,202,186,5.05
2020,CB2020,047,3,Brooklyn,30136003001,443,216,227,5.08
2020,CB2020,047,3,Brooklyn,30136004000,514,245,269,5.05
2020,CB2020,047,3,Brooklyn,30136004001,641,315,326,5.04
2020,CB2020,047,3,Brooklyn,30137001000,623,314,309,4.76
2020,CB2020,047,3,Brooklyn,30137001001,468,224,244,4.62
2020,CB2020,047,3,Brooklyn,30137002000,618,277,341,4.76
2020,CB2020,047,3,Brooklyn,30137002001,411,206,205,4.64
2020,CB2020,047,3,Brooklyn,30137003000,336,164,172,4.76
2020,CB2020,047,3,Brooklyn,30137003001,166,72,94,4.81
2020,CB2020,047,3,Brooklyn,30137003002,389,207,182,4.69
2020,CB2020,047,3,Brooklyn,30137003003,395,185,210,4.63
2020,CB2020,047,3,Brooklyn,30138001000,214,93,121,4.94
2020,CB2020,047,3,Brooklyn,30138001001,379,157,222,5.04
2020,CB2020,047,3,Brooklyn,30138001002,570,289,281,4.99
2020,CB2020,047,3,Brooklyn,30138001003,378,206,172,4.97
2020,CB2020,047,3,Brooklyn,30138002000,460,220,240,5.07
2020,CB2020,047,3,Brooklyn,30138002001,397,191,206,5.03
2020,CB2020,047,3,Brooklyn,30138003000,543,272,271,5.03
2020,CB2020,047,3,Brooklyn,30138003001,306,125,181,5.1
2020,CB2020,047,3,Brooklyn,30139001000,429,195,234,4.63
2020,CB2020,047,3,Brooklyn,30139001001,480,234,246,4.62
2020,CB2020,047,3,Brooklyn,30139002000,651,284,367,4.76
2020,CB2020,047,3,Brooklyn,30139002001,528,261,267,4.63
2020,CB2020,047,3,Brooklyn,30139003000,423,193,230,4.75
2020,CB2020,047,3,Brooklyn,30139003001,456,206,250,4.75
2020,CB2020,047,3,Brooklyn,30139004000,409,166,243,4.68
2020,CB2020,047,3,Brooklyn,30139004001,351,167,184,4.57
2020,CB2020,047,3,Brooklyn,30140001000,372,178,194,5.35
2020,CB2020,047,3,Brooklyn,30140001001,222,106,116,4.75
2020,CB2020,047,3,Brooklyn,30140001002,270,138,132,4.22
2020,CB2020,047,3,Brooklyn,30140001003,152,72,80,1.21
2020,CB2020,047,3,Brooklyn,30140002000,73,23,50,1.61
2020,CB2020,047,3,Brooklyn,30140002001,84,62,22,2.13
2020,CB2020,047,3,Brooklyn,30140002002,105,41,64,2.64
2020,CB2020,047,3,Brooklyn,30140002003,182,101,81,3.01
2020,CB2020,047,3,Brooklyn,30140002004,199,72,127,3.6
2020,CB2020,047,3,Brooklyn,30140002005,111,47,64,2.42
2020,CB2020,047,3,Brooklyn,30140002006,68,35,33,1.93
2020,CB2020,047,3,Brooklyn,30140002007,298,149,149,3.59
2020,CB2020,047,3,Brooklyn,30141011000,163,70,93,4.74
2020,CB2020,047,3,Brooklyn,30141011001,649,292,357,4.75
2020,CB2020,047,3,Brooklyn,30141011002,452,203,249,4.63
2020,CB2020,047,3,Brooklyn,30141011003,357,167,190,4.62
2020,CB2020,047,3,Brooklyn,30141021000,446,206,240,4.76
2020,CB2020,047,3,Brooklyn,30141021001,440,207,233,5.67
2020,CB2020,047,3,Brooklyn,30141022000,458,202,256,4.63
2020,CB2020,047,3,Brooklyn,30141022001,514,259,255,7.09
2020,CB2020,047,3,Brooklyn,30142001000,346,152,194,3.04
2020,CB2020,047,3,Brooklyn,30142001001,172,66,106,2.8
2020,CB2020,047,3,Brooklyn,30142001002,0,0,0,2.69
2020,CB2020,047,3,Brooklyn,30142001003,0,0,0,0.99
2020,CB2020,047,3,Brooklyn,30142001004,113,60,53,1.8
2020,CB2020,047,3,Brooklyn,30142001005,184,81,103,2.24
2020,CB2020,047,3,Brooklyn,30142001006,71,36,35,4.27
2020,CB2020,047,3,Brooklyn,30142001007,0,0,0,0.41
2020,CB2020,047,3,Brooklyn,30142001008,143,99,44,1.38
2020,CB2020,047,3,Brooklyn,30142001009,0,0,0,3.51
2020,CB2020,047,3,Brooklyn,30142001010,0,0,0,0.86
2020,CB2020,047,3,Brooklyn,30142001011,0,0,0,0.67
2020,CB2020,047,3,Brooklyn,30142001012,0,0,0,2.32
2020,CB2020,047,3,Brooklyn,30142001013,0,0,0,1.59
2020,CB2020,047,3,Brooklyn,30142001014,0,0,0,0.49
2020,CB2020,047,3,Brooklyn,30142001015,222,100,122,1.61
2020,CB2020,047,3,Brooklyn,30142002000,595,292,303,4.59
2020,CB2020,047,3,Brooklyn,30142002001,363,149,214,4.23
2020,CB2020,047,3,Brooklyn,30142003000,627,289,338,4.95
2020,CB2020,047,3,Brooklyn,30142003001,598,320,278,5.02
2020,CB2020,047,3,Brooklyn,30143001000,136,57,79,4.24
2020,CB2020,047,3,Brooklyn,30143001001,246,116,130,3.36
2020,CB2020,047,3,Brooklyn,30143001002,0,0,0,1.39
2020,CB2020,047,3,Brooklyn,30143001003,0,0,0,1.86
2020,CB2020,047,3,Brooklyn,30143001004,86,49,37,2.71
2020,CB2020,047,3,Brooklyn,30143001005,371,175,196,4.79
2020,CB2020,047,3,Brooklyn,30143001006,417,197,220,3.93
2020,CB2020,047,3,Brooklyn,30143002000,303,152,151,4.63
2020,CB2020,047,3,Brooklyn,30143002001,405,185,220,4.66
2020,CB2020,047,3,Brooklyn,30143002002,306,146,160,2.75
2020,CB2020,047,3,Brooklyn,30143002003,152,92,60,2.29
2020,CB2020,047,3,Brooklyn,30143002004,68,25,43,1.67
2020,CB2020,047,3,Brooklyn,30143002005,102,51,51,2.02
2020,CB2020,047,3,Brooklyn,30143003000,122,50,72,3.93
2020,CB2020,047,3,Brooklyn,30143003001,490,237,253,4.78
2020,CB2020,047,3,Brooklyn,30143003002,501,267,234,4.66
2020,CB2020,047,3,Brooklyn,30145001000,465,232,233,4.66
2020,CB2020,047,3,Brooklyn,30145001001,315,163,152,4.67
2020,CB2020,047,3,Brooklyn,30145001002,433,219,214,4.67
2020,CB2020,047,3,Brooklyn,30145001003,25,7,18,4.66
2020,CB2020,047,3,Brooklyn,30145002000,620,341,279,4.78
2020,CB2020,047,3,Brooklyn,30145002001,601,267,334,4.77
2020,CB2020,047,3,Brooklyn,30145003000,168,81,87,3.96
2020,CB2020,047,3,Brooklyn,30145003001,349,186,163,3.94
2020,CB2020,047,3,Brooklyn,30145003002,456,237,219,3.94
2020,CB2020,047,3,Brooklyn,30145004000,167,81,86,3.91
2020,CB2020,047,3,Brooklyn,30145004001,175,102,73,4.29
2020,CB2020,047,3,Brooklyn,30145004002,543,244,299,4.79
2020,CB2020,047,3,Brooklyn,30145004003,87,29,58,0.49
2020,CB2020,047,3,Brooklyn,30147001000,214,106,108,3.24
2020,CB2020,047,3,Brooklyn,30147001001,0,0,0,4.37
2020,CB2020,047,3,Brooklyn,30147001002,501,230,271,4.69
2020,CB2020,047,3,Brooklyn,30147002000,495,229,266,4.66
2020,CB2020,047,3,Brooklyn,30147002001,544,244,300,4.65
2020,CB2020,047,3,Brooklyn,30147002002,488,257,231,4.58
2020,CB2020,047,3,Brooklyn,30148001000,194,71,123,4.66
2020,CB2020,047,3,Brooklyn,30148001001,186,90,96,4.64
2020,CB2020,047,3,Brooklyn,30148001002,170,89,81,4.67
2020,CB2020,047,3,Brooklyn,30148002000,151,76,75,4.65
2020,CB2020,047,3,Brooklyn,30148002001,154,73,81,4.66
2020,CB2020,047,3,Brooklyn,30148002002,185,101,84,4.65
2020,CB2020,047,3,Brooklyn,30148002003,204,92,112,5.06
2020,CB2020,047,3,Brooklyn,30149011000,371,175,196,4.63
2020,CB2020,047,3,Brooklyn,30149011001,463,218,245,4.63
2020,CB2020,047,3,Brooklyn,30149012000,488,230,258,4.64
2020,CB2020,047,3,Brooklyn,30149012001,207,77,130,4.63
2020,CB2020,047,3,Brooklyn,30149021000,582,265,317,4.63
2020,CB2020,047,3,Brooklyn,30149021001,368,170,198,4.63
2020,CB2020,047,3,Brooklyn,30149021002,529,249,280,5.47
2020,CB2020,047,3,Brooklyn,30149022000,185,95,90,3.96
2020,CB2020,047,3,Brooklyn,30149022001,219,97,122,2.17
2020,CB2020,047,3,Brooklyn,30149022002,281,135,146,4.49
2020,CB2020,047,3,Brooklyn,30149022003,275,132,143,4.55
2020,CB2020,047,3,Brooklyn,30149023000,425,167,258,4.63
2020,CB2020,047,3,Brooklyn,30149023001,237,99,138,2.81
2020,CB2020,047,3,Brooklyn,30149023002,200,110,90,2.79
2020,CB2020,047,3,Brooklyn,30149023003,300,150,150,3.08
2020,CB2020,047,3,Brooklyn,30150001000,265,134,131,4.66
2020,CB2020,047,3,Brooklyn,30150001001,322,141,181,4.65
2020,CB2020,047,3,Brooklyn,30150001002,295,129,166,4.66
2020,CB2020,047,3,Brooklyn,30150002000,177,85,92,4.65
2020,CB2020,047,3,Brooklyn,30150002001,230,120,110,4.66
2020,CB2020,047,3,Brooklyn,30150002002,242,98,144,4.65
2020,CB2020,047,3,Brooklyn,30150002003,260,133,127,5.05
2020,CB2020,047,3,Brooklyn,30151001000,508,271,237,4.56
2020,CB2020,047,3,Brooklyn,30151001001,395,175,220,4.63
2020,CB2020,047,3,Brooklyn,30151002000,501,255,246,4.63
2020,CB2020,047,3,Brooklyn,30151002001,541,234,307,4.63
2020,CB2020,047,3,Brooklyn,30151003000,456,220,236,4.62
2020,CB2020,047,3,Brooklyn,30151003001,563,260,303,4.63
2020,CB2020,047,3,Brooklyn,30151004000,354,152,202,4.56
2020,CB2020,047,3,Brooklyn,30151004001,378,177,201,4.64
2020,CB2020,047,3,Brooklyn,30152001000,274,101,173,4.11
2020,CB2020,047,3,Brooklyn,30152001001,163,90,73,3.23
2020,CB2020,047,3,Brooklyn,30152001002,146,82,64,32.13
2020,CB2020,047,3,Brooklyn,30152001003,36,21,15,0.42
2020,CB2020,047,3,Brooklyn,30152001004,54,30,24,0.51
2020,CB2020,047,3,Brooklyn,30152002000,254,85,169,2.56
2020,CB2020,047,3,Brooklyn,30152002001,117,63,54,1.44
2020,CB2020,047,3,Brooklyn,30152002002,118,69,49,2.3
2020,CB2020,047,3,Brooklyn,30152002003,110,74,36,1.61
2020,CB2020,047,3,Brooklyn,30152002004,241,93,148,3.98
2020,CB2020,047,3,Brooklyn,30152003000,97,38,59,2.77
2020,CB2020,047,3,Brooklyn,30152003001,216,115,101,2.64
2020,CB2020,047,3,Brooklyn,30152003002,371,182,189,3.44
2020,CB2020,047,3,Brooklyn,30152003003,265,149,116,3.45
2020,CB2020,047,3,Brooklyn,30152003004,83,37,46,1.65
2020,CB2020,047,3,Brooklyn,30153001000,128,60,68,4.64
2020,CB2020,047,3,Brooklyn,30153001001,9,3,6,4.62
2020,CB2020,047,3,Brooklyn,30153002000,429,201,228,4.63
2020,CB2020,047,3,Brooklyn,30153002001,482,221,261,4.69
2020,CB2020,047,3,Brooklyn,30153003000,370,181,189,4.64
2020,CB2020,047,3,Brooklyn,30153003001,449,228,221,4.7
2020,CB2020,047,3,Brooklyn,30153004000,380,177,203,4.64
2020,CB2020,047,3,Brooklyn,30153004001,386,189,197,4.63
2020,CB2020,047,3,Brooklyn,30154001000,0,0,0,193.83
2020,CB2020,047,3,Brooklyn,30154001001,9,5,4,33.52
2020,CB2020,047,3,Brooklyn,30154001002,0,0,0,0.72
2020,CB2020,047,3,Brooklyn,30155001000,229,110,119,4.63
2020,CB2020,047,3,Brooklyn,30155001001,475,227,248,4.63
2020,CB2020,047,3,Brooklyn,30155002000,521,253,268,4.62
2020,CB2020,047,3,Brooklyn,30155002001,454,240,214,4.62
2020,CB2020,047,3,Brooklyn,30155003000,550,244,306,4.63
2020,CB2020,047,3,Brooklyn,30155003001,477,230,247,4.63
2020,CB2020,047,3,Brooklyn,30155004000,471,214,257,4.62
2020,CB2020,047,3,Brooklyn,30155004001,289,140,149,4.6
2020,CB2020,047,3,Brooklyn,30157001000,615,260,355,4.67
2020,CB2020,047,3,Brooklyn,30157001001,428,197,231,4.65
2020,CB2020,047,3,Brooklyn,30157002000,614,284,330,4.64
2020,CB2020,047,3,Brooklyn,30157002001,416,188,228,4.64
2020,CB2020,047,3,Brooklyn,30157003000,454,199,255,2.65
2020,CB2020,047,3,Brooklyn,30157003001,204,90,114,2.41
2020,CB2020,047,3,Brooklyn,30157003002,176,80,96,2.36
2020,CB2020,047,3,Brooklyn,30157003003,489,228,261,6.11
2020,CB2020,047,3,Brooklyn,30157004000,643,298,345,4.63
2020,CB2020,047,3,Brooklyn,30157004001,408,194,214,4.61
2020,CB2020,047,3,Brooklyn,30159001000,505,245,260,4.66
2020,CB2020,047,3,Brooklyn,30159001001,288,128,160,2.75
2020,CB2020,047,3,Brooklyn,30159001002,191,88,103,1.9
2020,CB2020,047,3,Brooklyn,30159002000,459,217,242,4.66
2020,CB2020,047,3,Brooklyn,30159002001,393,197,196,3.41
2020,CB2020,047,3,Brooklyn,30159002002,59,14,45,1.23
2020,CB2020,047,3,Brooklyn,30159003000,564,287,277,4.63
2020,CB2020,047,3,Brooklyn,30159003001,365,162,203,5.3
2020,CB2020,047,3,Brooklyn,30159004000,355,187,168,4.35
2020,CB2020,047,3,Brooklyn,30159004001,633,288,345,5.23
2020,CB2020,047,3,Brooklyn,30159005000,0,0,0,2.32
2020,CB2020,047,3,Brooklyn,30159005001,0,0,0,4.09
2020,CB2020,047,3,Brooklyn,30159005002,0,0,0,3.7
2020,CB2020,047,3,Brooklyn,30159005003,0,0,0,4.36
2020,CB2020,047,3,Brooklyn,30159005004,0,0,0,0.39
2020,CB2020,047,3,Brooklyn,30159006000,522,242,280,3.14
2020,CB2020,047,3,Brooklyn,30159006001,166,89,77,1.46
2020,CB2020,047,3,Brooklyn,30159006002,189,94,95,1.58
2020,CB2020,047,3,Brooklyn,30159006003,357,150,207,1.61
2020,CB2020,047,3,Brooklyn,30159006004,160,93,67,1.2
2020,CB2020,047,3,Brooklyn,30160001000,259,110,149,2.84
2020,CB2020,047,3,Brooklyn,30160001001,0,0,0,3.94
2020,CB2020,047,3,Brooklyn,30160001002,687,317,370,3.16
2020,CB2020,047,3,Brooklyn,30160001003,0,0,0,2.08
2020,CB2020,047,3,Brooklyn,30160001004,0,0,0,4.01
2020,CB2020,047,3,Brooklyn,30160001005,387,200,187,3.76
2020,CB2020,047,3,Brooklyn,30160002000,409,197,212,4.14
2020,CB2020,047,3,Brooklyn,30160002001,598,297,301,3.98
2020,CB2020,047,3,Brooklyn,30160003000,194,79,115,3.44
2020,CB2020,047,3,Brooklyn,30160003001,457,234,223,3.59
2020,CB2020,047,3,Brooklyn,30160003002,367,187,180,3.98
2020,CB2020,047,3,Brooklyn,30160003003,160,74,86,3.83
2020,CB2020,047,3,Brooklyn,30160004000,161,70,91,4.66
2020,CB2020,047,3,Brooklyn,30160004001,248,102,146,3.41
2020,CB2020,047,3,Brooklyn,30160004002,113,66,47,3.76
2020,CB2020,047,3,Brooklyn,30160004003,0,0,0,3.27
2020,CB2020,047,3,Brooklyn,30160004004,30,9,21,2.67
2020,CB2020,047,3,Brooklyn,30160004005,392,196,196,3.37
2020,CB2020,047,3,Brooklyn,30161001000,493,223,270,6.62
2020,CB2020,047,3,Brooklyn,30161001001,449,215,234,4.44
2020,CB2020,047,3,Brooklyn,30161001002,79,23,56,0.82
2020,CB2020,047,3,Brooklyn,30161001003,131,74,57,1.34
2020,CB2020,047,3,Brooklyn,30161002000,0,0,0,6.02
2020,CB2020,047,3,Brooklyn,30161003000,810,363,447,5.98
2020,CB2020,047,3,Brooklyn,30161003001,381,185,196,5.96
2020,CB2020,047,3,Brooklyn,30161004000,0,0,0,0.27
2020,CB2020,047,3,Brooklyn,30161004001,165,102,63,2.19
2020,CB2020,047,3,Brooklyn,30161004002,428,163,265,4.35
2020,CB2020,047,3,Brooklyn,30161004003,58,30,28,2.39
2020,CB2020,047,3,Brooklyn,30161004004,456,202,254,4.68
2020,CB2020,047,3,Brooklyn,30162001000,203,104,99,11.2
2020,CB2020,047,3,Brooklyn,30162001001,516,232,284,4.89
2020,CB2020,047,3,Brooklyn,30162001002,308,152,156,5.28
2020,CB2020,047,3,Brooklyn,30162002000,0,0,0,8.18
2020,CB2020,047,3,Brooklyn,30162002001,436,228,208,4.75
2020,CB2020,047,3,Brooklyn,30162002002,204,91,113,3.61
2020,CB2020,047,3,Brooklyn,30162002003,231,114,117,3.33
2020,CB2020,047,3,Brooklyn,30162002004,320,152,168,4.82
2020,CB2020,047,3,Brooklyn,30162002005,0,0,0,8.26
2020,CB2020,047,3,Brooklyn,30162002006,0,0,0,1.16
2020,CB2020,047,3,Brooklyn,30162002007,0,0,0,0.32
2020,CB2020,047,3,Brooklyn,30162002008,0,0,0,1.43
2020,CB2020,047,3,Brooklyn,30162002009,0,0,0,0.2
2020,CB2020,047,3,Brooklyn,30162002010,0,0,0,0.64
2020,CB2020,047,3,Brooklyn,30162002011,0,0,0,0.67
2020,CB2020,047,3,Brooklyn,30163001000,0,0,0,6.17
2020,CB2020,047,3,Brooklyn,30163002000,1023,496,527,6.06
2020,CB2020,047,3,Brooklyn,30163002001,347,178,169,6.05
2020,CB2020,047,3,Brooklyn,30163002002,537,264,273,6.94
2020,CB2020,047,3,Brooklyn,30163003000,589,276,313,6.94
2020,CB2020,047,3,Brooklyn,30163003001,828,381,447,6.96
2020,CB2020,047,3,Brooklyn,30163004000,764,348,416,6.37
2020,CB2020,047,3,Brooklyn,30164000001,0,0,0,0
2020,CB2020,047,3,Brooklyn,30164000002,0,0,0,0
2020,CB2020,047,3,Brooklyn,30164001000,0,0,0,0.52
2020,CB2020,047,3,Brooklyn,30164001001,60,34,26,6.64
2020,CB2020,047,3,Brooklyn,30164001002,0,0,0,1.04
2020,CB2020,047,3,Brooklyn,30164001003,0,0,0,1.14
2020,CB2020,047,3,Brooklyn,30164001004,0,0,0,6.45
2020,CB2020,047,3,Brooklyn,30164001005,15,7,8,26.65
2020,CB2020,047,3,Brooklyn,30164001006,0,0,0,8.03
2020,CB2020,047,3,Brooklyn,30164001007,167,73,94,22.67
2020,CB2020,047,3,Brooklyn,30164001008,30,22,8,12.24
2020,CB2020,047,3,Brooklyn,30164001009,0,0,0,6.66
2020,CB2020,047,3,Brooklyn,30164001010,0,0,0,3.73
2020,CB2020,047,3,Brooklyn,30164001011,122,55,67,3.39
2020,CB2020,047,3,Brooklyn,30164001012,29,16,13,4.41
2020,CB2020,047,3,Brooklyn,30164001013,0,0,0,4.43
2020,CB2020,047,3,Brooklyn,30164001014,0,0,0,0.56
2020,CB2020,047,3,Brooklyn,30164001015,12,7,5,5.24
2020,CB2020,047,3,Brooklyn,30164001016,0,0,0,18.9
2020,CB2020,047,3,Brooklyn,30164001017,0,0,0,8.86
2020,CB2020,047,3,Brooklyn,30164001018,0,0,0,6.12
2020,CB2020,047,3,Brooklyn,30164001019,0,0,0,1.63
2020,CB2020,047,3,Brooklyn,30164001020,0,0,0,1.43
2020,CB2020,047,3,Brooklyn,30164001021,0,0,0,2.65
2020,CB2020,047,3,Brooklyn,30164001022,0,0,0,4.02
2020,CB2020,047,3,Brooklyn,30164001023,0,0,0,20.04
2020,CB2020,047,3,Brooklyn,30164001024,0,0,0,2.03
2020,CB2020,047,3,Brooklyn,30164001025,0,0,0,1.28
2020,CB2020,047,3,Brooklyn,30164001026,196,101,95,6.47
2020,CB2020,047,3,Brooklyn,30164001027,61,33,28,6.41
2020,CB2020,047,3,Brooklyn,30164001028,46,28,18,2.36
2020,CB2020,047,3,Brooklyn,30164001029,37,13,24,2.21
2020,CB2020,047,3,Brooklyn,30165001000,533,233,300,4.8
2020,CB2020,047,3,Brooklyn,30165001001,646,311,335,4.67
2020,CB2020,047,3,Brooklyn,30165002000,413,177,236,4.04
2020,CB2020,047,3,Brooklyn,30165002001,537,262,275,4.68
2020,CB2020,047,3,Brooklyn,30165002002,499,245,254,4.65
2020,CB2020,047,3,Brooklyn,30165003000,314,156,158,4.66
2020,CB2020,047,3,Brooklyn,30165003001,551,263,288,4.66
2020,CB2020,047,3,Brooklyn,30165003002,598,278,320,4.66
2020,CB2020,047,3,Brooklyn,30165004000,418,186,232,4.64
2020,CB2020,047,3,Brooklyn,30165004001,571,272,299,4.66
2020,CB2020,047,3,Brooklyn,30166001000,140,81,59,4.66
2020,CB2020,047,3,Brooklyn,30166001001,159,66,93,4.66
2020,CB2020,047,3,Brooklyn,30166001002,172,82,90,4.67
2020,CB2020,047,3,Brooklyn,30166001003,116,61,55,4.65
2020,CB2020,047,3,Brooklyn,30166001004,130,53,77,4.66
2020,CB2020,047,3,Brooklyn,30166001005,128,61,67,4.66
2020,CB2020,047,3,Brooklyn,30166001006,161,89,72,5.03
2020,CB2020,047,3,Brooklyn,30166002000,231,109,122,4.66
2020,CB2020,047,3,Brooklyn,30166002001,57,31,26,4.65
2020,CB2020,047,3,Brooklyn,30166002002,153,75,78,4.66
2020,CB2020,047,3,Brooklyn,30166002003,125,69,56,4.64
2020,CB2020,047,3,Brooklyn,30166002004,91,48,43,4.66
2020,CB2020,047,3,Brooklyn,30166002005,115,64,51,4.66
2020,CB2020,047,3,Brooklyn,30166002006,190,90,100,5.05
2020,CB2020,047,3,Brooklyn,30167001000,329,158,171,4.66
2020,CB2020,047,3,Brooklyn,30167001001,730,343,387,4.66
2020,CB2020,047,3,Brooklyn,30167002000,534,250,284,4.72
2020,CB2020,047,3,Brooklyn,30167002001,477,237,240,4.6
2020,CB2020,047,3,Brooklyn,30167003000,474,228,246,4.68
2020,CB2020,047,3,Brooklyn,30167003001,765,377,388,4.67
2020,CB2020,047,3,Brooklyn,30167004000,553,253,300,4.64
2020,CB2020,047,3,Brooklyn,30167004001,370,189,181,4.67
2020,CB2020,047,3,Brooklyn,30167004002,522,259,263,4.44
2020,CB2020,047,3,Brooklyn,30168000001,0,0,0,0
2020,CB2020,047,3,Brooklyn,30168001000,260,155,105,5.01
2020,CB2020,047,3,Brooklyn,30168001001,288,134,154,6.05
2020,CB2020,047,3,Brooklyn,30168001002,384,179,205,5.42
2020,CB2020,047,3,Brooklyn,30168001003,207,101,106,3.52
2020,CB2020,047,3,Brooklyn,30168001004,122,39,83,2.13
2020,CB2020,047,3,Brooklyn,30168001005,264,115,149,5.33
2020,CB2020,047,3,Brooklyn,30168001006,170,89,81,2.97
2020,CB2020,047,3,Brooklyn,30168001007,0,0,0,2.61
2020,CB2020,047,3,Brooklyn,30168001008,0,0,0,1.33
2020,CB2020,047,3,Brooklyn,30168001009,0,0,0,7.23
2020,CB2020,047,3,Brooklyn,30169001000,539,255,284,4.45
2020,CB2020,047,3,Brooklyn,30169001001,292,126,166,4.63
2020,CB2020,047,3,Brooklyn,30169002000,734,348,386,4.47
2020,CB2020,047,3,Brooklyn,30169002001,410,176,234,4.64
2020,CB2020,047,3,Brooklyn,30169003000,433,192,241,6.91
2020,CB2020,047,3,Brooklyn,30169003001,28,19,9,2.63
2020,CB2020,047,3,Brooklyn,30169003002,159,77,82,2.67
2020,CB2020,047,3,Brooklyn,30169003003,210,116,94,3.06
2020,CB2020,047,3,Brooklyn,30169004000,609,268,341,4.48
2020,CB2020,047,3,Brooklyn,30169004001,382,179,203,4.48
2020,CB2020,047,3,Brooklyn,30169005000,349,194,155,4.69
2020,CB2020,047,3,Brooklyn,30169005001,314,145,169,4.65
2020,CB2020,047,3,Brooklyn,30170001000,438,215,223,4.65
2020,CB2020,047,3,Brooklyn,30170001001,190,91,99,5.01
2020,CB2020,047,3,Brooklyn,30170001002,331,169,162,4.77
2020,CB2020,047,3,Brooklyn,30170002000,428,209,219,4.77
2020,CB2020,047,3,Brooklyn,30170002001,403,219,184,4.61
2020,CB2020,047,3,Brooklyn,30170002002,375,183,192,4.54
2020,CB2020,047,3,Brooklyn,30170002003,168,72,96,4.71
2020,CB2020,047,3,Brooklyn,30170003000,387,178,209,4.72
2020,CB2020,047,3,Brooklyn,30170003001,280,117,163,4.63
2020,CB2020,047,3,Brooklyn,30170003002,306,138,168,4.46
2020,CB2020,047,3,Brooklyn,30170003003,298,159,139,4.78
2020,CB2020,047,3,Brooklyn,30171001000,513,237,276,4.64
2020,CB2020,047,3,Brooklyn,30171001001,308,143,165,4.62
2020,CB2020,047,3,Brooklyn,30171001002,256,109,147,3.51
2020,CB2020,047,3,Brooklyn,30171001003,125,46,79,2.16
2020,CB2020,047,3,Brooklyn,30171001004,36,27,9,0.35
2020,CB2020,047,3,Brooklyn,30171002000,323,132,191,4.65
2020,CB2020,047,3,Brooklyn,30171002001,195,91,104,4.16
2020,CB2020,047,3,Brooklyn,30171002002,224,110,114,1.65
2020,CB2020,047,3,Brooklyn,30171003000,270,122,148,5.17
2020,CB2020,047,3,Brooklyn,30171003001,66,24,42,0.99
2020,CB2020,047,3,Brooklyn,30171003002,279,150,129,3.71
2020,CB2020,047,3,Brooklyn,30171003003,250,120,130,3.8
2020,CB2020,047,3,Brooklyn,30171004000,172,80,92,2.35
2020,CB2020,047,3,Brooklyn,30171004001,165,70,95,2.14
2020,CB2020,047,3,Brooklyn,30171004002,357,176,181,4.77
2020,CB2020,047,3,Brooklyn,30171004003,63,31,32,1.38
2020,CB2020,047,3,Brooklyn,30171004004,115,61,54,1.48
2020,CB2020,047,3,Brooklyn,30172001000,351,178,173,5
2020,CB2020,047,3,Brooklyn,30172001001,35,16,19,5.01
2020,CB2020,047,3,Brooklyn,30172001002,424,224,200,4.77
2020,CB2020,047,3,Brooklyn,30172001003,305,148,157,4.6
2020,CB2020,047,3,Brooklyn,30172001004,74,30,44,2.84
2020,CB2020,047,3,Brooklyn,30172001005,297,132,165,3.1
2020,CB2020,047,3,Brooklyn,30172001006,146,80,66,1.62
2020,CB2020,047,3,Brooklyn,30172001007,170,83,87,1.93
2020,CB2020,047,3,Brooklyn,30172002000,335,156,179,4.7
2020,CB2020,047,3,Brooklyn,30172002001,349,162,187,4.54
2020,CB2020,047,3,Brooklyn,30172002002,219,110,109,4.18
2020,CB2020,047,3,Brooklyn,30172002003,207,97,110,4.45
2020,CB2020,047,3,Brooklyn,30172002004,251,100,151,2.4
2020,CB2020,047,3,Brooklyn,30172002005,137,90,47,1.84
2020,CB2020,047,3,Brooklyn,30174000001,0,0,0,0
2020,CB2020,047,3,Brooklyn,30174001000,369,165,204,6.55
2020,CB2020,047,3,Brooklyn,30174001001,320,131,189,5.66
2020,CB2020,047,3,Brooklyn,30174001002,331,187,144,8.09
2020,CB2020,047,3,Brooklyn,30174001003,0,0,0,3.27
2020,CB2020,047,3,Brooklyn,30174001004,0,0,0,1.01
2020,CB2020,047,3,Brooklyn,30174001005,0,0,0,3.12
2020,CB2020,047,3,Brooklyn,30174002000,323,154,169,4.56
2020,CB2020,047,3,Brooklyn,30174002001,310,138,172,4.36
2020,CB2020,047,3,Brooklyn,30174002002,297,153,144,4.28
2020,CB2020,047,3,Brooklyn,30175001000,5,4,1,483.96
2020,CB2020,047,3,Brooklyn,30175001001,0,0,0,0.71
2020,CB2020,047,3,Brooklyn,30176000001,0,0,0,0
2020,CB2020,047,3,Brooklyn,30176001000,303,145,158,3.54
2020,CB2020,047,3,Brooklyn,30176001001,425,219,206,5.14
2020,CB2020,047,3,Brooklyn,30176001002,346,168,178,4.77
2020,CB2020,047,3,Brooklyn,30176001003,0,0,0,1.69
2020,CB2020,047,3,Brooklyn,30176001004,0,0,0,0.72
2020,CB2020,047,3,Brooklyn,30176001005,0,0,0,2.24
2020,CB2020,047,3,Brooklyn,30176002000,333,176,157,3.76
2020,CB2020,047,3,Brooklyn,30176002001,418,234,184,3.51
2020,CB2020,047,3,Brooklyn,30176002002,379,168,211,4.96
2020,CB2020,047,3,Brooklyn,30176002003,214,95,119,2.69
2020,CB2020,047,3,Brooklyn,30177001000,0,0,0,83.9
2020,CB2020,047,3,Brooklyn,30177001001,0,0,0,47.29
2020,CB2020,047,3,Brooklyn,30177001002,0,0,0,0.86
2020,CB2020,047,3,Brooklyn,30177001003,0,0,0,11.99
2020,CB2020,047,3,Brooklyn,30177001004,0,0,0,10.93
2020,CB2020,047,3,Brooklyn,30177001005,15,6,9,215.95
2020,CB2020,047,3,Brooklyn,30177001006,0,0,0,0
2020,CB2020,047,3,Brooklyn,30177001007,0,0,0,43.38
2020,CB2020,047,3,Brooklyn,30177001008,0,0,0,14.47
2020,CB2020,047,3,Brooklyn,30177001009,0,0,0,15.15
2020,CB2020,047,3,Brooklyn,30177001010,0,0,0,57.25
2020,CB2020,047,3,Brooklyn,30177001011,0,0,0,2.37
2020,CB2020,047,3,Brooklyn,30177001012,0,0,0,23.8
2020,CB2020,047,3,Brooklyn,30177001013,0,0,0,42.92
2020,CB2020,047,3,Brooklyn,30177001014,0,0,0,1.33
2020,CB2020,047,3,Brooklyn,30178001000,214,100,114,2.19
2020,CB2020,047,3,Brooklyn,30178001001,80,33,47,1.69
2020,CB2020,047,3,Brooklyn,30178001002,484,240,244,4.77
2020,CB2020,047,3,Brooklyn,30178001003,108,78,30,3.44
2020,CB2020,047,3,Brooklyn,30178001004,380,181,199,3.98
2020,CB2020,047,3,Brooklyn,30178001005,58,26,32,1.12
2020,CB2020,047,3,Brooklyn,30178002000,396,205,191,4.58
2020,CB2020,047,3,Brooklyn,30178002001,149,66,83,4.8
2020,CB2020,047,3,Brooklyn,30178002002,89,55,34,1.38
2020,CB2020,047,3,Brooklyn,30178002003,72,24,48,1.32
2020,CB2020,047,3,Brooklyn,30178002004,82,44,38,1.38
2020,CB2020,047,3,Brooklyn,30178002005,317,175,142,3.35
2020,CB2020,047,3,Brooklyn,30178002006,220,121,99,3.21
2020,CB2020,047,3,Brooklyn,30178002007,310,156,154,3.33
2020,CB2020,047,3,Brooklyn,30179001000,0,0,0,5.52
2020,CB2020,047,3,Brooklyn,30179001001,556,249,307,2.37
2020,CB2020,047,3,Brooklyn,30179001002,861,368,493,2.81
2020,CB2020,047,3,Brooklyn,30179002000,585,232,353,6.35
2020,CB2020,047,3,Brooklyn,30179002001,97,46,51,1.23
2020,CB2020,047,3,Brooklyn,30179002002,211,99,112,2.1
2020,CB2020,047,3,Brooklyn,30179002003,705,357,348,5.89
2020,CB2020,047,3,Brooklyn,30179002004,50,24,26,1.52
2020,CB2020,047,3,Brooklyn,30179002005,91,45,46,1.81
2020,CB2020,047,3,Brooklyn,30179003000,333,145,188,4.34
2020,CB2020,047,3,Brooklyn,30179003001,406,219,187,2.97
2020,CB2020,047,3,Brooklyn,30179003002,0,0,0,1.76
2020,CB2020,047,3,Brooklyn,30179003003,0,0,0,0.45
2020,CB2020,047,3,Brooklyn,30180001000,282,142,140,6.58
2020,CB2020,047,3,Brooklyn,30180001001,304,153,151,5.6
2020,CB2020,047,3,Brooklyn,30180001002,471,238,233,5.29
2020,CB2020,047,3,Brooklyn,30180001003,390,201,189,5.18
2020,CB2020,047,3,Brooklyn,30180002000,501,251,250,5.3
2020,CB2020,047,3,Brooklyn,30180002001,238,129,109,5.22
2020,CB2020,047,3,Brooklyn,30180002002,440,207,233,5.13
2020,CB2020,047,3,Brooklyn,30180002003,499,261,238,5.22
2020,CB2020,047,3,Brooklyn,30181001000,635,299,336,4.85
2020,CB2020,047,3,Brooklyn,30181001001,411,202,209,3.34
2020,CB2020,047,3,Brooklyn,30181002000,422,193,229,3.31
2020,CB2020,047,3,Brooklyn,30181002001,153,82,71,1.88
2020,CB2020,047,3,Brooklyn,30181002002,112,46,66,1.76
2020,CB2020,047,3,Brooklyn,30181002003,159,77,82,1.67
2020,CB2020,047,3,Brooklyn,30181003000,929,413,516,5.59
2020,CB2020,047,3,Brooklyn,30181003001,202,86,116,2.63
2020,CB2020,047,3,Brooklyn,30181003002,82,43,39,1.28
2020,CB2020,047,3,Brooklyn,30181004000,404,176,228,4.26
2020,CB2020,047,3,Brooklyn,30181004001,124,51,73,4.53
2020,CB2020,047,3,Brooklyn,30181004002,302,149,153,3.35
2020,CB2020,047,3,Brooklyn,30181004003,269,150,119,3.41
2020,CB2020,047,3,Brooklyn,30182001000,335,164,171,3.05
2020,CB2020,047,3,Brooklyn,30182001001,386,191,195,3.83
2020,CB2020,047,3,Brooklyn,30182001002,487,249,238,4.58
2020,CB2020,047,3,Brooklyn,30182001003,20,8,12,5.16
2020,CB2020,047,3,Brooklyn,30182002000,0,0,0,0.19
2020,CB2020,047,3,Brooklyn,30182002001,115,32,83,0.9
2020,CB2020,047,3,Brooklyn,30182002002,648,323,325,5.21
2020,CB2020,047,3,Brooklyn,30182002003,488,273,215,5.19
2020,CB2020,047,3,Brooklyn,30182002004,492,261,231,5.18
2020,CB2020,047,3,Brooklyn,30182002005,426,205,221,3.8
2020,CB2020,047,3,Brooklyn,30182002006,348,130,218,3.8
2020,CB2020,047,3,Brooklyn,30183001000,486,205,281,3.72
2020,CB2020,047,3,Brooklyn,30183001001,331,155,176,3.66
2020,CB2020,047,3,Brooklyn,30183001002,79,31,48,4.88
2020,CB2020,047,3,Brooklyn,30183001003,312,163,149,4.96
2020,CB2020,047,3,Brooklyn,30183002000,432,207,225,4.79
2020,CB2020,047,3,Brooklyn,30183002001,442,217,225,4.76
2020,CB2020,047,3,Brooklyn,30183003000,381,193,188,3.67
2020,CB2020,047,3,Brooklyn,30183003001,321,154,167,3.49
2020,CB2020,047,3,Brooklyn,30184001000,384,178,206,4.17
2020,CB2020,047,3,Brooklyn,30184001001,55,28,27,0.48
2020,CB2020,047,3,Brooklyn,30184001002,138,84,54,4.66
2020,CB2020,047,3,Brooklyn,30184001003,331,157,174,4.64
2020,CB2020,047,3,Brooklyn,30184001004,323,145,178,4.3
2020,CB2020,047,3,Brooklyn,30184002000,259,130,129,4.65
2020,CB2020,047,3,Brooklyn,30184002001,312,149,163,4.66
2020,CB2020,047,3,Brooklyn,30184002002,310,158,152,4.64
2020,CB2020,047,3,Brooklyn,30184002003,348,166,182,4.65
2020,CB2020,047,3,Brooklyn,30185011000,0,0,0,0.23
2020,CB2020,047,3,Brooklyn,30185011001,0,0,0,0.24
2020,CB2020,047,3,Brooklyn,30185011002,711,328,383,6.7
2020,CB2020,047,3,Brooklyn,30185012000,0,0,0,0.69
2020,CB2020,047,3,Brooklyn,30185012001,0,0,0,0.62
2020,CB2020,047,3,Brooklyn,30185012002,0,0,0,0.91
2020,CB2020,047,3,Brooklyn,30185012003,1599,695,904,5.85
2020,CB2020,047,3,Brooklyn,30185013000,945,378,567,3.88
2020,CB2020,047,3,Brooklyn,30185013001,319,163,156,2.06
2020,CB2020,047,3,Brooklyn,30185014000,665,289,376,4.89
2020,CB2020,047,3,Brooklyn,30185014001,222,93,129,1.38
2020,CB2020,047,3,Brooklyn,30186001000,403,201,202,4.65
2020,CB2020,047,3,Brooklyn,30186001001,347,167,180,3.96
2020,CB2020,047,3,Brooklyn,30186001002,94,51,43,0.69
2020,CB2020,047,3,Brooklyn,30186001003,106,47,59,0.85
2020,CB2020,047,3,Brooklyn,30186001004,327,146,181,3.8
2020,CB2020,047,3,Brooklyn,30186002000,356,175,181,4.65
2020,CB2020,047,3,Brooklyn,30186002001,409,206,203,4.67
2020,CB2020,047,3,Brooklyn,30186002002,322,145,177,4.66
2020,CB2020,047,3,Brooklyn,30187001000,0,0,0,0.48
2020,CB2020,047,3,Brooklyn,30187001001,0,0,0,0.25
2020,CB2020,047,3,Brooklyn,30187001002,0,0,0,0.26
2020,CB2020,047,3,Brooklyn,30187001003,0,0,0,0.32
2020,CB2020,047,3,Brooklyn,30187001004,0,0,0,0.35
2020,CB2020,047,3,Brooklyn,30187001005,501,230,271,6.49
2020,CB2020,047,3,Brooklyn,30187001006,493,253,240,6.55
2020,CB2020,047,3,Brooklyn,30187001007,342,188,154,6.49
2020,CB2020,047,3,Brooklyn,30188001000,276,143,133,4.65
2020,CB2020,047,3,Brooklyn,30188001001,251,114,137,5.02
2020,CB2020,047,3,Brooklyn,30188001002,326,178,148,5.01
2020,CB2020,047,3,Brooklyn,30188001003,303,143,160,4.64
2020,CB2020,047,3,Brooklyn,30188001004,0,0,0,0.65
2020,CB2020,047,3,Brooklyn,30188001005,133,62,71,1.56
2020,CB2020,047,3,Brooklyn,30188002000,341,192,149,5.02
2020,CB2020,047,3,Brooklyn,30188002001,346,149,197,4.65
2020,CB2020,047,3,Brooklyn,30188002002,425,204,221,4.65
2020,CB2020,047,3,Brooklyn,30188002003,333,155,178,5.02
2020,CB2020,047,3,Brooklyn,30188002004,221,123,98,2.43
2020,CB2020,047,3,Brooklyn,30190001000,402,202,200,4.13
2020,CB2020,047,3,Brooklyn,30190001001,552,319,233,4.55
2020,CB2020,047,3,Brooklyn,30190001002,533,271,262,5.17
2020,CB2020,047,3,Brooklyn,30190001003,0,0,0,0.91
2020,CB2020,047,3,Brooklyn,30190001004,205,102,103,1.44
2020,CB2020,047,3,Brooklyn,30190002000,522,286,236,4.12
2020,CB2020,047,3,Brooklyn,30190002001,216,107,109,1.87
2020,CB2020,047,3,Brooklyn,30190002002,410,222,188,2.78
2020,CB2020,047,3,Brooklyn,30190002003,89,38,51,1.94
2020,CB2020,047,3,Brooklyn,30190002004,51,36,15,0.34
2020,CB2020,047,3,Brooklyn,30190002005,261,120,141,3.04
2020,CB2020,047,3,Brooklyn,30190003000,543,277,266,4.66
2020,CB2020,047,3,Brooklyn,30190003001,498,244,254,4.64
2020,CB2020,047,3,Brooklyn,30190003002,301,141,160,4.66
2020,CB2020,047,3,Brooklyn,30190003003,161,91,70,4.56
2020,CB2020,047,3,Brooklyn,30190003004,109,68,41,3.79
2020,CB2020,047,3,Brooklyn,30191001000,52,26,26,4.44
2020,CB2020,047,3,Brooklyn,30191001001,13,10,3,1.89
2020,CB2020,047,3,Brooklyn,30191001002,0,0,0,0.72
2020,CB2020,047,3,Brooklyn,30191001003,10,1,9,1.35
2020,CB2020,047,3,Brooklyn,30191001004,0,0,0,0.47
2020,CB2020,047,3,Brooklyn,30191001005,0,0,0,0.43
2020,CB2020,047,3,Brooklyn,30191001006,0,0,0,1.03
2020,CB2020,047,3,Brooklyn,30191001007,0,0,0,1.92
2020,CB2020,047,3,Brooklyn,30191001008,70,23,47,5.72
2020,CB2020,047,3,Brooklyn,30191001009,505,266,239,4.97
2020,CB2020,047,3,Brooklyn,30191001010,257,129,128,5.08
2020,CB2020,047,3,Brooklyn,30191001011,0,0,0,0.35
2020,CB2020,047,3,Brooklyn,30191001012,561,258,303,4.51
2020,CB2020,047,3,Brooklyn,30191002000,0,0,0,0.29
2020,CB2020,047,3,Brooklyn,30191002001,0,0,0,0.29
2020,CB2020,047,3,Brooklyn,30191002002,40,11,29,0.26
2020,CB2020,047,3,Brooklyn,30191002003,0,0,0,0.33
2020,CB2020,047,3,Brooklyn,30191002004,0,0,0,0.59
2020,CB2020,047,3,Brooklyn,30191002005,0,0,0,0.26
2020,CB2020,047,3,Brooklyn,30191002006,367,147,220,4.61
2020,CB2020,047,3,Brooklyn,30191002007,340,181,159,4.85
2020,CB2020,047,3,Brooklyn,30191002008,403,185,218,5.43
2020,CB2020,047,3,Brooklyn,30191003000,0,0,0,0.23
2020,CB2020,047,3,Brooklyn,30191003001,0,0,0,0.21
2020,CB2020,047,3,Brooklyn,30191003002,0,0,0,0.66
2020,CB2020,047,3,Brooklyn,30191003003,0,0,0,0.39
2020,CB2020,047,3,Brooklyn,30191003004,348,163,185,5.89
2020,CB2020,047,3,Brooklyn,30191003005,461,196,265,5.53
2020,CB2020,047,3,Brooklyn,30192001000,648,332,316,4.66
2020,CB2020,047,3,Brooklyn,30192001001,471,245,226,3.03
2020,CB2020,047,3,Brooklyn,30192002000,494,267,227,4.84
2020,CB2020,047,3,Brooklyn,30192002001,135,67,68,4.83
2020,CB2020,047,3,Brooklyn,30192002002,0,0,0,2.31
2020,CB2020,047,3,Brooklyn,30192002003,0,0,0,2.29
2020,CB2020,047,3,Brooklyn,30192002004,154,73,81,4.71
2020,CB2020,047,3,Brooklyn,30192002005,354,196,158,3.93
2020,CB2020,047,3,Brooklyn,30192002006,0,0,0,0.08
2020,CB2020,047,3,Brooklyn,30192003000,0,0,0,2.39
2020,CB2020,047,3,Brooklyn,30192003001,422,233,189,2.34
2020,CB2020,047,3,Brooklyn,30192003002,355,168,187,2.31
2020,CB2020,047,3,Brooklyn,30192003003,434,236,198,4.65
2020,CB2020,047,3,Brooklyn,30192003004,0,0,0,2.55
2020,CB2020,047,3,Brooklyn,30192004000,0,0,0,0.52
2020,CB2020,047,3,Brooklyn,30192004001,74,46,28,1.47
2020,CB2020,047,3,Brooklyn,30193001000,527,217,310,4.26
2020,CB2020,047,3,Brooklyn,30193001001,784,207,577,5.41
2020,CB2020,047,3,Brooklyn,30193001002,1256,519,737,6.75
2020,CB2020,047,3,Brooklyn,30193001003,0,0,0,1.38
2020,CB2020,047,3,Brooklyn,30193002000,121,35,86,3.45
2020,CB2020,047,3,Brooklyn,30193002001,929,424,505,4.35
2020,CB2020,047,3,Brooklyn,30193003000,374,107,267,14.96
2020,CB2020,047,3,Brooklyn,30193003001,306,50,256,4.67
2020,CB2020,047,3,Brooklyn,30193003002,0,0,0,4.56
2020,CB2020,047,3,Brooklyn,30193004000,756,311,445,6.68
2020,CB2020,047,3,Brooklyn,30193004001,1226,444,782,10.2
2020,CB2020,047,3,Brooklyn,30194001000,639,320,319,4.65
2020,CB2020,047,3,Brooklyn,30194001001,635,327,308,4.99
2020,CB2020,047,3,Brooklyn,30194001002,143,66,77,3.21
2020,CB2020,047,3,Brooklyn,30194001003,101,59,42,2.21
2020,CB2020,047,3,Brooklyn,30194002000,418,208,210,5.02
2020,CB2020,047,3,Brooklyn,30194002001,500,254,246,4.66
2020,CB2020,047,3,Brooklyn,30194003000,20,13,7,4.66
2020,CB2020,047,3,Brooklyn,30194003001,364,195,169,5.01
2020,CB2020,047,3,Brooklyn,30194003002,182,88,94,5.01
2020,CB2020,047,3,Brooklyn,30194003003,568,275,293,4.66
2020,CB2020,047,3,Brooklyn,30195001000,322,181,141,3.62
2020,CB2020,047,3,Brooklyn,30195001001,499,252,247,4.74
2020,CB2020,047,3,Brooklyn,30195002000,331,170,161,3.63
2020,CB2020,047,3,Brooklyn,30195002001,581,284,297,4.81
2020,CB2020,047,3,Brooklyn,30195003000,1046,480,566,3.61
2020,CB2020,047,3,Brooklyn,30195003001,199,103,96,4.76
2020,CB2020,047,3,Brooklyn,30195004000,517,246,271,3.73
2020,CB2020,047,3,Brooklyn,30195004001,189,93,96,4.97
2020,CB2020,047,3,Brooklyn,30196001000,627,303,324,5.6
2020,CB2020,047,3,Brooklyn,30196001001,603,326,277,3.71
2020,CB2020,047,3,Brooklyn,30196001002,325,169,156,3.15
2020,CB2020,047,3,Brooklyn,30196001003,143,53,90,1.49
2020,CB2020,047,3,Brooklyn,30196002000,326,141,185,4.66
2020,CB2020,047,3,Brooklyn,30196002001,436,219,217,4.65
2020,CB2020,047,3,Brooklyn,30196002002,294,163,131,4.64
2020,CB2020,047,3,Brooklyn,30196002003,324,148,176,4.67
2020,CB2020,047,3,Brooklyn,30196003000,630,264,366,5.8
2020,CB2020,047,3,Brooklyn,30196003001,267,144,123,3.51
2020,CB2020,047,3,Brooklyn,30196003002,344,155,189,2.84
2020,CB2020,047,3,Brooklyn,30196003003,372,184,188,1.82
2020,CB2020,047,3,Brooklyn,30197001000,253,122,131,3.41
2020,CB2020,047,3,Brooklyn,30197001001,164,73,91,3.45
2020,CB2020,047,3,Brooklyn,30197002000,188,89,99,3.41
2020,CB2020,047,3,Brooklyn,30197002001,464,224,240,3.62
2020,CB2020,047,3,Brooklyn,30197002002,272,136,136,3.34
2020,CB2020,047,3,Brooklyn,30197003000,204,104,100,3.48
2020,CB2020,047,3,Brooklyn,30197003001,800,362,438,3.35
2020,CB2020,047,3,Brooklyn,30197003002,267,129,138,3.47
2020,CB2020,047,3,Brooklyn,30197003003,8,7,1,3.47
2020,CB2020,047,3,Brooklyn,30197004000,475,230,245,3.36
2020,CB2020,047,3,Brooklyn,30197004001,268,130,138,3.01
2020,CB2020,047,3,Brooklyn,30197004002,177,82,95,3.97
2020,CB2020,047,3,Brooklyn,30197004003,45,31,14,0.62
2020,CB2020,047,3,Brooklyn,30198001000,361,168,193,4.66
2020,CB2020,047,3,Brooklyn,30198001001,211,108,103,4.65
2020,CB2020,047,3,Brooklyn,30198001002,224,107,117,5.02
2020,CB2020,047,3,Brooklyn,30198002000,324,187,137,5.01
2020,CB2020,047,3,Brooklyn,30198002001,276,113,163,4.64
2020,CB2020,047,3,Brooklyn,30198002002,400,215,185,4.66
2020,CB2020,047,3,Brooklyn,30198002003,265,102,163,4.65
2020,CB2020,047,3,Brooklyn,30199001000,168,71,97,5.26
2020,CB2020,047,3,Brooklyn,30199001001,451,212,239,5.02
2020,CB2020,047,3,Brooklyn,30199002000,301,138,163,3.21
2020,CB2020,047,3,Brooklyn,30199002001,203,102,101,2.28
2020,CB2020,047,3,Brooklyn,30199002002,243,89,154,1.56
2020,CB2020,047,3,Brooklyn,30199002003,0,0,0,0.49
2020,CB2020,047,3,Brooklyn,30199003000,440,209,231,4.55
2020,CB2020,047,3,Brooklyn,30199003001,303,117,186,4.46
2020,CB2020,047,3,Brooklyn,30199003002,326,149,177,4.32
2020,CB2020,047,3,Brooklyn,30199003003,456,205,251,5.13
2020,CB2020,047,3,Brooklyn,30199004000,526,226,300,5.21
2020,CB2020,047,3,Brooklyn,30199004001,561,277,284,5.19
2020,CB2020,047,3,Brooklyn,30200001000,396,186,210,4.66
2020,CB2020,047,3,Brooklyn,30200001001,525,255,270,4.66
2020,CB2020,047,3,Brooklyn,30200001002,395,201,194,5.01
2020,CB2020,047,3,Brooklyn,30200002000,242,106,136,5.02
2020,CB2020,047,3,Brooklyn,30200002001,185,101,84,4.65
2020,CB2020,047,3,Brooklyn,30200002002,336,173,163,4.66
2020,CB2020,047,3,Brooklyn,30200002003,363,146,217,4.66
2020,CB2020,047,3,Brooklyn,30201001000,416,185,231,5.03
2020,CB2020,047,3,Brooklyn,30201001001,386,183,203,4.97
2020,CB2020,047,3,Brooklyn,30201001002,0,0,0,0.35
2020,CB2020,047,3,Brooklyn,30201002000,287,139,148,4.29
2020,CB2020,047,3,Brooklyn,30201002001,546,247,299,4.9
2020,CB2020,047,3,Brooklyn,30201002002,263,108,155,4.45
2020,CB2020,047,3,Brooklyn,30201003000,436,206,230,4.68
2020,CB2020,047,3,Brooklyn,30201003001,551,249,302,4.18
2020,CB2020,047,3,Brooklyn,30201004000,419,208,211,5.01
2020,CB2020,047,3,Brooklyn,30201004001,558,237,321,5.49
2020,CB2020,047,3,Brooklyn,30202001000,468,236,232,4.66
2020,CB2020,047,3,Brooklyn,30202001001,343,151,192,4.66
2020,CB2020,047,3,Brooklyn,30202001002,290,135,155,5.01
2020,CB2020,047,3,Brooklyn,30202002000,302,126,176,5.02
2020,CB2020,047,3,Brooklyn,30202002001,285,112,173,4.65
2020,CB2020,047,3,Brooklyn,30202002002,216,119,97,4.65
2020,CB2020,047,3,Brooklyn,30202002003,243,129,114,4.66
2020,CB2020,047,3,Brooklyn,30203001000,300,120,180,5.55
2020,CB2020,047,3,Brooklyn,30203001001,71,28,43,0.54
2020,CB2020,047,3,Brooklyn,30203001002,172,88,84,1.48
2020,CB2020,047,3,Brooklyn,30203001003,305,153,152,4.47
2020,CB2020,047,3,Brooklyn,30203001004,266,134,132,3.63
2020,CB2020,047,3,Brooklyn,30203001005,105,55,50,2.33
2020,CB2020,047,3,Brooklyn,30203002000,240,108,132,5.76
2020,CB2020,047,3,Brooklyn,30203002001,312,161,151,5.52
2020,CB2020,047,3,Brooklyn,30203002002,361,171,190,5.52
2020,CB2020,047,3,Brooklyn,30204001000,363,166,197,4.66
2020,CB2020,047,3,Brooklyn,30204001001,293,152,141,4.66
2020,CB2020,047,3,Brooklyn,30204001002,378,182,196,5
2020,CB2020,047,3,Brooklyn,30204002000,322,161,161,5.02
2020,CB2020,047,3,Brooklyn,30204002001,230,116,114,4.65
2020,CB2020,047,3,Brooklyn,30204002002,280,134,146,4.66
2020,CB2020,047,3,Brooklyn,30204002003,174,81,93,4.66
2020,CB2020,047,3,Brooklyn,30205001000,276,108,168,3.12
2020,CB2020,047,3,Brooklyn,30205001001,427,211,216,3.73
2020,CB2020,047,3,Brooklyn,30205001002,198,93,105,6.33
2020,CB2020,047,3,Brooklyn,30205002000,151,79,72,2
2020,CB2020,047,3,Brooklyn,30205002001,490,231,259,4.81
2020,CB2020,047,3,Brooklyn,30205002002,731,308,423,6.32
2020,CB2020,047,3,Brooklyn,30205003000,64,31,33,0.89
2020,CB2020,047,3,Brooklyn,30205003001,566,240,326,5.94
2020,CB2020,047,3,Brooklyn,30205003002,502,257,245,6.34
2020,CB2020,047,3,Brooklyn,30206001000,399,189,210,4.17
2020,CB2020,047,3,Brooklyn,30206001001,635,315,320,4.46
2020,CB2020,047,3,Brooklyn,30206001002,140,76,64,4.71
2020,CB2020,047,3,Brooklyn,30206001003,143,71,72,5.44
2020,CB2020,047,3,Brooklyn,30206002000,293,169,124,5.74
2020,CB2020,047,3,Brooklyn,30206002001,263,137,126,5.65
2020,CB2020,047,3,Brooklyn,30206002002,344,164,180,6.43
2020,CB2020,047,3,Brooklyn,30206002003,288,112,176,5.65
2020,CB2020,047,3,Brooklyn,30207001000,656,295,361,7.07
2020,CB2020,047,3,Brooklyn,30207001001,1342,638,704,8.22
2020,CB2020,047,3,Brooklyn,30207002000,941,450,491,5.09
2020,CB2020,047,3,Brooklyn,30207002001,661,275,386,3.9
2020,CB2020,047,3,Brooklyn,30207002002,0,0,0,0.49
2020,CB2020,047,3,Brooklyn,30207003000,607,264,343,6.32
2020,CB2020,047,3,Brooklyn,30207003001,664,316,348,2.98
2020,CB2020,047,3,Brooklyn,30208001000,344,161,183,3.14
2020,CB2020,047,3,Brooklyn,30208001001,196,91,105,1.51
2020,CB2020,047,3,Brooklyn,30208001002,468,203,265,4.65
2020,CB2020,047,3,Brooklyn,30208002000,397,182,215,4.66
2020,CB2020,047,3,Brooklyn,30208002001,490,225,265,4.64
2020,CB2020,047,3,Brooklyn,30208002002,504,258,246,4.64
2020,CB2020,047,3,Brooklyn,30208003000,344,171,173,2.6
2020,CB2020,047,3,Brooklyn,30208003001,123,89,34,1.01
2020,CB2020,047,3,Brooklyn,30208003002,488,232,256,3.9
2020,CB2020,047,3,Brooklyn,30208003003,194,91,103,1.97
2020,CB2020,047,3,Brooklyn,30208003004,234,95,139,2.68
2020,CB2020,047,3,Brooklyn,30210001000,541,270,271,4.66
2020,CB2020,047,3,Brooklyn,30210001001,614,316,298,5.69
2020,CB2020,047,3,Brooklyn,30210001002,433,214,219,3.63
2020,CB2020,047,3,Brooklyn,30210002000,533,268,265,4.66
2020,CB2020,047,3,Brooklyn,30210002001,605,293,312,5.5
2020,CB2020,047,3,Brooklyn,30210002002,386,172,214,3.82
2020,CB2020,047,3,Brooklyn,30210003000,505,257,248,2.73
2020,CB2020,047,3,Brooklyn,30210003001,495,234,261,3.06
2020,CB2020,047,3,Brooklyn,30210003002,376,201,175,3.33
2020,CB2020,047,3,Brooklyn,30211001000,525,251,274,3.32
2020,CB2020,047,3,Brooklyn,30211001001,21,5,16,11.84
2020,CB2020,047,3,Brooklyn,30211002000,120,56,64,4.06
2020,CB2020,047,3,Brooklyn,30211002001,802,350,452,4.01
2020,CB2020,047,3,Brooklyn,30211002002,145,74,71,3.97
2020,CB2020,047,3,Brooklyn,30211002003,181,110,71,3.94
2020,CB2020,047,3,Brooklyn,30211002004,108,50,58,3.94
2020,CB2020,047,3,Brooklyn,30211002005,204,94,110,3.95
2020,CB2020,047,3,Brooklyn,30211002006,0,0,0,3.88
2020,CB2020,047,3,Brooklyn,30211003000,0,0,0,2.06
2020,CB2020,047,3,Brooklyn,30211003001,20,14,6,3.28
2020,CB2020,047,3,Brooklyn,30211003002,97,38,59,3.52
2020,CB2020,047,3,Brooklyn,30211003003,24,15,9,3.75
2020,CB2020,047,3,Brooklyn,30211003004,28,8,20,3.82
2020,CB2020,047,3,Brooklyn,30211003005,195,109,86,3.93
2020,CB2020,047,3,Brooklyn,30211003006,35,22,13,3.9
2020,CB2020,047,3,Brooklyn,30212001000,191,83,108,1.59
2020,CB2020,047,3,Brooklyn,30212001001,237,117,120,1.87
2020,CB2020,047,3,Brooklyn,30212001002,702,314,388,4.65
2020,CB2020,047,3,Brooklyn,30212001003,460,261,199,4.66
2020,CB2020,047,3,Brooklyn,30212001004,536,304,232,4.66
2020,CB2020,047,3,Brooklyn,30212002000,497,254,243,4.65
2020,CB2020,047,3,Brooklyn,30212002001,523,246,277,5.02
2020,CB2020,047,3,Brooklyn,30212002002,553,287,266,5.02
2020,CB2020,047,3,Brooklyn,30212003000,75,49,26,2.33
2020,CB2020,047,3,Brooklyn,30212003001,573,262,311,5.01
2020,CB2020,047,3,Brooklyn,30212003002,781,387,394,5.02
2020,CB2020,047,3,Brooklyn,30212003003,150,70,80,2.67
2020,CB2020,047,3,Brooklyn,30213001000,0,0,0,0.58
2020,CB2020,047,3,Brooklyn,30213001001,0,0,0,1.14
2020,CB2020,047,3,Brooklyn,30213001002,0,0,0,0.58
2020,CB2020,047,3,Brooklyn,30213001003,0,0,0,2.71
2020,CB2020,047,3,Brooklyn,30213001004,254,91,163,3.88
2020,CB2020,047,3,Brooklyn,30213001005,333,143,190,1.77
2020,CB2020,047,3,Brooklyn,30213001006,277,141,136,2.39
2020,CB2020,047,3,Brooklyn,30213001007,0,0,0,4.88
2020,CB2020,047,3,Brooklyn,30213002000,257,114,143,2.42
2020,CB2020,047,3,Brooklyn,30213002001,25,16,9,5
2020,CB2020,047,3,Brooklyn,30213002002,956,419,537,3.79
2020,CB2020,047,3,Brooklyn,30213002003,695,276,419,2.38
2020,CB2020,047,3,Brooklyn,30213003000,0,0,0,2.39
2020,CB2020,047,3,Brooklyn,30213003001,410,175,235,2.67
2020,CB2020,047,3,Brooklyn,30213003002,254,126,128,2
2020,CB2020,047,3,Brooklyn,30213003003,419,181,238,5.92
2020,CB2020,047,3,Brooklyn,30213003004,0,0,0,1.02
2020,CB2020,047,3,Brooklyn,30214001000,28,15,13,3.33
2020,CB2020,047,3,Brooklyn,30214001001,0,0,0,2.36
2020,CB2020,047,3,Brooklyn,30214002000,608,304,304,4.66
2020,CB2020,047,3,Brooklyn,30214002001,506,255,251,4.84
2020,CB2020,047,3,Brooklyn,30214002002,177,111,66,4.81
2020,CB2020,047,3,Brooklyn,30214002003,0,0,0,2.29
2020,CB2020,047,3,Brooklyn,30214003000,0,0,0,0.41
2020,CB2020,047,3,Brooklyn,30214003001,306,145,161,4.7
2020,CB2020,047,3,Brooklyn,30214003002,470,245,225,4.83
2020,CB2020,047,3,Brooklyn,30214003003,0,0,0,0.75
2020,CB2020,047,3,Brooklyn,30214003004,79,65,14,1.06
2020,CB2020,047,3,Brooklyn,30214003005,0,0,0,2.63
2020,CB2020,047,3,Brooklyn,30214003006,328,164,164,4.83
2020,CB2020,047,3,Brooklyn,30215001000,281,123,158,6.59
2020,CB2020,047,3,Brooklyn,30215001001,589,320,269,5.46
2020,CB2020,047,3,Brooklyn,30215002000,605,268,337,4.36
2020,CB2020,047,3,Brooklyn,30215002001,358,168,190,2.62
2020,CB2020,047,3,Brooklyn,30215002002,0,0,0,0.7
2020,CB2020,047,3,Brooklyn,30215003000,1480,602,878,7.57
2020,CB2020,047,3,Brooklyn,30215004000,2256,1005,1251,8.52
2020,CB2020,047,3,Brooklyn,30215004001,0,0,0,1.82
2020,CB2020,047,3,Brooklyn,30216001000,615,313,302,4.66
2020,CB2020,047,3,Brooklyn,30216001001,457,241,216,4.66
2020,CB2020,047,3,Brooklyn,30216001002,317,164,153,4.65
2020,CB2020,047,3,Brooklyn,30216002000,368,176,192,4.67
2020,CB2020,047,3,Brooklyn,30216002001,439,201,238,4.65
2020,CB2020,047,3,Brooklyn,30216002002,334,186,148,4.67
2020,CB2020,047,3,Brooklyn,30216003000,558,275,283,4.25
2020,CB2020,047,3,Brooklyn,30216003001,355,187,168,4.51
2020,CB2020,047,3,Brooklyn,30216003002,837,413,424,4.83
2020,CB2020,047,3,Brooklyn,30217001000,292,127,165,2.41
2020,CB2020,047,3,Brooklyn,30217001001,763,353,410,4.99
2020,CB2020,047,3,Brooklyn,30217001002,382,151,231,4.99
2020,CB2020,047,3,Brooklyn,30217001003,289,115,174,2.38
2020,CB2020,047,3,Brooklyn,30217002000,354,190,164,2.37
2020,CB2020,047,3,Brooklyn,30217002001,1218,483,735,5.04
2020,CB2020,047,3,Brooklyn,30217002002,778,321,457,3.81
2020,CB2020,047,3,Brooklyn,30217002003,0,0,0,1.24
2020,CB2020,047,3,Brooklyn,30217002004,0,0,0,0.57
2020,CB2020,047,3,Brooklyn,30217002005,275,129,146,1.79
2020,CB2020,047,3,Brooklyn,30218001000,240,128,112,2.6
2020,CB2020,047,3,Brooklyn,30218001001,376,175,201,3.59
2020,CB2020,047,3,Brooklyn,30218001002,675,326,349,4.67
2020,CB2020,047,3,Brooklyn,30218001003,70,36,34,1.04
2020,CB2020,047,3,Brooklyn,30218001004,125,59,66,2.06
2020,CB2020,047,3,Brooklyn,30218002000,454,226,228,4.66
2020,CB2020,047,3,Brooklyn,30218002001,511,277,234,4.66
2020,CB2020,047,3,Brooklyn,30218002002,406,202,204,4.66
2020,CB2020,047,3,Brooklyn,30218003000,408,205,203,3.41
2020,CB2020,047,3,Brooklyn,30218003001,480,251,229,3.68
2020,CB2020,047,3,Brooklyn,30218003002,446,207,239,3.97
2020,CB2020,047,3,Brooklyn,30219001000,347,157,190,2.45
2020,CB2020,047,3,Brooklyn,30219001001,749,316,433,5.91
2020,CB2020,047,3,Brooklyn,30219002000,253,78,175,2.95
2020,CB2020,047,3,Brooklyn,30219002001,580,270,310,5.36
2020,CB2020,047,3,Brooklyn,30219002002,90,41,49,0.6
2020,CB2020,047,3,Brooklyn,30219002003,524,258,266,3.43
2020,CB2020,047,3,Brooklyn,30219003000,243,109,134,2.14
2020,CB2020,047,3,Brooklyn,30219003001,186,81,105,1.87
2020,CB2020,047,3,Brooklyn,30219003002,102,42,60,0.94
2020,CB2020,047,3,Brooklyn,30219003003,96,45,51,0.95
2020,CB2020,047,3,Brooklyn,30219003004,620,296,324,4.44
2020,CB2020,047,3,Brooklyn,30219003005,435,204,231,2.88
2020,CB2020,047,3,Brooklyn,30219003006,0,0,0,1.02
2020,CB2020,047,3,Brooklyn,30219003007,0,0,0,1.4
2020,CB2020,047,3,Brooklyn,30220001000,804,406,398,4.65
2020,CB2020,047,3,Brooklyn,30220001001,984,484,500,4.64
2020,CB2020,047,3,Brooklyn,30220002000,0,0,0,0.61
2020,CB2020,047,3,Brooklyn,30220002001,406,203,203,4.06
2020,CB2020,047,3,Brooklyn,30220002002,256,131,125,3.04
2020,CB2020,047,3,Brooklyn,30220002003,0,0,0,1.6
2020,CB2020,047,3,Brooklyn,30220002004,582,277,305,4.66
2020,CB2020,047,3,Brooklyn,30220003000,523,255,268,2.83
2020,CB2020,047,3,Brooklyn,30220003001,620,333,287,4.68
2020,CB2020,047,3,Brooklyn,30220003002,110,60,50,3.11
2020,CB2020,047,3,Brooklyn,30220004000,176,95,81,2.26
2020,CB2020,047,3,Brooklyn,30220004001,350,168,182,2.55
2020,CB2020,047,3,Brooklyn,30220004002,469,244,225,4.25
2020,CB2020,047,3,Brooklyn,30220004003,273,140,133,3.29
2020,CB2020,047,3,Brooklyn,30220004004,107,63,44,1.4
2020,CB2020,047,3,Brooklyn,30220004005,0,0,0,0.39
2020,CB2020,047,3,Brooklyn,30221001000,0,0,0,0.85
2020,CB2020,047,3,Brooklyn,30221001001,79,36,43,0.49
2020,CB2020,047,3,Brooklyn,30221001002,212,184,28,3.59
2020,CB2020,047,3,Brooklyn,30221001003,761,343,418,4.85
2020,CB2020,047,3,Brooklyn,30221001004,525,250,275,5.3
2020,CB2020,047,3,Brooklyn,30221001005,0,0,0,0.39
2020,CB2020,047,3,Brooklyn,30221002000,113,51,62,1
2020,CB2020,047,3,Brooklyn,30221002001,648,292,356,5.84
2020,CB2020,047,3,Brooklyn,30221002002,654,298,356,5.93
2020,CB2020,047,3,Brooklyn,30221003000,109,56,53,1.5
2020,CB2020,047,3,Brooklyn,30221003001,212,90,122,1.96
2020,CB2020,047,3,Brooklyn,30221003002,584,263,321,5.87
2020,CB2020,047,3,Brooklyn,30222001000,605,305,300,4.66
2020,CB2020,047,3,Brooklyn,30222001001,726,388,338,4.67
2020,CB2020,047,3,Brooklyn,30222001002,712,309,403,4.65
2020,CB2020,047,3,Brooklyn,30222002000,167,79,88,1.98
2020,CB2020,047,3,Brooklyn,30222002001,290,141,149,2.25
2020,CB2020,047,3,Brooklyn,30222002002,144,84,60,2.42
2020,CB2020,047,3,Brooklyn,30222002003,692,334,358,4.67
2020,CB2020,047,3,Brooklyn,30222003000,757,363,394,5.6
2020,CB2020,047,3,Brooklyn,30222003001,21,7,14,0.34
2020,CB2020,047,3,Brooklyn,30222003002,68,44,24,1.32
2020,CB2020,047,3,Brooklyn,30222003003,18,9,9,0.3
2020,CB2020,047,3,Brooklyn,30222003004,739,382,357,4.32
2020,CB2020,047,3,Brooklyn,30222003005,418,226,192,3.42
2020,CB2020,047,3,Brooklyn,30222003006,141,42,99,1.25
2020,CB2020,047,3,Brooklyn,30222003007,135,89,46,1.68
2020,CB2020,047,3,Brooklyn,30224001000,539,260,279,4.67
2020,CB2020,047,3,Brooklyn,30224001001,476,252,224,3.08
2020,CB2020,047,3,Brooklyn,30224001002,232,114,118,1.59
2020,CB2020,047,3,Brooklyn,30224002000,813,406,407,4.66
2020,CB2020,047,3,Brooklyn,30224002001,758,418,340,4.68
2020,CB2020,047,3,Brooklyn,30224003000,915,461,454,5.22
2020,CB2020,047,3,Brooklyn,30224003001,571,291,280,5.51
2020,CB2020,047,3,Brooklyn,30224004000,481,244,237,4.38
2020,CB2020,047,3,Brooklyn,30224004001,491,259,232,4.67
2020,CB2020,047,3,Brooklyn,30224004002,527,287,240,3.34
2020,CB2020,047,3,Brooklyn,30224004003,314,170,144,1.59
2020,CB2020,047,3,Brooklyn,30226001000,435,207,228,4.3
2020,CB2020,047,3,Brooklyn,30226001001,71,42,29,4.66
2020,CB2020,047,3,Brooklyn,30226001002,313,164,149,4.67
2020,CB2020,047,3,Brooklyn,30226001003,204,79,125,4.67
2020,CB2020,047,3,Brooklyn,30226001004,269,171,98,4.67
2020,CB2020,047,3,Brooklyn,30226001005,25,11,14,3.15
2020,CB2020,047,3,Brooklyn,30226001006,56,45,11,1.19
2020,CB2020,047,3,Brooklyn,30226002000,225,84,141,3.37
2020,CB2020,047,3,Brooklyn,30226002001,527,284,243,3.8
2020,CB2020,047,3,Brooklyn,30226002002,539,269,270,4.11
2020,CB2020,047,3,Brooklyn,30227001000,328,155,173,3.75
2020,CB2020,047,3,Brooklyn,30227001001,0,0,0,3.75
2020,CB2020,047,3,Brooklyn,30227001002,400,209,191,3
2020,CB2020,047,3,Brooklyn,30227001003,192,98,94,2.65
2020,CB2020,047,3,Brooklyn,30227002000,349,192,157,4.13
2020,CB2020,047,3,Brooklyn,30227002001,439,213,226,6.12
2020,CB2020,047,3,Brooklyn,30227002002,245,118,127,5.3
2020,CB2020,047,3,Brooklyn,30227002003,61,23,38,1.1
2020,CB2020,047,3,Brooklyn,30227003000,174,69,105,2.73
2020,CB2020,047,3,Brooklyn,30227003001,321,191,130,4.05
2020,CB2020,047,3,Brooklyn,30227003002,431,177,254,4.47
2020,CB2020,047,3,Brooklyn,30227004000,307,130,177,2.5
2020,CB2020,047,3,Brooklyn,30227004001,246,139,107,1.77
2020,CB2020,047,3,Brooklyn,30227004002,51,29,22,1.08
2020,CB2020,047,3,Brooklyn,30227004003,483,227,256,6.34
2020,CB2020,047,3,Brooklyn,30227004004,488,207,281,6.73
2020,CB2020,047,3,Brooklyn,30228001000,753,386,367,3.48
2020,CB2020,047,3,Brooklyn,30228001001,0,0,0,0.27
2020,CB2020,047,3,Brooklyn,30228001002,0,0,0,0.97
2020,CB2020,047,3,Brooklyn,30228001003,650,340,310,4.44
2020,CB2020,047,3,Brooklyn,30228002000,193,104,89,1.39
2020,CB2020,047,3,Brooklyn,30228002001,374,194,180,3.04
2020,CB2020,047,3,Brooklyn,30228002002,491,275,216,4.48
2020,CB2020,047,3,Brooklyn,30228002003,457,229,228,4.66
2020,CB2020,047,3,Brooklyn,30228003000,150,76,74,4.64
2020,CB2020,047,3,Brooklyn,30228003001,138,69,69,4.66
2020,CB2020,047,3,Brooklyn,30228003002,263,148,115,4.67
2020,CB2020,047,3,Brooklyn,30228003003,169,79,90,4.67
2020,CB2020,047,3,Brooklyn,30229001000,338,149,189,3.75
2020,CB2020,047,3,Brooklyn,30229001001,462,230,232,3.75
2020,CB2020,047,3,Brooklyn,30229002000,384,175,209,3.75
2020,CB2020,047,3,Brooklyn,30229002001,295,125,170,3.76
2020,CB2020,047,3,Brooklyn,30229002002,160,77,83,2.98
2020,CB2020,047,3,Brooklyn,30229002003,101,57,44,0.77
2020,CB2020,047,3,Brooklyn,30229003000,520,234,286,4.74
2020,CB2020,047,3,Brooklyn,30229003001,320,147,173,4.74
2020,CB2020,047,3,Brooklyn,30229004000,558,267,291,4.73
2020,CB2020,047,3,Brooklyn,30229004001,501,224,277,4.75
2020,CB2020,047,3,Brooklyn,30229004002,284,121,163,4.74
2020,CB2020,047,3,Brooklyn,30230001000,670,344,326,4.67
2020,CB2020,047,3,Brooklyn,30230001001,605,320,285,2.46
2020,CB2020,047,3,Brooklyn,30230001002,183,95,88,2.2
2020,CB2020,047,3,Brooklyn,30230001003,274,139,135,4.66
2020,CB2020,047,3,Brooklyn,30230002000,425,244,181,4.66
2020,CB2020,047,3,Brooklyn,30230002001,210,99,111,1.95
2020,CB2020,047,3,Brooklyn,30230002002,423,217,206,2.71
2020,CB2020,047,3,Brooklyn,30230003000,515,248,267,4.65
2020,CB2020,047,3,Brooklyn,30230003001,523,266,257,4.66
2020,CB2020,047,3,Brooklyn,30230003002,614,299,315,4.66
2020,CB2020,047,3,Brooklyn,30231001000,745,354,391,4.93
2020,CB2020,047,3,Brooklyn,30231001001,489,202,287,4.92
2020,CB2020,047,3,Brooklyn,30231002000,526,216,310,4.94
2020,CB2020,047,3,Brooklyn,30231002001,694,312,382,6.56
2020,CB2020,047,3,Brooklyn,30231002002,163,73,90,3.27
2020,CB2020,047,3,Brooklyn,30231002003,440,232,208,4.93
2020,CB2020,047,3,Brooklyn,30231003000,177,78,99,4.87
2020,CB2020,047,3,Brooklyn,30231003001,598,281,317,4.97
2020,CB2020,047,3,Brooklyn,30232001000,499,266,233,4.65
2020,CB2020,047,3,Brooklyn,30232001001,391,193,198,4.65
2020,CB2020,047,3,Brooklyn,30232001002,535,285,250,4.66
2020,CB2020,047,3,Brooklyn,30232002000,502,260,242,4.66
2020,CB2020,047,3,Brooklyn,30232002001,538,276,262,4.67
2020,CB2020,047,3,Brooklyn,30232002002,604,318,286,4.67
2020,CB2020,047,3,Brooklyn,30232003000,521,244,277,4.67
2020,CB2020,047,3,Brooklyn,30232003001,660,356,304,4.66
2020,CB2020,047,3,Brooklyn,30232004000,248,145,103,2.92
2020,CB2020,047,3,Brooklyn,30232004001,287,116,171,1.74
2020,CB2020,047,3,Brooklyn,30232004002,419,227,192,4.66
2020,CB2020,047,3,Brooklyn,30232005000,379,224,155,4.66
2020,CB2020,047,3,Brooklyn,30232005001,799,412,387,4.66
2020,CB2020,047,3,Brooklyn,30233001000,428,200,228,4.73
2020,CB2020,047,3,Brooklyn,30233001001,462,228,234,4.74
2020,CB2020,047,3,Brooklyn,30233001002,443,225,218,4.74
2020,CB2020,047,3,Brooklyn,30233002000,1472,617,855,5.49
2020,CB2020,047,3,Brooklyn,30233002001,1116,482,634,4.97
2020,CB2020,047,3,Brooklyn,30233003000,371,193,178,3.29
2020,CB2020,047,3,Brooklyn,30233003001,524,281,243,3.25
2020,CB2020,047,3,Brooklyn,30233003002,152,62,90,2.12
2020,CB2020,047,3,Brooklyn,30233003003,86,70,16,1.09
2020,CB2020,047,3,Brooklyn,30233003004,80,30,50,0.54
2020,CB2020,047,3,Brooklyn,30233003005,94,39,55,0.65
2020,CB2020,047,3,Brooklyn,30233003006,280,134,146,3.11
2020,CB2020,047,3,Brooklyn,30233003007,453,190,263,3.75
2020,CB2020,047,3,Brooklyn,30234001000,851,408,443,4.66
2020,CB2020,047,3,Brooklyn,30234001001,428,209,219,4.66
2020,CB2020,047,3,Brooklyn,30234001002,580,306,274,4.66
2020,CB2020,047,3,Brooklyn,30234002000,851,458,393,4.66
2020,CB2020,047,3,Brooklyn,30234002001,648,321,327,4.66
2020,CB2020,047,3,Brooklyn,30234002002,478,235,243,4.67
2020,CB2020,047,3,Brooklyn,30234003000,842,402,440,4.66
2020,CB2020,047,3,Brooklyn,30234003001,613,306,307,4.67
2020,CB2020,047,3,Brooklyn,30234003002,632,337,295,4.66
2020,CB2020,047,3,Brooklyn,30235001000,797,384,413,4.68
2020,CB2020,047,3,Brooklyn,30235001001,1053,572,481,4.51
2020,CB2020,047,3,Brooklyn,30235001002,289,133,156,6.47
2020,CB2020,047,3,Brooklyn,30235001003,952,445,507,4.2
2020,CB2020,047,3,Brooklyn,30235002000,842,451,391,3.56
2020,CB2020,047,3,Brooklyn,30235002001,1165,603,562,3.42
2020,CB2020,047,3,Brooklyn,30235002002,536,236,300,4.94
2020,CB2020,047,3,Brooklyn,30235002003,287,134,153,3.2
2020,CB2020,047,3,Brooklyn,30236001000,479,258,221,4.67
2020,CB2020,047,3,Brooklyn,30236001001,566,269,297,4.66
2020,CB2020,047,3,Brooklyn,30236001002,607,293,314,4.67
2020,CB2020,047,3,Brooklyn,30236002000,1059,490,569,4.66
2020,CB2020,047,3,Brooklyn,30236002001,916,468,448,4.66
2020,CB2020,047,3,Brooklyn,30236003000,527,280,247,4.68
2020,CB2020,047,3,Brooklyn,30236003001,991,480,511,4.66
2020,CB2020,047,3,Brooklyn,30236004000,422,213,209,4.65
2020,CB2020,047,3,Brooklyn,30236004001,981,512,469,4.66
2020,CB2020,047,3,Brooklyn,30238001000,708,338,370,4.66
2020,CB2020,047,3,Brooklyn,30238001001,354,172,182,3.98
2020,CB2020,047,3,Brooklyn,30238001002,550,267,283,5.36
2020,CB2020,047,3,Brooklyn,30238002000,980,501,479,4.66
2020,CB2020,047,3,Brooklyn,30238002001,468,246,222,4.65
2020,CB2020,047,3,Brooklyn,30238002002,741,352,389,4.68
2020,CB2020,047,3,Brooklyn,30238003000,470,246,224,4.67
2020,CB2020,047,3,Brooklyn,30238003001,547,272,275,4.65
2020,CB2020,047,3,Brooklyn,30238003002,596,285,311,4.68
2020,CB2020,047,3,Brooklyn,30240001000,705,336,369,4.66
2020,CB2020,047,3,Brooklyn,30240001001,696,341,355,4.67
2020,CB2020,047,3,Brooklyn,30240002000,0,0,0,0.72
2020,CB2020,047,3,Brooklyn,30240002001,92,40,52,1.48
2020,CB2020,047,3,Brooklyn,30240002002,172,89,83,2.26
2020,CB2020,047,3,Brooklyn,30240002003,234,128,106,2.41
2020,CB2020,047,3,Brooklyn,30240002004,237,115,122,3.17
2020,CB2020,047,3,Brooklyn,30240002005,474,217,257,4.66
2020,CB2020,047,3,Brooklyn,30240002006,498,251,247,4.65
2020,CB2020,047,3,Brooklyn,30240003000,575,290,285,3.96
2020,CB2020,047,3,Brooklyn,30240003001,577,298,279,4.66
2020,CB2020,047,3,Brooklyn,30240003002,905,434,471,4.67
2020,CB2020,047,3,Brooklyn,30241001000,126,74,52,3.48
2020,CB2020,047,3,Brooklyn,30241001001,33,14,19,3.36
2020,CB2020,047,3,Brooklyn,30241001002,114,49,65,3.35
2020,CB2020,047,3,Brooklyn,30241001003,275,142,133,3.56
2020,CB2020,047,3,Brooklyn,30241001004,765,391,374,4.67
2020,CB2020,047,3,Brooklyn,30241001005,575,303,272,4.43
2020,CB2020,047,3,Brooklyn,30241001006,60,20,40,8.97
2020,CB2020,047,3,Brooklyn,30241002000,476,221,255,4.7
2020,CB2020,047,3,Brooklyn,30241002001,170,74,96,1.63
2020,CB2020,047,3,Brooklyn,30241002002,581,260,321,6.37
2020,CB2020,047,3,Brooklyn,30242001000,413,214,199,5.21
2020,CB2020,047,3,Brooklyn,30242001001,383,169,214,5.4
2020,CB2020,047,3,Brooklyn,30242001002,189,100,89,4.85
2020,CB2020,047,3,Brooklyn,30242001003,35,20,15,1.65
2020,CB2020,047,3,Brooklyn,30242001004,15,4,11,3.29
2020,CB2020,047,3,Brooklyn,30242001005,438,295,143,5.4
2020,CB2020,047,3,Brooklyn,30242002000,126,73,53,1.64
2020,CB2020,047,3,Brooklyn,30242002001,32,7,25,1.01
2020,CB2020,047,3,Brooklyn,30242002002,381,208,173,4.7
2020,CB2020,047,3,Brooklyn,30242002003,412,188,224,4.86
2020,CB2020,047,3,Brooklyn,30242002004,504,255,249,4.64
2020,CB2020,047,3,Brooklyn,30242002005,361,180,181,4.66
2020,CB2020,047,3,Brooklyn,30243001000,423,206,217,3.31
2020,CB2020,047,3,Brooklyn,30243001001,398,177,221,3.04
2020,CB2020,047,3,Brooklyn,30243001002,733,340,393,6.36
2020,CB2020,047,3,Brooklyn,30243002000,775,367,408,6.35
2020,CB2020,047,3,Brooklyn,30243002001,629,311,318,6.36
2020,CB2020,047,3,Brooklyn,30243003000,497,236,261,6.35
2020,CB2020,047,3,Brooklyn,30243003001,892,389,503,6.36
2020,CB2020,047,3,Brooklyn,30244001000,483,250,233,4.84
2020,CB2020,047,3,Brooklyn,30244001001,465,242,223,4.85
2020,CB2020,047,3,Brooklyn,30244002000,462,240,222,4.64
2020,CB2020,047,3,Brooklyn,30244002001,539,253,286,4.8
2020,CB2020,047,3,Brooklyn,30244002002,341,181,160,4.76
2020,CB2020,047,3,Brooklyn,30244003000,390,204,186,4.68
2020,CB2020,047,3,Brooklyn,30244003001,481,264,217,4.89
2020,CB2020,047,3,Brooklyn,30244003002,490,248,242,4.92
2020,CB2020,047,3,Brooklyn,30245001000,508,243,265,6.36
2020,CB2020,047,3,Brooklyn,30245001001,467,238,229,6.36
2020,CB2020,047,3,Brooklyn,30245002000,835,393,442,6.35
2020,CB2020,047,3,Brooklyn,30245002001,803,374,429,6.35
2020,CB2020,047,3,Brooklyn,30245003000,789,377,412,6.35
2020,CB2020,047,3,Brooklyn,30245004000,354,195,159,2.55
2020,CB2020,047,3,Brooklyn,30245004001,356,163,193,4.96
2020,CB2020,047,3,Brooklyn,30245004002,145,61,84,1.96
2020,CB2020,047,3,Brooklyn,30246001000,368,180,188,4.56
2020,CB2020,047,3,Brooklyn,30246001001,434,232,202,4.89
2020,CB2020,047,3,Brooklyn,30246001002,307,152,155,4.89
2020,CB2020,047,3,Brooklyn,30246002000,467,251,216,4.67
2020,CB2020,047,3,Brooklyn,30246002001,446,204,242,4.65
2020,CB2020,047,3,Brooklyn,30246002002,277,130,147,4.71
2020,CB2020,047,3,Brooklyn,30246003000,415,226,189,4.67
2020,CB2020,047,3,Brooklyn,30246003001,399,202,197,4.83
2020,CB2020,047,3,Brooklyn,30246003002,323,165,158,4.84
2020,CB2020,047,3,Brooklyn,30247001000,37,17,20,4.87
2020,CB2020,047,3,Brooklyn,30247001001,438,179,259,4.89
2020,CB2020,047,3,Brooklyn,30247001002,572,262,310,7.02
2020,CB2020,047,3,Brooklyn,30247001003,549,275,274,7.08
2020,CB2020,047,3,Brooklyn,30247002000,490,245,245,6.61
2020,CB2020,047,3,Brooklyn,30247002001,37,22,15,3.1
2020,CB2020,047,3,Brooklyn,30247002002,87,51,36,1.64
2020,CB2020,047,3,Brooklyn,30247002003,51,18,33,0.56
2020,CB2020,047,3,Brooklyn,30247002004,271,147,124,6.45
2020,CB2020,047,3,Brooklyn,30247002005,288,106,182,2.19
2020,CB2020,047,3,Brooklyn,30248001000,304,148,156,4.56
2020,CB2020,047,3,Brooklyn,30248001001,285,134,151,4.53
2020,CB2020,047,3,Brooklyn,30248001002,139,78,61,2.12
2020,CB2020,047,3,Brooklyn,30248001003,363,183,180,2.08
2020,CB2020,047,3,Brooklyn,30248001004,68,42,26,2.73
2020,CB2020,047,3,Brooklyn,30248001005,157,59,98,2.39
2020,CB2020,047,3,Brooklyn,30248002000,20,5,15,5.18
2020,CB2020,047,3,Brooklyn,30248002001,145,78,67,5.19
2020,CB2020,047,3,Brooklyn,30248002002,0,0,0,2.1
2020,CB2020,047,3,Brooklyn,30248002003,238,113,125,3.1
2020,CB2020,047,3,Brooklyn,30248002004,514,227,287,4.79
2020,CB2020,047,3,Brooklyn,30248002005,414,202,212,4.73
2020,CB2020,047,3,Brooklyn,30249001000,639,298,341,5.7
2020,CB2020,047,3,Brooklyn,30249001001,478,222,256,5.71
2020,CB2020,047,3,Brooklyn,30249002000,737,322,415,5.71
2020,CB2020,047,3,Brooklyn,30249002001,646,325,321,5.7
2020,CB2020,047,3,Brooklyn,30249003000,760,324,436,5.71
2020,CB2020,047,3,Brooklyn,30249003001,497,210,287,5.69
2020,CB2020,047,3,Brooklyn,30249004000,282,164,118,3.55
2020,CB2020,047,3,Brooklyn,30249004001,225,96,129,3.87
2020,CB2020,047,3,Brooklyn,30250001000,0,0,0,4
2020,CB2020,047,3,Brooklyn,30250001001,98,46,52,4.54
2020,CB2020,047,3,Brooklyn,30250001002,45,13,32,4.68
2020,CB2020,047,3,Brooklyn,30250001003,31,21,10,3.18
2020,CB2020,047,3,Brooklyn,30250001004,74,25,49,2.45
2020,CB2020,047,3,Brooklyn,30250001005,52,41,11,1.83
2020,CB2020,047,3,Brooklyn,30250001006,206,114,92,2.81
2020,CB2020,047,3,Brooklyn,30250001007,355,174,181,5.01
2020,CB2020,047,3,Brooklyn,30250002000,66,32,34,1.79
2020,CB2020,047,3,Brooklyn,30250002001,0,0,0,0.88
2020,CB2020,047,3,Brooklyn,30250002002,240,122,118,3.68
2020,CB2020,047,3,Brooklyn,30250002003,252,142,110,5.02
2020,CB2020,047,3,Brooklyn,30250002004,90,51,39,0.92
2020,CB2020,047,3,Brooklyn,30250002005,239,98,141,2.08
2020,CB2020,047,3,Brooklyn,30251001000,486,232,254,5.69
2020,CB2020,047,3,Brooklyn,30251001001,763,342,421,5.71
2020,CB2020,047,3,Brooklyn,30251002000,559,215,344,5.7
2020,CB2020,047,3,Brooklyn,30251002001,954,427,527,5.71
2020,CB2020,047,3,Brooklyn,30251003000,987,481,506,5.71
2020,CB2020,047,3,Brooklyn,30251003001,460,232,228,5.7
2020,CB2020,047,3,Brooklyn,30252001000,449,206,243,4.84
2020,CB2020,047,3,Brooklyn,30252001001,324,175,149,4.8
2020,CB2020,047,3,Brooklyn,30252002000,574,282,292,5.2
2020,CB2020,047,3,Brooklyn,30252002001,1002,459,543,6.32
2020,CB2020,047,3,Brooklyn,30252003000,512,258,254,5.6
2020,CB2020,047,3,Brooklyn,30252003001,203,100,103,1.92
2020,CB2020,047,3,Brooklyn,30252003002,191,100,91,1.78
2020,CB2020,047,3,Brooklyn,30252003003,183,74,109,1.73
2020,CB2020,047,3,Brooklyn,30252003004,193,98,95,1.83
2020,CB2020,047,3,Brooklyn,30252004000,1187,604,583,5.59
2020,CB2020,047,3,Brooklyn,30252004001,482,250,232,5.18
2020,CB2020,047,3,Brooklyn,30253001000,864,426,438,5.77
2020,CB2020,047,3,Brooklyn,30253001001,698,316,382,5.72
2020,CB2020,047,3,Brooklyn,30253002000,591,273,318,5.7
2020,CB2020,047,3,Brooklyn,30253002001,708,356,352,5.7
2020,CB2020,047,3,Brooklyn,30253003000,348,156,192,3.4
2020,CB2020,047,3,Brooklyn,30253003001,154,88,66,2.3
2020,CB2020,047,3,Brooklyn,30253003002,0,0,0,5.7
2020,CB2020,047,3,Brooklyn,30253003003,154,89,65,5.7
2020,CB2020,047,3,Brooklyn,30254001000,437,194,243,4.72
2020,CB2020,047,3,Brooklyn,30254001001,360,155,205,4.71
2020,CB2020,047,3,Brooklyn,30254001002,306,157,149,5.26
2020,CB2020,047,3,Brooklyn,30254002000,506,243,263,4.65
2020,CB2020,047,3,Brooklyn,30254002001,223,107,116,3.04
2020,CB2020,047,3,Brooklyn,30254002002,71,36,35,1.62
2020,CB2020,047,3,Brooklyn,30254002003,385,206,179,5.05
2020,CB2020,047,3,Brooklyn,30254003000,339,149,190,4.63
2020,CB2020,047,3,Brooklyn,30254003001,182,65,117,2.33
2020,CB2020,047,3,Brooklyn,30254003002,195,118,77,2.33
2020,CB2020,047,3,Brooklyn,30254003003,646,338,308,5.03
2020,CB2020,047,3,Brooklyn,30255001000,2742,1092,1650,17.12
2020,CB2020,047,3,Brooklyn,30255002000,2057,841,1216,17.14
2020,CB2020,047,3,Brooklyn,30256001000,251,118,133,3.53
2020,CB2020,047,3,Brooklyn,30256001001,308,149,159,4.64
2020,CB2020,047,3,Brooklyn,30256001002,348,152,196,4.64
2020,CB2020,047,3,Brooklyn,30256001003,262,136,126,4.66
2020,CB2020,047,3,Brooklyn,30256001004,220,98,122,4.7
2020,CB2020,047,3,Brooklyn,30256001005,88,49,39,1.33
2020,CB2020,047,3,Brooklyn,30256002000,428,222,206,5.02
2020,CB2020,047,3,Brooklyn,30256002001,367,142,225,4.65
2020,CB2020,047,3,Brooklyn,30256002002,672,325,347,4.66
2020,CB2020,047,3,Brooklyn,30256002003,422,210,212,4.99
2020,CB2020,047,3,Brooklyn,30257001000,542,294,248,4.94
2020,CB2020,047,3,Brooklyn,30257001001,146,74,72,4.95
2020,CB2020,047,3,Brooklyn,30257001002,257,138,119,4.94
2020,CB2020,047,3,Brooklyn,30257001003,704,346,358,5.04
2020,CB2020,047,3,Brooklyn,30257002000,221,118,103,2.25
2020,CB2020,047,3,Brooklyn,30257002001,283,161,122,2.79
2020,CB2020,047,3,Brooklyn,30257003000,364,187,177,4.97
2020,CB2020,047,3,Brooklyn,30257003001,16,12,4,4.96
2020,CB2020,047,3,Brooklyn,30257003002,34,26,8,4.95
2020,CB2020,047,3,Brooklyn,30257003003,255,133,122,4.97
2020,CB2020,047,3,Brooklyn,30258001000,568,251,317,4.73
2020,CB2020,047,3,Brooklyn,30258001001,399,183,216,4.69
2020,CB2020,047,3,Brooklyn,30258001002,586,304,282,4.71
2020,CB2020,047,3,Brooklyn,30258002000,714,364,350,4.65
2020,CB2020,047,3,Brooklyn,30258002001,610,310,300,4.65
2020,CB2020,047,3,Brooklyn,30258002002,471,230,241,4.66
2020,CB2020,047,3,Brooklyn,30258003000,736,364,372,4.66
2020,CB2020,047,3,Brooklyn,30258003001,528,258,270,4.65
2020,CB2020,047,3,Brooklyn,30258003002,461,222,239,4.66
2020,CB2020,047,3,Brooklyn,30259011000,589,259,330,4.99
2020,CB2020,047,3,Brooklyn,30259011001,769,390,379,4.99
2020,CB2020,047,3,Brooklyn,30259011002,258,112,146,4.93
2020,CB2020,047,3,Brooklyn,30259011003,712,332,380,4.92
2020,CB2020,047,3,Brooklyn,30259021000,3560,1476,2084,14.73
2020,CB2020,047,3,Brooklyn,30260001000,376,171,205,4.45
2020,CB2020,047,3,Brooklyn,30260001001,408,220,188,4.43
2020,CB2020,047,3,Brooklyn,30260001002,481,210,271,4.4
2020,CB2020,047,3,Brooklyn,30260002000,472,221,251,4.38
2020,CB2020,047,3,Brooklyn,30260002001,460,224,236,4.36
2020,CB2020,047,3,Brooklyn,30260003000,326,151,175,3.42
2020,CB2020,047,3,Brooklyn,30260003001,399,215,184,4.9
2020,CB2020,047,3,Brooklyn,30260003002,326,164,162,4.93
2020,CB2020,047,3,Brooklyn,30260003003,408,218,190,4.96
2020,CB2020,047,3,Brooklyn,30261001000,792,375,417,4.93
2020,CB2020,047,3,Brooklyn,30261001001,565,262,303,4.92
2020,CB2020,047,3,Brooklyn,30261002000,318,155,163,2.98
2020,CB2020,047,3,Brooklyn,30261002001,310,143,167,1.95
2020,CB2020,047,3,Brooklyn,30261002002,551,273,278,4.93
2020,CB2020,047,3,Brooklyn,30261003000,634,276,358,4.92
2020,CB2020,047,3,Brooklyn,30261003001,761,326,435,4.93
2020,CB2020,047,3,Brooklyn,30261004000,310,151,159,2.57
2020,CB2020,047,3,Brooklyn,30261004001,485,196,289,2.36
2020,CB2020,047,3,Brooklyn,30261004002,491,236,255,4.93
2020,CB2020,047,3,Brooklyn,30261005000,580,285,295,4.93
2020,CB2020,047,3,Brooklyn,30261005001,682,332,350,4.92
2020,CB2020,047,3,Brooklyn,30262001000,287,143,144,1.92
2020,CB2020,047,3,Brooklyn,30262001001,339,182,157,3.1
2020,CB2020,047,3,Brooklyn,30262001002,273,139,134,5.18
2020,CB2020,047,3,Brooklyn,30262001003,234,115,119,3.11
2020,CB2020,047,3,Brooklyn,30262001004,323,161,162,5.19
2020,CB2020,047,3,Brooklyn,30262002000,85,37,48,0.58
2020,CB2020,047,3,Brooklyn,30262002001,90,50,40,0.95
2020,CB2020,047,3,Brooklyn,30262002002,0,0,0,1.61
2020,CB2020,047,3,Brooklyn,30262002003,101,33,68,0.85
2020,CB2020,047,3,Brooklyn,30262002004,0,0,0,0.87
2020,CB2020,047,3,Brooklyn,30262002005,346,176,170,5.2
2020,CB2020,047,3,Brooklyn,30262002006,310,144,166,5.17
2020,CB2020,047,3,Brooklyn,30262002007,338,170,168,5.28
2020,CB2020,047,3,Brooklyn,30263001000,457,218,239,4.9
2020,CB2020,047,3,Brooklyn,30263001001,0,0,0,9.87
2020,CB2020,047,3,Brooklyn,30263001002,462,226,236,4.94
2020,CB2020,047,3,Brooklyn,30263001003,381,192,189,4.92
2020,CB2020,047,3,Brooklyn,30263001004,788,329,459,4.93
2020,CB2020,047,3,Brooklyn,30264001000,489,252,237,4.96
2020,CB2020,047,3,Brooklyn,30264001001,362,159,203,5.02
2020,CB2020,047,3,Brooklyn,30264002000,674,334,340,5.02
2020,CB2020,047,3,Brooklyn,30264002001,452,190,262,5.43
2020,CB2020,047,3,Brooklyn,30264003000,435,251,184,3.46
2020,CB2020,047,3,Brooklyn,30264003001,280,161,119,1.99
2020,CB2020,047,3,Brooklyn,30264003002,669,314,355,5.08
2020,CB2020,047,3,Brooklyn,30264003003,285,144,141,2.12
2020,CB2020,047,3,Brooklyn,30264003004,49,15,34,1.36
2020,CB2020,047,3,Brooklyn,30264003005,26,5,21,0.63
2020,CB2020,047,3,Brooklyn,30264004000,365,179,186,4.55
2020,CB2020,047,3,Brooklyn,30264004001,547,281,266,4.03
2020,CB2020,047,3,Brooklyn,30264004002,470,276,194,3.15
2020,CB2020,047,3,Brooklyn,30265001000,723,331,392,4.93
2020,CB2020,047,3,Brooklyn,30265001001,563,255,308,4.93
2020,CB2020,047,3,Brooklyn,30265002000,634,304,330,4.94
2020,CB2020,047,3,Brooklyn,30265002001,616,262,354,4.93
2020,CB2020,047,3,Brooklyn,30265003000,549,238,311,4.92
2020,CB2020,047,3,Brooklyn,30265003001,531,253,278,4.92
2020,CB2020,047,3,Brooklyn,30265004000,636,302,334,4.93
2020,CB2020,047,3,Brooklyn,30265004001,133,55,78,4.93
2020,CB2020,047,3,Brooklyn,30266001000,383,165,218,4.72
2020,CB2020,047,3,Brooklyn,30266001001,411,220,191,4.7
2020,CB2020,047,3,Brooklyn,30266001002,512,263,249,4.65
2020,CB2020,047,3,Brooklyn,30266002000,490,236,254,4.65
2020,CB2020,047,3,Brooklyn,30266002001,461,208,253,4.66
2020,CB2020,047,3,Brooklyn,30266002002,600,293,307,4.65
2020,CB2020,047,3,Brooklyn,30266003000,361,153,208,4.33
2020,CB2020,047,3,Brooklyn,30266003001,351,171,180,4.33
2020,CB2020,047,3,Brooklyn,30266003002,392,196,196,4.31
2020,CB2020,047,3,Brooklyn,30267001000,511,252,259,4.93
2020,CB2020,047,3,Brooklyn,30267001001,521,241,280,4.93
2020,CB2020,047,3,Brooklyn,30267002000,570,232,338,4.92
2020,CB2020,047,3,Brooklyn,30267002001,451,244,207,4.93
2020,CB2020,047,3,Brooklyn,30267003000,356,131,225,2.78
2020,CB2020,047,3,Brooklyn,30267003001,521,245,276,4.93
2020,CB2020,047,3,Brooklyn,30267003002,210,117,93,2.15
2020,CB2020,047,3,Brooklyn,30267004000,505,230,275,4.93
2020,CB2020,047,3,Brooklyn,30267004001,583,266,317,4.93
2020,CB2020,047,3,Brooklyn,30268001000,465,227,238,4.72
2020,CB2020,047,3,Brooklyn,30268001001,789,396,393,5.07
2020,CB2020,047,3,Brooklyn,30268002000,275,132,143,2.75
2020,CB2020,047,3,Brooklyn,30268002001,251,111,140,2.27
2020,CB2020,047,3,Brooklyn,30268002002,165,95,70,2.35
2020,CB2020,047,3,Brooklyn,30268002003,279,124,155,2.72
2020,CB2020,047,3,Brooklyn,30268003000,481,265,216,4.65
2020,CB2020,047,3,Brooklyn,30268003001,397,184,213,5
2020,CB2020,047,3,Brooklyn,30268003002,339,188,151,2.26
2020,CB2020,047,3,Brooklyn,30268003003,281,116,165,2.76
2020,CB2020,047,3,Brooklyn,30268004000,506,245,261,4.64
2020,CB2020,047,3,Brooklyn,30268004001,458,238,220,5.02
2020,CB2020,047,3,Brooklyn,30269001000,454,208,246,4.92
2020,CB2020,047,3,Brooklyn,30269001001,472,242,230,4.9
2020,CB2020,047,3,Brooklyn,30269002000,536,269,267,4.92
2020,CB2020,047,3,Brooklyn,30269002001,373,171,202,3.39
2020,CB2020,047,3,Brooklyn,30269003000,0,0,0,4.93
2020,CB2020,047,3,Brooklyn,30269003001,697,319,378,4.91
2020,CB2020,047,3,Brooklyn,30269003002,473,227,246,5.12
2020,CB2020,047,3,Brooklyn,30270001000,299,140,159,4.86
2020,CB2020,047,3,Brooklyn,30270001001,495,248,247,4.72
2020,CB2020,047,3,Brooklyn,30270001002,623,296,327,4.71
2020,CB2020,047,3,Brooklyn,30270002000,353,134,219,4.67
2020,CB2020,047,3,Brooklyn,30270002001,390,181,209,4.73
2020,CB2020,047,3,Brooklyn,30270002002,280,150,130,4.71
2020,CB2020,047,3,Brooklyn,30270002003,279,146,133,4.72
2020,CB2020,047,3,Brooklyn,30271001000,151,79,72,6.95
2020,CB2020,047,3,Brooklyn,30271001001,928,443,485,6.95
2020,CB2020,047,3,Brooklyn,30271001002,0,0,0,4.63
2020,CB2020,047,3,Brooklyn,30271001003,341,157,184,2.45
2020,CB2020,047,3,Brooklyn,30271001004,451,211,240,4.87
2020,CB2020,047,3,Brooklyn,30271001005,56,29,27,2.33
2020,CB2020,047,3,Brooklyn,30271001006,293,149,144,2.53
2020,CB2020,047,3,Brooklyn,30271002000,6,5,1,13.31
2020,CB2020,047,3,Brooklyn,30271002001,525,212,313,4.05
2020,CB2020,047,3,Brooklyn,30271002002,533,254,279,5.67
2020,CB2020,047,3,Brooklyn,30271002003,209,89,120,6.89
2020,CB2020,047,3,Brooklyn,30272001000,485,245,240,4.65
2020,CB2020,047,3,Brooklyn,30272001001,631,300,331,4.73
2020,CB2020,047,3,Brooklyn,30272002000,798,431,367,4.65
2020,CB2020,047,3,Brooklyn,30272002001,579,300,279,4.64
2020,CB2020,047,3,Brooklyn,30272003000,295,162,133,4.65
2020,CB2020,047,3,Brooklyn,30272003001,363,165,198,4.66
2020,CB2020,047,3,Brooklyn,30272003002,482,218,264,4.66
2020,CB2020,047,3,Brooklyn,30273001000,447,212,235,5.09
2020,CB2020,047,3,Brooklyn,30273001001,289,134,155,4.92
2020,CB2020,047,3,Brooklyn,30273002000,92,41,51,4.68
2020,CB2020,047,3,Brooklyn,30273002001,64,28,36,0.41
2020,CB2020,047,3,Brooklyn,30273002002,518,256,262,4.93
2020,CB2020,047,3,Brooklyn,30273003000,361,167,194,3.47
2020,CB2020,047,3,Brooklyn,30273003001,310,110,200,2.49
2020,CB2020,047,3,Brooklyn,30273003002,349,156,193,4.16
2020,CB2020,047,3,Brooklyn,30273003003,81,28,53,0.93
2020,CB2020,047,3,Brooklyn,30273003004,620,284,336,5.59
2020,CB2020,047,3,Brooklyn,30273003005,0,0,0,0.33
2020,CB2020,047,3,Brooklyn,30274001000,192,91,101,4.65
2020,CB2020,047,3,Brooklyn,30274001001,414,201,213,4.63
2020,CB2020,047,3,Brooklyn,30274001002,381,180,201,4.66
2020,CB2020,047,3,Brooklyn,30274001003,276,124,152,4.66
2020,CB2020,047,3,Brooklyn,30274002000,380,194,186,4.59
2020,CB2020,047,3,Brooklyn,30274002001,187,86,101,2.42
2020,CB2020,047,3,Brooklyn,30274002002,165,93,72,2.15
2020,CB2020,047,3,Brooklyn,30274002003,518,253,265,4.23
2020,CB2020,047,3,Brooklyn,30274002004,306,145,161,4.18
2020,CB2020,047,3,Brooklyn,30274002005,453,233,220,4.19
2020,CB2020,047,3,Brooklyn,30275001000,147,100,47,5.08
2020,CB2020,047,3,Brooklyn,30275001001,628,257,371,4.92
2020,CB2020,047,3,Brooklyn,30275002000,367,172,195,2.98
2020,CB2020,047,3,Brooklyn,30275002001,235,102,133,2.11
2020,CB2020,047,3,Brooklyn,30275002002,360,162,198,2.67
2020,CB2020,047,3,Brooklyn,30275002003,258,131,127,2.26
2020,CB2020,047,3,Brooklyn,30275003000,459,216,243,5.08
2020,CB2020,047,3,Brooklyn,30275003001,522,249,273,4.93
2020,CB2020,047,3,Brooklyn,30275004000,609,271,338,5.09
2020,CB2020,047,3,Brooklyn,30275004001,486,258,228,4.94
2020,CB2020,047,3,Brooklyn,30276001000,692,344,348,5.09
2020,CB2020,047,3,Brooklyn,30276001001,700,335,365,5.12
2020,CB2020,047,3,Brooklyn,30276002000,707,354,353,5
2020,CB2020,047,3,Brooklyn,30276002001,490,239,251,4.16
2020,CB2020,047,3,Brooklyn,30276003000,560,271,289,4.24
2020,CB2020,047,3,Brooklyn,30276003001,524,269,255,4.14
2020,CB2020,047,3,Brooklyn,30276003002,149,86,63,7.24
2020,CB2020,047,3,Brooklyn,30276003003,64,36,28,1.92
2020,CB2020,047,3,Brooklyn,30277001000,765,324,441,5.09
2020,CB2020,047,3,Brooklyn,30277001001,678,269,409,5.08
2020,CB2020,047,3,Brooklyn,30277002000,501,233,268,5.09
2020,CB2020,047,3,Brooklyn,30277002001,484,227,257,5.08
2020,CB2020,047,3,Brooklyn,30277003000,0,0,0,4.93
2020,CB2020,047,3,Brooklyn,30277003001,570,294,276,4.93
2020,CB2020,047,3,Brooklyn,30277004000,674,265,409,4.94
2020,CB2020,047,3,Brooklyn,30277004001,679,291,388,4.92
2020,CB2020,047,3,Brooklyn,30278001000,538,268,270,4.1
2020,CB2020,047,3,Brooklyn,30278001001,653,285,368,4.15
2020,CB2020,047,3,Brooklyn,30278001002,194,90,104,4.29
2020,CB2020,047,3,Brooklyn,30278001003,412,195,217,4.42
2020,CB2020,047,3,Brooklyn,30278002000,38,21,17,1.44
2020,CB2020,047,3,Brooklyn,30278002001,320,159,161,3.48
2020,CB2020,047,3,Brooklyn,30278002002,328,148,180,6.03
2020,CB2020,047,3,Brooklyn,30278002003,648,341,307,5.82
2020,CB2020,047,3,Brooklyn,30278002004,411,178,233,5.93
2020,CB2020,047,3,Brooklyn,30279001000,472,217,255,5.09
2020,CB2020,047,3,Brooklyn,30279001001,563,268,295,4.93
2020,CB2020,047,3,Brooklyn,30279002000,488,256,232,5.06
2020,CB2020,047,3,Brooklyn,30279002001,424,168,256,4.91
2020,CB2020,047,3,Brooklyn,30279003000,468,220,248,5.09
2020,CB2020,047,3,Brooklyn,30279003001,441,209,232,4.92
2020,CB2020,047,3,Brooklyn,30279004000,391,196,195,5.07
2020,CB2020,047,3,Brooklyn,30279004001,427,198,229,4.93
2020,CB2020,047,3,Brooklyn,30280000001,0,0,0,0
2020,CB2020,047,3,Brooklyn,30280001000,327,166,161,5.75
2020,CB2020,047,3,Brooklyn,30280001001,421,194,227,5.53
2020,CB2020,047,3,Brooklyn,30280001002,0,0,0,1.1
2020,CB2020,047,3,Brooklyn,30280001003,0,0,0,0.52
2020,CB2020,047,3,Brooklyn,30280001004,0,0,0,1.5
2020,CB2020,047,3,Brooklyn,30280002000,50,30,20,2.32
2020,CB2020,047,3,Brooklyn,30280002001,79,47,32,4.21
2020,CB2020,047,3,Brooklyn,30280002002,325,147,178,3.31
2020,CB2020,047,3,Brooklyn,30280002003,351,187,164,3.47
2020,CB2020,047,3,Brooklyn,30280002004,207,118,89,4.01
2020,CB2020,047,3,Brooklyn,30280002005,102,54,48,2.81
2020,CB2020,047,3,Brooklyn,30281001000,551,280,271,5.08
2020,CB2020,047,3,Brooklyn,30281001001,777,338,439,3.56
2020,CB2020,047,3,Brooklyn,30281001002,375,146,229,1.51
2020,CB2020,047,3,Brooklyn,30281002000,702,279,423,5.08
2020,CB2020,047,3,Brooklyn,30281002001,522,255,267,5.07
2020,CB2020,047,3,Brooklyn,30281003000,204,115,89,4.92
2020,CB2020,047,3,Brooklyn,30281003001,538,256,282,2.83
2020,CB2020,047,3,Brooklyn,30281003002,316,159,157,2.1
2020,CB2020,047,3,Brooklyn,30281003003,537,279,258,4.93
2020,CB2020,047,3,Brooklyn,30281003004,278,116,162,4.92
2020,CB2020,047,3,Brooklyn,30282000001,0,0,0,0
2020,CB2020,047,3,Brooklyn,30282001000,408,192,216,5.6
2020,CB2020,047,3,Brooklyn,30282001001,286,154,132,5.47
2020,CB2020,047,3,Brooklyn,30282001002,846,412,434,5.65
2020,CB2020,047,3,Brooklyn,30282001003,0,0,0,2.11
2020,CB2020,047,3,Brooklyn,30282001004,0,0,0,0.8
2020,CB2020,047,3,Brooklyn,30282001005,0,0,0,2.17
2020,CB2020,047,3,Brooklyn,30282002000,196,115,81,3.31
2020,CB2020,047,3,Brooklyn,30282002001,0,0,0,3.16
2020,CB2020,047,3,Brooklyn,30282002002,422,205,217,3.34
2020,CB2020,047,3,Brooklyn,30282002003,485,236,249,3.48
2020,CB2020,047,3,Brooklyn,30282003000,171,73,98,3.29
2020,CB2020,047,3,Brooklyn,30282003001,468,215,253,3.48
2020,CB2020,047,3,Brooklyn,30283001000,841,400,441,5.12
2020,CB2020,047,3,Brooklyn,30283001001,420,202,218,4.96
2020,CB2020,047,3,Brooklyn,30283002000,779,342,437,5.09
2020,CB2020,047,3,Brooklyn,30283002001,527,262,265,4.92
2020,CB2020,047,3,Brooklyn,30283003000,572,252,320,5.09
2020,CB2020,047,3,Brooklyn,30283003001,794,361,433,4.93
2020,CB2020,047,3,Brooklyn,30284001000,508,243,265,4.65
2020,CB2020,047,3,Brooklyn,30284001001,763,356,407,4.65
2020,CB2020,047,3,Brooklyn,30284002000,553,258,295,4.66
2020,CB2020,047,3,Brooklyn,30284002001,614,307,307,4.66
2020,CB2020,047,3,Brooklyn,30284002002,301,166,135,5.02
2020,CB2020,047,3,Brooklyn,30284003000,613,323,290,5.83
2020,CB2020,047,3,Brooklyn,30284003001,597,337,260,5.5
2020,CB2020,047,3,Brooklyn,30284003002,447,218,229,5.63
2020,CB2020,047,3,Brooklyn,30285011000,138,77,61,14.8
2020,CB2020,047,3,Brooklyn,30285011001,445,246,199,3.67
2020,CB2020,047,3,Brooklyn,30285011002,53,25,28,2.09
2020,CB2020,047,3,Brooklyn,30285021000,1388,576,812,15.03
2020,CB2020,047,3,Brooklyn,30285021001,1270,515,755,14.59
2020,CB2020,047,3,Brooklyn,30286000001,0,0,0,0
2020,CB2020,047,3,Brooklyn,30286000002,0,0,0,0
2020,CB2020,047,3,Brooklyn,30286001000,1315,679,636,5.05
2020,CB2020,047,3,Brooklyn,30286001001,26,14,12,1.99
2020,CB2020,047,3,Brooklyn,30286001002,0,0,0,0.72
2020,CB2020,047,3,Brooklyn,30286001003,0,0,0,1.92
2020,CB2020,047,3,Brooklyn,30286002000,1334,679,655,5.83
2020,CB2020,047,3,Brooklyn,30286003000,1184,617,567,5.18
2020,CB2020,047,3,Brooklyn,30286004000,269,150,119,3.48
2020,CB2020,047,3,Brooklyn,30286004001,287,123,164,3.34
2020,CB2020,047,3,Brooklyn,30286004002,411,219,192,3.49
2020,CB2020,047,3,Brooklyn,30286005000,417,195,222,4.17
2020,CB2020,047,3,Brooklyn,30286005001,375,208,167,4.1
2020,CB2020,047,3,Brooklyn,30286005002,476,224,252,4.37
2020,CB2020,047,3,Brooklyn,30287001000,86,53,33,2.27
2020,CB2020,047,3,Brooklyn,30287001001,217,125,92,3.64
2020,CB2020,047,3,Brooklyn,30287001002,87,43,44,2.81
2020,CB2020,047,3,Brooklyn,30287001003,0,0,0,0.3
2020,CB2020,047,3,Brooklyn,30287001004,192,94,98,1.82
2020,CB2020,047,3,Brooklyn,30287001005,424,197,227,5.09
2020,CB2020,047,3,Brooklyn,30287001006,202,116,86,2.21
2020,CB2020,047,3,Brooklyn,30287002000,304,159,145,3.51
2020,CB2020,047,3,Brooklyn,30287002001,82,42,40,0.65
2020,CB2020,047,3,Brooklyn,30287002002,150,65,85,4.44
2020,CB2020,047,3,Brooklyn,30287003000,410,246,164,4.94
2020,CB2020,047,3,Brooklyn,30287003001,274,117,157,0.66
2020,CB2020,047,3,Brooklyn,30287003002,675,261,414,4.42
2020,CB2020,047,3,Brooklyn,30288001000,318,151,167,4.65
2020,CB2020,047,3,Brooklyn,30288001001,381,184,197,4.65
2020,CB2020,047,3,Brooklyn,30288001002,397,194,203,4.65
2020,CB2020,047,3,Brooklyn,30288002000,968,446,522,4.66
2020,CB2020,047,3,Brooklyn,30288002001,348,211,137,5
2020,CB2020,047,3,Brooklyn,30288003000,500,278,222,4.77
2020,CB2020,047,3,Brooklyn,30288003001,477,249,228,4.6
2020,CB2020,047,3,Brooklyn,30288003002,511,260,251,4.78
2020,CB2020,047,3,Brooklyn,30289001000,209,161,48,2.04
2020,CB2020,047,3,Brooklyn,30289001001,324,156,168,3.41
2020,CB2020,047,3,Brooklyn,30289001002,314,136,178,4.84
2020,CB2020,047,3,Brooklyn,30289001003,0,0,0,0.19
2020,CB2020,047,3,Brooklyn,30289002000,679,315,364,5.08
2020,CB2020,047,3,Brooklyn,30289002001,414,214,200,5.08
2020,CB2020,047,3,Brooklyn,30289003000,501,222,279,5.08
2020,CB2020,047,3,Brooklyn,30289003001,226,115,111,5.07
2020,CB2020,047,3,Brooklyn,30289004000,658,299,359,5.08
2020,CB2020,047,3,Brooklyn,30289004001,608,244,364,5.07
2020,CB2020,047,3,Brooklyn,30290001000,605,283,322,4.72
2020,CB2020,047,3,Brooklyn,30290001001,560,266,294,4.71
2020,CB2020,047,3,Brooklyn,30290002000,577,274,303,4.72
2020,CB2020,047,3,Brooklyn,30290002001,783,395,388,4.71
2020,CB2020,047,3,Brooklyn,30290003000,313,157,156,4.99
2020,CB2020,047,3,Brooklyn,30290003001,426,197,229,4.75
2020,CB2020,047,3,Brooklyn,30290003002,539,255,284,4.61
2020,CB2020,047,3,Brooklyn,30290003003,574,273,301,5.02
2020,CB2020,047,3,Brooklyn,30291001000,250,117,133,10.17
2020,CB2020,047,3,Brooklyn,30291001001,426,222,204,5.09
2020,CB2020,047,3,Brooklyn,30291001002,425,210,215,5.08
2020,CB2020,047,3,Brooklyn,30291002000,649,305,344,5.08
2020,CB2020,047,3,Brooklyn,30291002001,397,184,213,5.11
2020,CB2020,047,3,Brooklyn,30291003000,357,163,194,5.08
2020,CB2020,047,3,Brooklyn,30291003001,538,236,302,5.07
2020,CB2020,047,3,Brooklyn,30292000001,0,0,0,0
2020,CB2020,047,3,Brooklyn,30292001000,358,195,163,4.47
2020,CB2020,047,3,Brooklyn,30292001001,436,201,235,4.39
2020,CB2020,047,3,Brooklyn,30292001002,696,334,362,4.83
2020,CB2020,047,3,Brooklyn,30292002000,394,182,212,3.43
2020,CB2020,047,3,Brooklyn,30292002001,344,137,207,3.38
2020,CB2020,047,3,Brooklyn,30292002002,426,248,178,3.71
2020,CB2020,047,3,Brooklyn,30292002003,127,62,65,1.17
2020,CB2020,047,3,Brooklyn,30292003000,0,0,0,11.62
2020,CB2020,047,3,Brooklyn,30292003001,0,0,0,0.21
2020,CB2020,047,3,Brooklyn,30292003002,0,0,0,1.92
2020,CB2020,047,3,Brooklyn,30292003003,0,0,0,11.67
2020,CB2020,047,3,Brooklyn,30293001000,552,229,323,5.07
2020,CB2020,047,3,Brooklyn,30293001001,144,78,66,5.08
2020,CB2020,047,3,Brooklyn,30293002000,198,81,117,5.09
2020,CB2020,047,3,Brooklyn,30293002001,673,281,392,5.09
2020,CB2020,047,3,Brooklyn,30293003000,471,223,248,5.09
2020,CB2020,047,3,Brooklyn,30293003001,467,203,264,5.08
2020,CB2020,047,3,Brooklyn,30293004000,455,194,261,5.07
2020,CB2020,047,3,Brooklyn,30293004001,442,204,238,5.07
2020,CB2020,047,3,Brooklyn,30294000001,0,0,0,0
2020,CB2020,047,3,Brooklyn,30294001000,418,198,220,3.82
2020,CB2020,047,3,Brooklyn,30294001001,495,255,240,3.73
2020,CB2020,047,3,Brooklyn,30294001002,380,215,165,4
2020,CB2020,047,3,Brooklyn,30294001003,985,421,564,11.23
2020,CB2020,047,3,Brooklyn,30294001004,0,0,0,0.43
2020,CB2020,047,3,Brooklyn,30294001005,0,0,0,1.3
2020,CB2020,047,3,Brooklyn,30294001006,0,0,0,1.73
2020,CB2020,047,3,Brooklyn,30294001007,0,0,0,0.79
2020,CB2020,047,3,Brooklyn,30294001008,20,13,7,1.81
2020,CB2020,047,3,Brooklyn,30294001009,0,0,0,6.77
2020,CB2020,047,3,Brooklyn,30294001010,0,0,0,11.02
2020,CB2020,047,3,Brooklyn,30295001000,502,222,280,5.09
2020,CB2020,047,3,Brooklyn,30295001001,288,141,147,2.73
2020,CB2020,047,3,Brooklyn,30295001002,184,82,102,2.36
2020,CB2020,047,3,Brooklyn,30295002000,514,251,263,5.08
2020,CB2020,047,3,Brooklyn,30295002001,490,207,283,5.08
2020,CB2020,047,3,Brooklyn,30295003000,601,273,328,5.07
2020,CB2020,047,3,Brooklyn,30295003001,343,139,204,5.08
2020,CB2020,047,3,Brooklyn,30295004000,489,237,252,5.08
2020,CB2020,047,3,Brooklyn,30295004001,288,138,150,3.2
2020,CB2020,047,3,Brooklyn,30295004002,152,59,93,1.89
2020,CB2020,047,3,Brooklyn,30296001000,281,146,135,4.71
2020,CB2020,047,3,Brooklyn,30296001001,427,192,235,4.72
2020,CB2020,047,3,Brooklyn,30296001002,743,352,391,4.72
2020,CB2020,047,3,Brooklyn,30296002000,697,359,338,4.71
2020,CB2020,047,3,Brooklyn,30296002001,361,195,166,5.03
2020,CB2020,047,3,Brooklyn,30296002002,610,304,306,4.99
2020,CB2020,047,3,Brooklyn,30296003000,511,234,277,4.62
2020,CB2020,047,3,Brooklyn,30296003001,541,273,268,4.77
2020,CB2020,047,3,Brooklyn,30296003002,523,251,272,4.98
2020,CB2020,047,3,Brooklyn,30296004000,829,403,426,4.97
2020,CB2020,047,3,Brooklyn,30296004001,470,220,250,4.69
2020,CB2020,047,3,Brooklyn,30297001000,146,76,70,5.09
2020,CB2020,047,3,Brooklyn,30297001001,449,213,236,5.09
2020,CB2020,047,3,Brooklyn,30297001002,472,223,249,5.08
2020,CB2020,047,3,Brooklyn,30297002000,400,186,214,5.09
2020,CB2020,047,3,Brooklyn,30297002001,410,191,219,5.08
2020,CB2020,047,3,Brooklyn,30297002002,0,0,0,3.65
2020,CB2020,047,3,Brooklyn,30297002003,960,430,530,6.47
2020,CB2020,047,3,Brooklyn,30297003000,348,162,186,5.08
2020,CB2020,047,3,Brooklyn,30297003001,340,158,182,5.09
2020,CB2020,047,3,Brooklyn,30297003002,396,187,209,5.08
2020,CB2020,047,3,Brooklyn,30298001000,39,20,19,0.91
2020,CB2020,047,3,Brooklyn,30298001001,72,28,44,2.59
2020,CB2020,047,3,Brooklyn,30298001002,419,199,220,4.18
2020,CB2020,047,3,Brooklyn,30298001003,442,206,236,4.64
2020,CB2020,047,3,Brooklyn,30298001004,466,241,225,4.67
2020,CB2020,047,3,Brooklyn,30298001005,167,97,70,2.82
2020,CB2020,047,3,Brooklyn,30298001006,56,16,40,1.26
2020,CB2020,047,3,Brooklyn,30298002000,349,197,152,4.56
2020,CB2020,047,3,Brooklyn,30298002001,436,195,241,4.65
2020,CB2020,047,3,Brooklyn,30298002002,186,104,82,5.02
2020,CB2020,047,3,Brooklyn,30298002003,133,42,91,3.45
2020,CB2020,047,3,Brooklyn,30298002004,68,48,20,1.49
2020,CB2020,047,3,Brooklyn,30298003000,357,175,182,4.66
2020,CB2020,047,3,Brooklyn,30298003001,431,213,218,4.65
2020,CB2020,047,3,Brooklyn,30298003002,334,170,164,5.03
2020,CB2020,047,3,Brooklyn,30299001000,354,188,166,5.19
2020,CB2020,047,3,Brooklyn,30299001001,139,63,76,2.54
2020,CB2020,047,3,Brooklyn,30299001002,274,130,144,2.5
2020,CB2020,047,3,Brooklyn,30299001003,209,118,91,2.54
2020,CB2020,047,3,Brooklyn,30299001004,250,98,152,4.7
2020,CB2020,047,3,Brooklyn,30299002000,419,184,235,4.89
2020,CB2020,047,3,Brooklyn,30299002001,240,90,150,3.65
2020,CB2020,047,3,Brooklyn,30299002002,154,71,83,2.39
2020,CB2020,047,3,Brooklyn,30299002003,169,76,93,2.14
2020,CB2020,047,3,Brooklyn,30299002004,288,114,174,4.6
2020,CB2020,047,3,Brooklyn,30300001000,572,278,294,4.75
2020,CB2020,047,3,Brooklyn,30300001001,471,213,258,4.57
2020,CB2020,047,3,Brooklyn,30300002000,421,205,216,4.8
2020,CB2020,047,3,Brooklyn,30300002001,463,238,225,4.77
2020,CB2020,047,3,Brooklyn,30300003000,456,228,228,4.59
2020,CB2020,047,3,Brooklyn,30300003001,398,192,206,4.78
2020,CB2020,047,3,Brooklyn,30300004000,408,213,195,4.76
2020,CB2020,047,3,Brooklyn,30300004001,293,138,155,4.61
2020,CB2020,047,3,Brooklyn,30300005000,407,203,204,4.67
2020,CB2020,047,3,Brooklyn,30300005001,335,168,167,3.47
2020,CB2020,047,3,Brooklyn,30300006000,0,0,0,2.42
2020,CB2020,047,3,Brooklyn,30301001000,465,218,247,4.86
2020,CB2020,047,3,Brooklyn,30301001001,247,134,113,2.46
2020,CB2020,047,3,Brooklyn,30301001002,268,127,141,2.56
2020,CB2020,047,3,Brooklyn,30301001003,212,82,130,2.57
2020,CB2020,047,3,Brooklyn,30301002000,190,87,103,4.83
2020,CB2020,047,3,Brooklyn,30301002001,76,40,36,2.57
2020,CB2020,047,3,Brooklyn,30301002002,159,77,82,2.48
2020,CB2020,047,3,Brooklyn,30301002003,267,130,137,2.54
2020,CB2020,047,3,Brooklyn,30301003000,253,103,150,4.85
2020,CB2020,047,3,Brooklyn,30301003001,44,28,16,4.56
2020,CB2020,047,3,Brooklyn,30301003002,207,94,113,2.34
2020,CB2020,047,3,Brooklyn,30301003003,173,94,79,2.33
2020,CB2020,047,3,Brooklyn,30301003004,194,90,104,2.5
2020,CB2020,047,3,Brooklyn,30301003005,49,31,18,2.22
2020,CB2020,047,3,Brooklyn,30301003006,102,57,45,2.15
2020,CB2020,047,3,Brooklyn,30301003007,64,32,32,2.23
2020,CB2020,047,3,Brooklyn,30302001000,305,157,148,5.1
2020,CB2020,047,3,Brooklyn,30302001001,472,245,227,4.98
2020,CB2020,047,3,Brooklyn,30302001002,218,104,114,5.28
2020,CB2020,047,3,Brooklyn,30302001003,478,243,235,5.33
2020,CB2020,047,3,Brooklyn,30302002000,506,256,250,5.11
2020,CB2020,047,3,Brooklyn,30302002001,613,306,307,5.31
2020,CB2020,047,3,Brooklyn,30302002002,428,199,229,5.31
2020,CB2020,047,3,Brooklyn,30302003000,525,254,271,5.13
2020,CB2020,047,3,Brooklyn,30302003001,390,194,196,5.32
2020,CB2020,047,3,Brooklyn,30302003002,456,223,233,5.32
2020,CB2020,047,3,Brooklyn,30303001000,864,392,472,5.23
2020,CB2020,047,3,Brooklyn,30303001001,133,69,64,5.03
2020,CB2020,047,3,Brooklyn,30303001002,548,248,300,5.03
2020,CB2020,047,3,Brooklyn,30303001003,461,174,287,5.75
2020,CB2020,047,3,Brooklyn,30303002000,0,0,0,1.08
2020,CB2020,047,3,Brooklyn,30303002001,335,136,199,4.33
2020,CB2020,047,3,Brooklyn,30303002002,373,165,208,4.68
2020,CB2020,047,3,Brooklyn,30303002003,22,8,14,4.71
2020,CB2020,047,3,Brooklyn,30303002004,242,103,139,5.4
2020,CB2020,047,3,Brooklyn,30303003000,0,0,0,0.9
2020,CB2020,047,3,Brooklyn,30303003001,209,92,117,4.73
2020,CB2020,047,3,Brooklyn,30303003002,567,233,334,5.02
2020,CB2020,047,3,Brooklyn,30303003003,556,245,311,5.02
2020,CB2020,047,3,Brooklyn,30303003004,642,298,344,5.76
2020,CB2020,047,3,Brooklyn,30304000001,0,0,0,0
2020,CB2020,047,3,Brooklyn,30304000002,0,0,0,0
2020,CB2020,047,3,Brooklyn,30304001000,211,81,130,4.24
2020,CB2020,047,3,Brooklyn,30304001001,310,183,127,4.41
2020,CB2020,047,3,Brooklyn,30304001002,404,197,207,4.42
2020,CB2020,047,3,Brooklyn,30304001003,98,50,48,2.1
2020,CB2020,047,3,Brooklyn,30304001004,214,118,96,2.76
2020,CB2020,047,3,Brooklyn,30304001005,159,69,90,2.03
2020,CB2020,047,3,Brooklyn,30304001006,0,0,0,3.46
2020,CB2020,047,3,Brooklyn,30304001007,0,0,0,1.91
2020,CB2020,047,3,Brooklyn,30304001008,0,0,0,5.03
2020,CB2020,047,3,Brooklyn,30304001009,0,0,0,40.46
2020,CB2020,047,3,Brooklyn,30304001010,150,69,81,1.8
2020,CB2020,047,3,Brooklyn,30304002000,569,301,268,4.11
2020,CB2020,047,3,Brooklyn,30304002001,433,177,256,4.15
2020,CB2020,047,3,Brooklyn,30304002002,388,210,178,4.56
2020,CB2020,047,3,Brooklyn,30304002003,42,26,16,4.52
2020,CB2020,047,3,Brooklyn,30304002004,332,125,207,2.89
2020,CB2020,047,3,Brooklyn,30304003000,14,6,8,4.2
2020,CB2020,047,3,Brooklyn,30304003001,0,0,0,4.44
2020,CB2020,047,3,Brooklyn,30304003002,376,174,202,4.41
2020,CB2020,047,3,Brooklyn,30304003003,52,24,28,1.62
2020,CB2020,047,3,Brooklyn,30304003004,0,0,0,1.04
2020,CB2020,047,3,Brooklyn,30304003005,0,0,0,0.53
2020,CB2020,047,3,Brooklyn,30304003006,618,299,319,2.05
2020,CB2020,047,3,Brooklyn,30304003007,161,58,103,1.94
2020,CB2020,047,3,Brooklyn,30304003008,155,85,70,1.86
2020,CB2020,047,3,Brooklyn,30305001000,79,35,44,1.84
2020,CB2020,047,3,Brooklyn,30305001001,46,14,32,4.45
2020,CB2020,047,3,Brooklyn,30305001002,146,82,64,5.94
2020,CB2020,047,3,Brooklyn,30305001003,38,16,22,5.96
2020,CB2020,047,3,Brooklyn,30305001004,162,73,89,5.95
2020,CB2020,047,3,Brooklyn,30305001005,335,154,181,4.39
2020,CB2020,047,3,Brooklyn,30305001006,63,26,37,4.37
2020,CB2020,047,3,Brooklyn,30305001007,113,53,60,2.07
2020,CB2020,047,3,Brooklyn,30305001008,231,130,101,2.08
2020,CB2020,047,3,Brooklyn,30305002000,197,83,114,2.37
2020,CB2020,047,3,Brooklyn,30305002001,974,479,495,5.02
2020,CB2020,047,3,Brooklyn,30305002002,740,375,365,6.82
2020,CB2020,047,3,Brooklyn,30305003000,339,154,185,2.39
2020,CB2020,047,3,Brooklyn,30305003001,986,462,524,4.99
2020,CB2020,047,3,Brooklyn,30305003002,1055,490,565,6.83
2020,CB2020,047,3,Brooklyn,30305004000,256,95,161,2.42
2020,CB2020,047,3,Brooklyn,30305004001,552,210,342,4.99
2020,CB2020,047,3,Brooklyn,30305004002,937,408,529,6.81
2020,CB2020,047,3,Brooklyn,30306001000,0,0,0,10.53
2020,CB2020,047,3,Brooklyn,30306001001,284,128,156,4.41
2020,CB2020,047,3,Brooklyn,30306001002,256,120,136,4.25
2020,CB2020,047,3,Brooklyn,30306001003,193,100,93,4.38
2020,CB2020,047,3,Brooklyn,30306001004,199,117,82,2.77
2020,CB2020,047,3,Brooklyn,30306001005,74,33,41,1.4
2020,CB2020,047,3,Brooklyn,30306001006,308,136,172,4.42
2020,CB2020,047,3,Brooklyn,30306001007,233,120,113,4.25
2020,CB2020,047,3,Brooklyn,30306001008,239,137,102,4.42
2020,CB2020,047,3,Brooklyn,30306001009,247,112,135,4.33
2020,CB2020,047,3,Brooklyn,30306001010,182,86,96,2.71
2020,CB2020,047,3,Brooklyn,30307001000,304,128,176,1.48
2020,CB2020,047,3,Brooklyn,30307001001,1338,526,812,8.59
2020,CB2020,047,3,Brooklyn,30307002000,1169,456,713,10.66
2020,CB2020,047,3,Brooklyn,30307003000,0,0,0,1.12
2020,CB2020,047,3,Brooklyn,30307003001,0,0,0,0.53
2020,CB2020,047,3,Brooklyn,30307003002,0,0,0,0.59
2020,CB2020,047,3,Brooklyn,30307003003,0,0,0,0.51
2020,CB2020,047,3,Brooklyn,30307003004,0,0,0,0.53
2020,CB2020,047,3,Brooklyn,30307003005,523,213,310,4.67
2020,CB2020,047,3,Brooklyn,30307003006,15,6,9,4.67
2020,CB2020,047,3,Brooklyn,30307003007,126,65,61,4.33
2020,CB2020,047,3,Brooklyn,30307003008,61,44,17,0.71
2020,CB2020,047,3,Brooklyn,30307003009,589,260,329,5.02
2020,CB2020,047,3,Brooklyn,30307003010,156,64,92,5.76
2020,CB2020,047,3,Brooklyn,30307003011,269,128,141,5.74
2020,CB2020,047,3,Brooklyn,30307003012,551,267,284,6.13
2020,CB2020,047,3,Brooklyn,30307003013,524,231,293,4.93
2020,CB2020,047,3,Brooklyn,30308001000,36,33,3,48.43
2020,CB2020,047,3,Brooklyn,30308001001,155,86,69,83.27
2020,CB2020,047,3,Brooklyn,30308001002,11,1,10,8.15
2020,CB2020,047,3,Brooklyn,30308001003,37,19,18,2.67
2020,CB2020,047,3,Brooklyn,30308001004,22,11,11,2.07
2020,CB2020,047,3,Brooklyn,30308001005,199,100,99,1.68
2020,CB2020,047,3,Brooklyn,30308001006,938,426,512,9.64
2020,CB2020,047,3,Brooklyn,30308001007,32,12,20,1.45
2020,CB2020,047,3,Brooklyn,30308001008,42,9,33,1.24
2020,CB2020,047,3,Brooklyn,30308001009,218,106,112,1.52
2020,CB2020,047,3,Brooklyn,30308001010,312,165,147,4.63
2020,CB2020,047,3,Brooklyn,30308001011,312,142,170,3.33
2020,CB2020,047,3,Brooklyn,30308001012,0,0,0,0.34
2020,CB2020,047,3,Brooklyn,30309001000,0,0,0,0.58
2020,CB2020,047,3,Brooklyn,30309001001,0,0,0,0.63
2020,CB2020,047,3,Brooklyn,30309001002,0,0,0,0.52
2020,CB2020,047,3,Brooklyn,30309001003,24,11,13,4.74
2020,CB2020,047,3,Brooklyn,30309001004,41,21,20,4.63
2020,CB2020,047,3,Brooklyn,30309001005,0,0,0,0.55
2020,CB2020,047,3,Brooklyn,30309001006,229,97,132,5.02
2020,CB2020,047,3,Brooklyn,30309001007,800,370,430,5.01
2020,CB2020,047,3,Brooklyn,30309002000,337,155,182,5.03
2020,CB2020,047,3,Brooklyn,30309002001,126,46,80,5.06
2020,CB2020,047,3,Brooklyn,30309002002,652,314,338,5.75
2020,CB2020,047,3,Brooklyn,30311001000,0,0,0,0.67
2020,CB2020,047,3,Brooklyn,30311001001,0,0,0,0.51
2020,CB2020,047,3,Brooklyn,30311001002,285,151,134,4.72
2020,CB2020,047,3,Brooklyn,30311001003,468,186,282,5.02
2020,CB2020,047,3,Brooklyn,30311001004,168,78,90,5.09
2020,CB2020,047,3,Brooklyn,30311002000,219,110,109,3.95
2020,CB2020,047,3,Brooklyn,30311002001,116,48,68,1.07
2020,CB2020,047,3,Brooklyn,30311002002,853,406,447,5.8
2020,CB2020,047,3,Brooklyn,30311003000,0,0,0,0.64
2020,CB2020,047,3,Brooklyn,30311003001,0,0,0,0.56
2020,CB2020,047,3,Brooklyn,30311003002,351,180,171,4.69
2020,CB2020,047,3,Brooklyn,30311003003,731,358,373,5.02
2020,CB2020,047,3,Brooklyn,30313001000,0,0,0,0.51
2020,CB2020,047,3,Brooklyn,30313001001,0,0,0,0.57
2020,CB2020,047,3,Brooklyn,30313001002,432,166,266,4.65
2020,CB2020,047,3,Brooklyn,30313001003,700,357,343,5.03
2020,CB2020,047,3,Brooklyn,30313002000,199,94,105,2.3
2020,CB2020,047,3,Brooklyn,30313002001,431,193,238,2.72
2020,CB2020,047,3,Brooklyn,30313002002,473,228,245,5.75
2020,CB2020,047,3,Brooklyn,30313003000,251,110,141,2.11
2020,CB2020,047,3,Brooklyn,30313003001,269,156,113,2.92
2020,CB2020,047,3,Brooklyn,30313003002,1366,541,825,5.74
2020,CB2020,047,3,Brooklyn,30313004000,0,0,0,0.5
2020,CB2020,047,3,Brooklyn,30313004001,0,0,0,0.58
2020,CB2020,047,3,Brooklyn,30313004002,391,232,159,4.67
2020,CB2020,047,3,Brooklyn,30313004003,597,252,345,5.03
2020,CB2020,047,3,Brooklyn,30314010001,0,0,0,0
2020,CB2020,047,3,Brooklyn,30314011000,161,86,75,3.31
2020,CB2020,047,3,Brooklyn,30314011001,196,87,109,2.36
2020,CB2020,047,3,Brooklyn,30314011002,153,48,105,1.59
2020,CB2020,047,3,Brooklyn,30314011003,85,49,36,1.44
2020,CB2020,047,3,Brooklyn,30314011004,175,85,90,3.07
2020,CB2020,047,3,Brooklyn,30314011005,394,200,194,4.88
2020,CB2020,047,3,Brooklyn,30314012000,723,333,390,4.87
2020,CB2020,047,3,Brooklyn,30314012001,298,131,167,2.82
2020,CB2020,047,3,Brooklyn,30314012002,0,0,0,2.86
2020,CB2020,047,3,Brooklyn,30314013000,0,0,0,1.66
2020,CB2020,047,3,Brooklyn,30314013001,0,0,0,0.85
2020,CB2020,047,3,Brooklyn,30314013002,0,0,0,2.01
2020,CB2020,047,3,Brooklyn,30314013003,13,5,8,14.3
2020,CB2020,047,3,Brooklyn,30314013004,0,0,0,6.74
2020,CB2020,047,3,Brooklyn,30314013005,0,0,0,2
2020,CB2020,047,3,Brooklyn,30314013006,0,0,0,4.57
2020,CB2020,047,3,Brooklyn,30314013007,118,66,52,2.41
2020,CB2020,047,3,Brooklyn,30314013008,281,119,162,1.74
2020,CB2020,047,3,Brooklyn,30314013009,727,339,388,6.07
2020,CB2020,047,3,Brooklyn,30314013010,0,0,0,6.46
2020,CB2020,047,3,Brooklyn,30314013011,0,0,0,0.82
2020,CB2020,047,3,Brooklyn,30314014000,0,0,0,8.66
2020,CB2020,047,3,Brooklyn,30314015000,453,226,227,5.49
2020,CB2020,047,3,Brooklyn,30314015001,490,232,258,6.37
2020,CB2020,047,3,Brooklyn,30314016000,524,265,259,6.71
2020,CB2020,047,3,Brooklyn,30314016001,351,186,165,7.18
2020,CB2020,047,3,Brooklyn,30314020001,0,0,0,0
2020,CB2020,047,3,Brooklyn,30314021000,0,0,0,95.25
2020,CB2020,047,3,Brooklyn,30315001000,0,0,0,0.51
2020,CB2020,047,3,Brooklyn,30315001001,0,0,0,0.66
2020,CB2020,047,3,Brooklyn,30315001002,544,263,281,4.63
2020,CB2020,047,3,Brooklyn,30315001003,903,424,479,5.02
2020,CB2020,047,3,Brooklyn,30315002000,526,219,307,5.03
2020,CB2020,047,3,Brooklyn,30315002001,909,380,529,5.76
2020,CB2020,047,3,Brooklyn,30315003000,701,341,360,5.07
2020,CB2020,047,3,Brooklyn,30315003001,645,303,342,5.75
2020,CB2020,047,3,Brooklyn,30315004000,0,0,0,0.55
2020,CB2020,047,3,Brooklyn,30315004001,0,0,0,0.87
2020,CB2020,047,3,Brooklyn,30315004002,443,222,221,5.25
2020,CB2020,047,3,Brooklyn,30315004003,942,411,531,5.42
2020,CB2020,047,3,Brooklyn,30317011000,861,348,513,5.76
2020,CB2020,047,3,Brooklyn,30317011001,729,324,405,5.76
2020,CB2020,047,3,Brooklyn,30317012000,654,303,351,5.75
2020,CB2020,047,3,Brooklyn,30317012001,560,286,274,5.75
2020,CB2020,047,3,Brooklyn,30317013000,634,284,350,5.76
2020,CB2020,047,3,Brooklyn,30317013001,561,228,333,5.75
2020,CB2020,047,3,Brooklyn,30317021000,737,327,410,5.76
2020,CB2020,047,3,Brooklyn,30317021001,447,190,257,5.75
2020,CB2020,047,3,Brooklyn,30317022000,472,212,260,4.37
2020,CB2020,047,3,Brooklyn,30317022001,574,301,273,4.35
2020,CB2020,047,3,Brooklyn,30317022002,0,0,0,1.41
2020,CB2020,047,3,Brooklyn,30317022003,0,0,0,1.39
2020,CB2020,047,3,Brooklyn,30317023000,666,305,361,5.75
2020,CB2020,047,3,Brooklyn,30317023001,818,371,447,5.76
2020,CB2020,047,3,Brooklyn,30319001000,0,0,0,1.34
2020,CB2020,047,3,Brooklyn,30319001001,538,245,293,4.51
2020,CB2020,047,3,Brooklyn,30319001002,650,302,348,5.67
2020,CB2020,047,3,Brooklyn,30319002000,711,312,399,5.75
2020,CB2020,047,3,Brooklyn,30319002001,540,234,306,5.76
2020,CB2020,047,3,Brooklyn,30319003000,330,158,172,5.74
2020,CB2020,047,3,Brooklyn,30319003001,66,30,36,3.78
2020,CB2020,047,3,Brooklyn,30319003002,595,248,347,3.66
2020,CB2020,047,3,Brooklyn,30319003003,22,11,11,1.18
2020,CB2020,047,3,Brooklyn,30321001000,17,11,6,1.36
2020,CB2020,047,3,Brooklyn,30321001001,585,226,359,4.39
2020,CB2020,047,3,Brooklyn,30321001002,708,362,346,5.76
2020,CB2020,047,3,Brooklyn,30321002000,848,401,447,5.75
2020,CB2020,047,3,Brooklyn,30321002001,521,222,299,5.77
2020,CB2020,047,3,Brooklyn,30321003000,761,350,411,2.88
2020,CB2020,047,3,Brooklyn,30321003001,586,250,336,2.87
2020,CB2020,047,3,Brooklyn,30321004000,932,416,516,5.64
2020,CB2020,047,3,Brooklyn,30321004001,530,227,303,5.13
2020,CB2020,047,3,Brooklyn,30323001000,0,0,0,0.98
2020,CB2020,047,3,Brooklyn,30323001001,480,203,277,3.47
2020,CB2020,047,3,Brooklyn,30323001002,139,58,81,4.86
2020,CB2020,047,3,Brooklyn,30323001003,742,319,423,5.38
2020,CB2020,047,3,Brooklyn,30323002000,526,205,321,5.86
2020,CB2020,047,3,Brooklyn,30323002001,553,234,319,6.34
2020,CB2020,047,3,Brooklyn,30323003000,507,232,275,3.33
2020,CB2020,047,3,Brooklyn,30323003001,167,72,95,2.71
2020,CB2020,047,3,Brooklyn,30323003002,230,107,123,3.57
2020,CB2020,047,3,Brooklyn,30323003003,165,68,97,6.25
2020,CB2020,047,3,Brooklyn,30325001000,23,13,10,1.43
2020,CB2020,047,3,Brooklyn,30325001001,675,284,391,4.53
2020,CB2020,047,3,Brooklyn,30325001002,544,229,315,5.88
2020,CB2020,047,3,Brooklyn,30325002000,1066,464,602,5.91
2020,CB2020,047,3,Brooklyn,30325002001,388,157,231,5.91
2020,CB2020,047,3,Brooklyn,30325003000,0,0,0,5.98
2020,CB2020,047,3,Brooklyn,30325003001,3522,1640,1882,7.36
2020,CB2020,047,3,Brooklyn,30325003002,0,0,0,4.62
2020,CB2020,047,3,Brooklyn,30326001000,432,225,207,5.82
2020,CB2020,047,3,Brooklyn,30326001001,296,143,153,5.82
2020,CB2020,047,3,Brooklyn,30326001002,156,60,96,3.37
2020,CB2020,047,3,Brooklyn,30326001003,155,76,79,3.38
2020,CB2020,047,3,Brooklyn,30326002000,63,36,27,3.59
2020,CB2020,047,3,Brooklyn,30326002001,596,237,359,4
2020,CB2020,047,3,Brooklyn,30326002002,735,317,418,4.45
2020,CB2020,047,3,Brooklyn,30326002003,669,306,363,4.89
2020,CB2020,047,3,Brooklyn,30326003000,662,286,376,5.36
2020,CB2020,047,3,Brooklyn,30326003001,443,198,245,3.68
2020,CB2020,047,3,Brooklyn,30326003002,605,242,363,2.08
2020,CB2020,047,3,Brooklyn,30326004000,632,315,317,5.82
2020,CB2020,047,3,Brooklyn,30326004001,415,158,257,5.84
2020,CB2020,047,3,Brooklyn,30326005000,494,261,233,5.83
2020,CB2020,047,3,Brooklyn,30326005001,112,81,31,5.8
2020,CB2020,047,3,Brooklyn,30326005002,276,121,155,5.81
2020,CB2020,047,3,Brooklyn,30326005003,334,153,181,5.79
2020,CB2020,047,3,Brooklyn,30327001000,424,165,259,6.1
2020,CB2020,047,3,Brooklyn,30327001001,460,238,222,6.03
2020,CB2020,047,3,Brooklyn,30327002000,88,44,44,4.2
2020,CB2020,047,3,Brooklyn,30327002001,30,17,13,1.71
2020,CB2020,047,3,Brooklyn,30327002002,292,108,184,6.56
2020,CB2020,047,3,Brooklyn,30327002003,0,0,0,0.26
2020,CB2020,047,3,Brooklyn,30327002004,697,322,375,6.74
2020,CB2020,047,3,Brooklyn,30327003000,28,7,21,3.9
2020,CB2020,047,3,Brooklyn,30327003001,537,248,289,4.69
2020,CB2020,047,3,Brooklyn,30327003002,495,235,260,2.74
2020,CB2020,047,3,Brooklyn,30327003003,23,6,17,0.84
2020,CB2020,047,3,Brooklyn,30328001000,229,96,133,5.8
2020,CB2020,047,3,Brooklyn,30328001001,187,98,89,5.79
2020,CB2020,047,3,Brooklyn,30328001002,503,241,262,5.81
2020,CB2020,047,3,Brooklyn,30328002000,253,127,126,5.81
2020,CB2020,047,3,Brooklyn,30328002001,195,100,95,5.68
2020,CB2020,047,3,Brooklyn,30328002002,223,101,122,5.93
2020,CB2020,047,3,Brooklyn,30328003000,590,282,308,5.67
2020,CB2020,047,3,Brooklyn,30328003001,161,79,82,5.71
2020,CB2020,047,3,Brooklyn,30328004000,339,168,171,5.65
2020,CB2020,047,3,Brooklyn,30328004001,410,195,215,5.68
2020,CB2020,047,3,Brooklyn,30329001000,825,393,432,4.13
2020,CB2020,047,3,Brooklyn,30329001001,393,164,229,2.66
2020,CB2020,047,3,Brooklyn,30329001002,292,150,142,2.03
2020,CB2020,047,3,Brooklyn,30329002000,678,315,363,4.66
2020,CB2020,047,3,Brooklyn,30329002001,863,386,477,4.27
2020,CB2020,047,3,Brooklyn,30329003000,295,125,170,5.2
2020,CB2020,047,3,Brooklyn,30329003001,1136,465,671,5.23
2020,CB2020,047,3,Brooklyn,30329004000,805,358,447,5.25
2020,CB2020,047,3,Brooklyn,30329004001,420,195,225,5.22
2020,CB2020,047,3,Brooklyn,30330000001,0,0,0,0
2020,CB2020,047,3,Brooklyn,30330001000,2235,970,1265,20.5
2020,CB2020,047,3,Brooklyn,30330002000,0,0,0,4.85
2020,CB2020,047,3,Brooklyn,30330002001,330,152,178,4.54
2020,CB2020,047,3,Brooklyn,30330002002,238,98,140,4.86
2020,CB2020,047,3,Brooklyn,30330003000,32,14,18,39.74
2020,CB2020,047,3,Brooklyn,30330003001,0,0,0,1.38
2020,CB2020,047,3,Brooklyn,30330003002,1264,518,746,12.2
2020,CB2020,047,3,Brooklyn,30330003003,324,140,184,3.89
2020,CB2020,047,3,Brooklyn,30331001000,1014,482,532,5.75
2020,CB2020,047,3,Brooklyn,30331001001,261,116,145,1.84
2020,CB2020,047,3,Brooklyn,30331001002,236,122,114,2.79
2020,CB2020,047,3,Brooklyn,30331002000,707,365,342,5.75
2020,CB2020,047,3,Brooklyn,30331002001,373,165,208,2.68
2020,CB2020,047,3,Brooklyn,30331002002,790,362,428,4.07
2020,CB2020,047,3,Brooklyn,30331003000,487,225,262,5.75
2020,CB2020,047,3,Brooklyn,30331003001,349,176,173,6.56
2020,CB2020,047,3,Brooklyn,30333001000,751,366,385,5.76
2020,CB2020,047,3,Brooklyn,30333001001,459,225,234,5.74
2020,CB2020,047,3,Brooklyn,30333002000,919,437,482,5.78
2020,CB2020,047,3,Brooklyn,30333002001,657,297,360,5.76
2020,CB2020,047,3,Brooklyn,30333002002,286,153,133,5.75
2020,CB2020,047,3,Brooklyn,30333003000,244,113,131,3.17
2020,CB2020,047,3,Brooklyn,30333003001,381,178,203,3.24
2020,CB2020,047,3,Brooklyn,30333003002,229,108,121,2.52
2020,CB2020,047,3,Brooklyn,30333003003,330,155,175,5.74
2020,CB2020,047,3,Brooklyn,30333003004,247,117,130,2.59
2020,CB2020,047,3,Brooklyn,30335001000,590,284,306,5.29
2020,CB2020,047,3,Brooklyn,30335001001,659,300,359,5.75
2020,CB2020,047,3,Brooklyn,30335002000,433,208,225,5.38
2020,CB2020,047,3,Brooklyn,30335002001,599,358,241,5.76
2020,CB2020,047,3,Brooklyn,30335003000,149,64,85,5.42
2020,CB2020,047,3,Brooklyn,30335003001,322,164,158,5.51
2020,CB2020,047,3,Brooklyn,30335003002,219,131,88,5.76
2020,CB2020,047,3,Brooklyn,30335003003,260,115,145,5.77
2020,CB2020,047,3,Brooklyn,30336000001,0,0,0,0
2020,CB2020,047,3,Brooklyn,30336000002,0,0,0,0
2020,CB2020,047,3,Brooklyn,30336001000,154,68,86,3.77
2020,CB2020,047,3,Brooklyn,30336001001,139,76,63,3.74
2020,CB2020,047,3,Brooklyn,30336001002,116,45,71,3.8
2020,CB2020,047,3,Brooklyn,30336001003,224,129,95,3.84
2020,CB2020,047,3,Brooklyn,30336001004,155,86,69,3.83
2020,CB2020,047,3,Brooklyn,30336001005,100,51,49,3.82
2020,CB2020,047,3,Brooklyn,30336002000,46,16,30,0.55
2020,CB2020,047,3,Brooklyn,30336002001,140,81,59,3.21
2020,CB2020,047,3,Brooklyn,30336002002,169,73,96,3.45
2020,CB2020,047,3,Brooklyn,30336002003,140,75,65,3.54
2020,CB2020,047,3,Brooklyn,30336002004,59,30,29,1.49
2020,CB2020,047,3,Brooklyn,30336002005,172,72,100,3.98
2020,CB2020,047,3,Brooklyn,30336002006,0,0,0,3.7
2020,CB2020,047,3,Brooklyn,30336002007,138,65,73,3.3
2020,CB2020,047,3,Brooklyn,30336002008,88,54,34,7.36
2020,CB2020,047,3,Brooklyn,30336002009,17,3,14,6.8
2020,CB2020,047,3,Brooklyn,30336002010,60,32,28,2.1
2020,CB2020,047,3,Brooklyn,30336003000,33,18,15,1.15
2020,CB2020,047,3,Brooklyn,30336003001,86,51,35,1.94
2020,CB2020,047,3,Brooklyn,30336003002,84,26,58,2.3
2020,CB2020,047,3,Brooklyn,30336003003,115,61,54,1.89
2020,CB2020,047,3,Brooklyn,30336003004,92,48,44,2.11
2020,CB2020,047,3,Brooklyn,30336003005,182,98,84,3.62
2020,CB2020,047,3,Brooklyn,30336003006,171,96,75,12.84
2020,CB2020,047,3,Brooklyn,30336003007,53,28,25,1.31
2020,CB2020,047,3,Brooklyn,30336003008,0,0,0,0.3
2020,CB2020,047,3,Brooklyn,30336004000,335,166,169,11.78
2020,CB2020,047,3,Brooklyn,30336004001,230,124,106,14.14
2020,CB2020,047,3,Brooklyn,30336005000,147,87,60,24.2
2020,CB2020,047,3,Brooklyn,30336005001,76,36,40,1.68
2020,CB2020,047,3,Brooklyn,30336005002,70,39,31,2.38
2020,CB2020,047,3,Brooklyn,30336005003,78,29,49,2.01
2020,CB2020,047,3,Brooklyn,30336005004,101,45,56,1.58
2020,CB2020,047,3,Brooklyn,30336005005,175,80,95,3.76
2020,CB2020,047,3,Brooklyn,30336005006,166,82,84,3.89
2020,CB2020,047,3,Brooklyn,30336005007,173,67,106,3.73
2020,CB2020,047,3,Brooklyn,30336005008,125,64,61,3.75
2020,CB2020,047,3,Brooklyn,30336005009,185,87,98,3.76
2020,CB2020,047,3,Brooklyn,30336005010,171,76,95,3.69
2020,CB2020,047,3,Brooklyn,30337011000,873,419,454,4.77
2020,CB2020,047,3,Brooklyn,30337011001,530,296,234,4.3
2020,CB2020,047,3,Brooklyn,30337011002,0,0,0,0.33
2020,CB2020,047,3,Brooklyn,30337011003,27,12,15,0.7
2020,CB2020,047,3,Brooklyn,30337011004,0,0,0,0.82
2020,CB2020,047,3,Brooklyn,30337011005,0,0,0,1.32
2020,CB2020,047,3,Brooklyn,30337012000,608,304,304,4.66
2020,CB2020,047,3,Brooklyn,30337012001,472,213,259,4.73
2020,CB2020,047,3,Brooklyn,30337012002,0,0,0,1.34
2020,CB2020,047,3,Brooklyn,30337012003,0,0,0,1.41
2020,CB2020,047,3,Brooklyn,30337021000,0,0,0,1.33
2020,CB2020,047,3,Brooklyn,30337021001,0,0,0,1.34
2020,CB2020,047,3,Brooklyn,30337021002,478,233,245,4.67
2020,CB2020,047,3,Brooklyn,30337021003,279,149,130,4.74
2020,CB2020,047,3,Brooklyn,30337022000,8,6,2,1.36
2020,CB2020,047,3,Brooklyn,30337022001,0,0,0,1.31
2020,CB2020,047,3,Brooklyn,30337022002,643,345,298,4.82
2020,CB2020,047,3,Brooklyn,30337022003,708,339,369,4.86
2020,CB2020,047,3,Brooklyn,30339001000,865,399,466,5.75
2020,CB2020,047,3,Brooklyn,30339001001,603,276,327,5.44
2020,CB2020,047,3,Brooklyn,30339002000,405,191,214,3.47
2020,CB2020,047,3,Brooklyn,30339002001,230,103,127,2.28
2020,CB2020,047,3,Brooklyn,30339002002,563,298,265,5.44
2020,CB2020,047,3,Brooklyn,30339003000,671,274,397,5.75
2020,CB2020,047,3,Brooklyn,30339003001,453,192,261,5.41
2020,CB2020,047,3,Brooklyn,30339004000,415,148,267,5.75
2020,CB2020,047,3,Brooklyn,30339004001,471,240,231,5.35
2020,CB2020,047,3,Brooklyn,30340001000,1213,485,728,9.08
2020,CB2020,047,3,Brooklyn,30340001001,15,8,7,2.92
2020,CB2020,047,3,Brooklyn,30340001002,128,95,33,2.94
2020,CB2020,047,3,Brooklyn,30340001003,17,4,13,2.75
2020,CB2020,047,3,Brooklyn,30340001004,14,10,4,2.59
2020,CB2020,047,3,Brooklyn,30340002000,0,0,0,4.32
2020,CB2020,047,3,Brooklyn,30340002001,173,62,111,3.84
2020,CB2020,047,3,Brooklyn,30340002002,398,133,265,3.61
2020,CB2020,047,3,Brooklyn,30341001000,0,0,0,11.51
2020,CB2020,047,3,Brooklyn,30341001001,878,383,495,5.79
2020,CB2020,047,3,Brooklyn,30341002000,689,303,386,5.73
2020,CB2020,047,3,Brooklyn,30341003000,876,380,496,5.75
2020,CB2020,047,3,Brooklyn,30341003001,242,110,132,5.76
2020,CB2020,047,3,Brooklyn,30342001000,1664,702,962,12.5
2020,CB2020,047,3,Brooklyn,30342001001,843,358,485,6.54
2020,CB2020,047,3,Brooklyn,30342002000,444,174,270,6.41
2020,CB2020,047,3,Brooklyn,30342002001,880,378,502,6.31
2020,CB2020,047,3,Brooklyn,30342003000,1490,577,913,11.58
2020,CB2020,047,3,Brooklyn,30342003001,578,250,328,5.27
2020,CB2020,047,3,Brooklyn,30342004000,727,291,436,4.5
2020,CB2020,047,3,Brooklyn,30342004001,434,216,218,3.72
2020,CB2020,047,3,Brooklyn,30343001000,186,80,106,5.81
2020,CB2020,047,3,Brooklyn,30343001001,208,103,105,1.86
2020,CB2020,047,3,Brooklyn,30343001002,152,61,91,1.64
2020,CB2020,047,3,Brooklyn,30343001003,132,61,71,2.28
2020,CB2020,047,3,Brooklyn,30343002000,713,303,410,5.8
2020,CB2020,047,3,Brooklyn,30343002001,516,237,279,5.78
2020,CB2020,047,3,Brooklyn,30343003000,1691,705,986,11.26
2020,CB2020,047,3,Brooklyn,30343004000,1426,565,861,5.62
2020,CB2020,047,3,Brooklyn,30345001000,736,327,409,5.74
2020,CB2020,047,3,Brooklyn,30345001001,542,257,285,5.9
2020,CB2020,047,3,Brooklyn,30345002000,532,244,288,5.76
2020,CB2020,047,3,Brooklyn,30345002001,0,0,0,11.56
2020,CB2020,047,3,Brooklyn,30345002002,363,151,212,5.7
2020,CB2020,047,3,Brooklyn,30345002003,565,281,284,5.77
2020,CB2020,047,3,Brooklyn,30347001000,135,69,66,2.87
2020,CB2020,047,3,Brooklyn,30347001001,726,301,425,5.75
2020,CB2020,047,3,Brooklyn,30347001002,142,52,90,2.87
2020,CB2020,047,3,Brooklyn,30347002000,842,402,440,5.77
2020,CB2020,047,3,Brooklyn,30347002001,220,94,126,5.78
2020,CB2020,047,3,Brooklyn,30347003000,846,374,472,5.76
2020,CB2020,047,3,Brooklyn,30347003001,734,323,411,5.75
2020,CB2020,047,3,Brooklyn,30348001000,0,0,0,1.84
2020,CB2020,047,3,Brooklyn,30348001001,0,0,0,1.85
2020,CB2020,047,3,Brooklyn,30348001002,0,0,0,4.46
2020,CB2020,047,3,Brooklyn,30348001003,0,0,0,1
2020,CB2020,047,3,Brooklyn,30348001004,0,0,0,0.61
2020,CB2020,047,3,Brooklyn,30348001005,0,0,0,1.53
2020,CB2020,047,3,Brooklyn,30348001006,25,11,14,21.88
2020,CB2020,047,3,Brooklyn,30348001007,0,0,0,4.48
2020,CB2020,047,3,Brooklyn,30348001008,0,0,0,7.41
2020,CB2020,047,3,Brooklyn,30348001009,0,0,0,1.06
2020,CB2020,047,3,Brooklyn,30348001010,403,200,203,7.21
2020,CB2020,047,3,Brooklyn,30348001011,0,0,0,10.65
2020,CB2020,047,3,Brooklyn,30348001012,0,0,0,0
2020,CB2020,047,3,Brooklyn,30348001013,0,0,0,0
2020,CB2020,047,3,Brooklyn,30348001014,0,0,0,0
2020,CB2020,047,3,Brooklyn,30348001015,325,168,157,12.78
2020,CB2020,047,3,Brooklyn,30348001016,63,26,37,4.31
2020,CB2020,047,3,Brooklyn,30348001017,0,0,0,8.25
2020,CB2020,047,3,Brooklyn,30348001018,0,0,0,0
2020,CB2020,047,3,Brooklyn,30348001019,0,0,0,5.94
2020,CB2020,047,3,Brooklyn,30348001020,0,0,0,0.76
2020,CB2020,047,3,Brooklyn,30348001021,0,0,0,5.22
2020,CB2020,047,3,Brooklyn,30348001022,0,0,0,3.84
2020,CB2020,047,3,Brooklyn,30348001023,51,40,11,3.15
2020,CB2020,047,3,Brooklyn,30348001024,113,52,61,3.62
2020,CB2020,047,3,Brooklyn,30348001025,0,0,0,2.37
2020,CB2020,047,3,Brooklyn,30348001026,0,0,0,0.93
2020,CB2020,047,3,Brooklyn,30348001027,485,261,224,7.28
2020,CB2020,047,3,Brooklyn,30348001028,142,51,91,5.6
2020,CB2020,047,3,Brooklyn,30348002000,529,241,288,5.75
2020,CB2020,047,3,Brooklyn,30348002001,478,261,217,5.8
2020,CB2020,047,3,Brooklyn,30348002002,87,55,32,3.32
2020,CB2020,047,3,Brooklyn,30348002003,127,81,46,3.55
2020,CB2020,047,3,Brooklyn,30349011000,1046,444,602,5.76
2020,CB2020,047,3,Brooklyn,30349012000,463,203,260,5.45
2020,CB2020,047,3,Brooklyn,30349012001,558,241,317,4.67
2020,CB2020,047,3,Brooklyn,30349012002,0,0,0,1.41
2020,CB2020,047,3,Brooklyn,30349021000,0,0,0,1.38
2020,CB2020,047,3,Brooklyn,30349021001,524,219,305,4.91
2020,CB2020,047,3,Brooklyn,30349021002,965,441,524,5.22
2020,CB2020,047,3,Brooklyn,30349022000,727,323,404,5.77
2020,CB2020,047,3,Brooklyn,30349023000,337,139,198,1.54
2020,CB2020,047,3,Brooklyn,30349023001,794,339,455,4.23
2020,CB2020,047,3,Brooklyn,30350001000,0,0,0,0.61
2020,CB2020,047,3,Brooklyn,30350001001,1865,817,1048,14.12
2020,CB2020,047,3,Brooklyn,30350002000,1217,511,706,13.69
2020,CB2020,047,3,Brooklyn,30350002001,0,0,0,12.17
2020,CB2020,047,3,Brooklyn,30350002002,0,0,0,5.54
2020,CB2020,047,3,Brooklyn,30350002003,0,0,0,2.95
2020,CB2020,047,3,Brooklyn,30351011000,848,352,496,5.76
2020,CB2020,047,3,Brooklyn,30351011001,489,212,277,5.45
2020,CB2020,047,3,Brooklyn,30351011002,906,396,510,4.63
2020,CB2020,047,3,Brooklyn,30351011003,0,0,0,1.44
2020,CB2020,047,3,Brooklyn,30351021000,10,6,4,1.43
2020,CB2020,047,3,Brooklyn,30351021001,462,205,257,4.86
2020,CB2020,047,3,Brooklyn,30351021002,956,442,514,5.22
2020,CB2020,047,3,Brooklyn,30351022000,707,338,369,5.74
2020,CB2020,047,3,Brooklyn,30351022001,491,228,263,5.77
2020,CB2020,047,3,Brooklyn,30352000001,0,0,0,0
2020,CB2020,047,3,Brooklyn,30352001000,14,9,5,101.59
2020,CB2020,047,3,Brooklyn,30352001001,0,0,0,0.28
2020,CB2020,047,3,Brooklyn,30352001002,0,0,0,1.37
2020,CB2020,047,3,Brooklyn,30352001003,0,0,0,1.71
2020,CB2020,047,3,Brooklyn,30352001004,0,0,0,1.02
2020,CB2020,047,3,Brooklyn,30352001005,0,0,0,1.77
2020,CB2020,047,3,Brooklyn,30352001006,1124,525,599,99.29
2020,CB2020,047,3,Brooklyn,30352001007,225,110,115,3.85
2020,CB2020,047,3,Brooklyn,30352001008,0,0,0,6.89
2020,CB2020,047,3,Brooklyn,30352001009,0,0,0,16.07
2020,CB2020,047,3,Brooklyn,30352001010,4,4,0,10.96
2020,CB2020,047,3,Brooklyn,30353011000,1095,514,581,5.75
2020,CB2020,047,3,Brooklyn,30353011001,858,391,467,5.45
2020,CB2020,047,3,Brooklyn,30353012000,613,271,342,4.62
2020,CB2020,047,3,Brooklyn,30353012001,0,0,0,1.45
2020,CB2020,047,3,Brooklyn,30353021000,666,322,344,5.75
2020,CB2020,047,3,Brooklyn,30353021001,519,240,279,5.76
2020,CB2020,047,3,Brooklyn,30353022000,0,0,0,1.42
2020,CB2020,047,3,Brooklyn,30353022001,842,397,445,4.86
2020,CB2020,047,3,Brooklyn,30353022002,784,367,417,5.22
2020,CB2020,047,3,Brooklyn,30354001000,0,0,0,0.34
2020,CB2020,047,3,Brooklyn,30354001001,13,7,6,3.14
2020,CB2020,047,3,Brooklyn,30354001002,0,0,0,1.58
2020,CB2020,047,3,Brooklyn,30354001003,0,0,0,0.36
2020,CB2020,047,3,Brooklyn,30354001004,0,0,0,5.36
2020,CB2020,047,3,Brooklyn,30354001005,0,0,0,13.54
2020,CB2020,047,3,Brooklyn,30354001006,0,0,0,1.21
2020,CB2020,047,3,Brooklyn,30354001007,0,0,0,4.52
2020,CB2020,047,3,Brooklyn,30354001008,1875,831,1044,17.61
2020,CB2020,047,3,Brooklyn,30354001009,0,0,0,0.73
2020,CB2020,047,3,Brooklyn,30354001010,0,0,0,1.7
2020,CB2020,047,3,Brooklyn,30354002000,2097,899,1198,17.68
2020,CB2020,047,3,Brooklyn,30354002001,0,0,0,3.08
2020,CB2020,047,3,Brooklyn,30354002002,23,14,9,11.09
2020,CB2020,047,3,Brooklyn,30354003000,1485,695,790,11.5
2020,CB2020,047,3,Brooklyn,30355001000,41,31,10,1
2020,CB2020,047,3,Brooklyn,30355001001,708,323,385,4.76
2020,CB2020,047,3,Brooklyn,30355001002,1127,504,623,5.73
2020,CB2020,047,3,Brooklyn,30355002000,507,222,285,2.48
2020,CB2020,047,3,Brooklyn,30355002001,952,403,549,5.42
2020,CB2020,047,3,Brooklyn,30355002002,0,0,0,0.79
2020,CB2020,047,3,Brooklyn,30355003000,786,365,421,5.72
2020,CB2020,047,3,Brooklyn,30355003001,649,308,341,5.75
2020,CB2020,047,3,Brooklyn,30355003002,422,209,213,2.54
2020,CB2020,047,3,Brooklyn,30356011000,0,0,0,0.77
2020,CB2020,047,3,Brooklyn,30356011001,1299,562,737,3.26
2020,CB2020,047,3,Brooklyn,30356011002,1603,706,897,12.74
2020,CB2020,047,3,Brooklyn,30356021000,918,409,509,5.81
2020,CB2020,047,3,Brooklyn,30356021001,0,0,0,2.63
2020,CB2020,047,3,Brooklyn,30356021002,0,0,0,1.56
2020,CB2020,047,3,Brooklyn,30356021003,112,42,70,2.82
2020,CB2020,047,3,Brooklyn,30356022000,2164,953,1211,13.02
2020,CB2020,047,3,Brooklyn,30356022001,0,0,0,0.63
2020,CB2020,047,3,Brooklyn,30356022002,258,117,141,1.29
2020,CB2020,047,3,Brooklyn,30356023000,0,0,0,2.56
2020,CB2020,047,3,Brooklyn,30356023001,1685,740,945,8.9
2020,CB2020,047,3,Brooklyn,30356023002,0,0,0,0.82
2020,CB2020,047,3,Brooklyn,30356023003,0,0,0,0.53
2020,CB2020,047,3,Brooklyn,30356023004,337,143,194,1.62
2020,CB2020,047,3,Brooklyn,30357011000,865,399,466,5.75
2020,CB2020,047,3,Brooklyn,30357011001,717,319,398,5.44
2020,CB2020,047,3,Brooklyn,30357011002,740,280,460,4.66
2020,CB2020,047,3,Brooklyn,30357011003,0,0,0,1.39
2020,CB2020,047,3,Brooklyn,30357021000,0,0,0,1.38
2020,CB2020,047,3,Brooklyn,30357021001,0,0,0,5.06
2020,CB2020,047,3,Brooklyn,30357021002,15,6,9,20.81
2020,CB2020,047,3,Brooklyn,30359001000,763,350,413,6.12
2020,CB2020,047,3,Brooklyn,30359001001,757,350,407,6.13
2020,CB2020,047,3,Brooklyn,30359002000,585,256,329,6.13
2020,CB2020,047,3,Brooklyn,30359002001,734,312,422,6.12
2020,CB2020,047,3,Brooklyn,30359003000,878,359,519,4.85
2020,CB2020,047,3,Brooklyn,30359003001,179,66,113,0.94
2020,CB2020,047,3,Brooklyn,30359003002,761,320,441,4.96
2020,CB2020,047,3,Brooklyn,30359003003,0,0,0,1.39
2020,CB2020,047,3,Brooklyn,30359004000,0,0,0,1.42
2020,CB2020,047,3,Brooklyn,30359004001,707,296,411,4.23
2020,CB2020,047,3,Brooklyn,30359004002,141,63,78,1.25
2020,CB2020,047,3,Brooklyn,30359004003,112,56,56,1.82
2020,CB2020,047,3,Brooklyn,30360011000,675,292,383,3.32
2020,CB2020,047,3,Brooklyn,30360011001,184,99,85,2.71
2020,CB2020,047,3,Brooklyn,30360011002,235,126,109,0.79
2020,CB2020,047,3,Brooklyn,30360012000,336,144,192,2.18
2020,CB2020,047,3,Brooklyn,30360012001,374,150,224,1.92
2020,CB2020,047,3,Brooklyn,30360012002,270,136,134,3.16
2020,CB2020,047,3,Brooklyn,30360013000,695,297,398,3.17
2020,CB2020,047,3,Brooklyn,30360013001,592,279,313,2.91
2020,CB2020,047,3,Brooklyn,30360013002,26,21,5,3.26
2020,CB2020,047,3,Brooklyn,30360021000,905,383,522,4.45
2020,CB2020,047,3,Brooklyn,30360021001,949,432,517,3.59
2020,CB2020,047,3,Brooklyn,30360021002,195,64,131,2.76
2020,CB2020,047,3,Brooklyn,30360022000,774,328,446,3.83
2020,CB2020,047,3,Brooklyn,30360022001,738,318,420,3.45
2020,CB2020,047,3,Brooklyn,30360022002,642,254,388,3.18
2020,CB2020,047,3,Brooklyn,30361001000,235,166,69,3.1
2020,CB2020,047,3,Brooklyn,30361001001,382,167,215,3.99
2020,CB2020,047,3,Brooklyn,30361001002,171,61,110,1.8
2020,CB2020,047,3,Brooklyn,30361002000,215,91,124,2.91
2020,CB2020,047,3,Brooklyn,30361002001,0,0,0,0.58
2020,CB2020,047,3,Brooklyn,30361002002,133,63,70,0.76
2020,CB2020,047,3,Brooklyn,30361002003,157,77,80,2.54
2020,CB2020,047,3,Brooklyn,30361002004,87,49,38,1.93
2020,CB2020,047,3,Brooklyn,30361002005,204,98,106,4.55
2020,CB2020,047,3,Brooklyn,30361002006,100,53,47,0.93
2020,CB2020,047,3,Brooklyn,30361002007,151,54,97,1.38
2020,CB2020,047,3,Brooklyn,30361003000,694,293,401,5.38
2020,CB2020,047,3,Brooklyn,30361003001,435,197,238,4.75
2020,CB2020,047,3,Brooklyn,30361003002,0,0,0,0.26
2020,CB2020,047,3,Brooklyn,30362001000,633,341,292,4.32
2020,CB2020,047,3,Brooklyn,30362001001,240,130,110,1.73
2020,CB2020,047,3,Brooklyn,30362001002,482,256,226,4.32
2020,CB2020,047,3,Brooklyn,30362001003,477,232,245,4.51
2020,CB2020,047,3,Brooklyn,30362002000,505,256,249,4.49
2020,CB2020,047,3,Brooklyn,30362002001,465,231,234,4.49
2020,CB2020,047,3,Brooklyn,30362002002,320,175,145,4.46
2020,CB2020,047,3,Brooklyn,30362003000,67,34,33,0.68
2020,CB2020,047,3,Brooklyn,30362003001,99,86,13,0.96
2020,CB2020,047,3,Brooklyn,30362003002,411,205,206,5.32
2020,CB2020,047,3,Brooklyn,30362003003,15,2,13,1.34
2020,CB2020,047,3,Brooklyn,30362003004,54,32,22,0.68
2020,CB2020,047,3,Brooklyn,30362003005,96,50,46,0.79
2020,CB2020,047,3,Brooklyn,30362003006,109,52,57,0.91
2020,CB2020,047,3,Brooklyn,30362003007,64,23,41,1.19
2020,CB2020,047,3,Brooklyn,30362003008,41,15,26,1.52
2020,CB2020,047,3,Brooklyn,30362003009,62,27,35,0.58
2020,CB2020,047,3,Brooklyn,30363001000,132,57,75,1.14
2020,CB2020,047,3,Brooklyn,30363001001,45,11,34,1.16
2020,CB2020,047,3,Brooklyn,30363001002,26,9,17,1.83
2020,CB2020,047,3,Brooklyn,30363001003,233,82,151,4.15
2020,CB2020,047,3,Brooklyn,30363001004,0,0,0,0.53
2020,CB2020,047,3,Brooklyn,30363001005,200,114,86,3.89
2020,CB2020,047,3,Brooklyn,30363001006,39,22,17,0.84
2020,CB2020,047,3,Brooklyn,30363002000,336,165,171,5.39
2020,CB2020,047,3,Brooklyn,30363002001,465,231,234,5.39
2020,CB2020,047,3,Brooklyn,30363002002,595,233,362,5.38
2020,CB2020,047,3,Brooklyn,30363002003,405,170,235,5.75
2020,CB2020,047,3,Brooklyn,30363003000,539,241,298,5.76
2020,CB2020,047,3,Brooklyn,30363003001,592,269,323,5.34
2020,CB2020,047,3,Brooklyn,30363003002,194,94,100,2.04
2020,CB2020,047,3,Brooklyn,30363003003,273,103,170,3.66
2020,CB2020,047,3,Brooklyn,30363003004,0,0,0,0.42
2020,CB2020,047,3,Brooklyn,30363004000,465,214,251,5.75
2020,CB2020,047,3,Brooklyn,30363004001,846,326,520,5.76
2020,CB2020,047,3,Brooklyn,30364001000,345,191,154,2.81
2020,CB2020,047,3,Brooklyn,30364001001,252,136,116,2.42
2020,CB2020,047,3,Brooklyn,30364001002,93,47,46,1.29
2020,CB2020,047,3,Brooklyn,30364001003,129,77,52,1.55
2020,CB2020,047,3,Brooklyn,30364001004,115,53,62,0.99
2020,CB2020,047,3,Brooklyn,30364001005,32,21,11,2.68
2020,CB2020,047,3,Brooklyn,30364001006,581,299,282,4.02
2020,CB2020,047,3,Brooklyn,30364001007,217,118,99,3.99
2020,CB2020,047,3,Brooklyn,30364002000,99,54,45,1.39
2020,CB2020,047,3,Brooklyn,30364002001,137,81,56,2.36
2020,CB2020,047,3,Brooklyn,30364002002,624,320,304,4.89
2020,CB2020,047,3,Brooklyn,30364002003,0,0,0,1.39
2020,CB2020,047,3,Brooklyn,30364002004,142,87,55,2.62
2020,CB2020,047,3,Brooklyn,30364002005,93,33,60,1.5
2020,CB2020,047,3,Brooklyn,30364002006,147,77,70,1.48
2020,CB2020,047,3,Brooklyn,30365011000,1652,696,956,10.27
2020,CB2020,047,3,Brooklyn,30365011001,41,12,29,5.02
2020,CB2020,047,3,Brooklyn,30365011002,414,201,213,5.55
2020,CB2020,047,3,Brooklyn,30365012000,464,215,249,5.31
2020,CB2020,047,3,Brooklyn,30365012001,305,145,160,4.31
2020,CB2020,047,3,Brooklyn,30365012002,83,46,37,0.77
2020,CB2020,047,3,Brooklyn,30365021000,0,0,0,0.57
2020,CB2020,047,3,Brooklyn,30365021001,0,0,0,1.47
2020,CB2020,047,3,Brooklyn,30365021002,0,0,0,0.8
2020,CB2020,047,3,Brooklyn,30365021003,382,184,198,3.36
2020,CB2020,047,3,Brooklyn,30365021004,256,157,99,3.78
2020,CB2020,047,3,Brooklyn,30365021005,322,154,168,3.64
2020,CB2020,047,3,Brooklyn,30365021006,86,28,58,1.35
2020,CB2020,047,3,Brooklyn,30365021007,177,144,33,1.08
2020,CB2020,047,3,Brooklyn,30365021008,147,65,82,3.01
2020,CB2020,047,3,Brooklyn,30365021009,191,78,113,2.34
2020,CB2020,047,3,Brooklyn,30365021010,139,48,91,2.68
2020,CB2020,047,3,Brooklyn,30365021011,53,21,32,1.09
2020,CB2020,047,3,Brooklyn,30365021012,149,100,49,4.45
2020,CB2020,047,3,Brooklyn,30365021013,0,0,0,0.55
2020,CB2020,047,3,Brooklyn,30366001000,0,0,0,5.74
2020,CB2020,047,3,Brooklyn,30366001001,0,0,0,0.31
2020,CB2020,047,3,Brooklyn,30366001002,0,0,0,2.03
2020,CB2020,047,3,Brooklyn,30366001003,0,0,0,0.28
2020,CB2020,047,3,Brooklyn,30366001004,0,0,0,2.72
2020,CB2020,047,3,Brooklyn,30366001005,0,0,0,3.48
2020,CB2020,047,3,Brooklyn,30366001006,391,189,202,2.39
2020,CB2020,047,3,Brooklyn,30366001007,0,0,0,0.61
2020,CB2020,047,3,Brooklyn,30366001008,234,136,98,1.9
2020,CB2020,047,3,Brooklyn,30366001009,572,311,261,3.52
2020,CB2020,047,3,Brooklyn,30366001010,270,111,159,1.95
2020,CB2020,047,3,Brooklyn,30366001011,0,0,0,0.33
2020,CB2020,047,3,Brooklyn,30366002000,599,256,343,12.26
2020,CB2020,047,3,Brooklyn,30366002001,1134,531,603,8.1
2020,CB2020,047,3,Brooklyn,30366002002,0,0,0,1.89
2020,CB2020,047,3,Brooklyn,30366003000,408,185,223,2.06
2020,CB2020,047,3,Brooklyn,30366003001,422,219,203,3.52
2020,CB2020,047,3,Brooklyn,30366003002,266,149,117,1.87
2020,CB2020,047,3,Brooklyn,30366003003,385,212,173,2.88
2020,CB2020,047,3,Brooklyn,30367001000,24,12,12,3.6
2020,CB2020,047,3,Brooklyn,30367001001,0,0,0,1.44
2020,CB2020,047,3,Brooklyn,30367001002,0,0,0,1.43
2020,CB2020,047,3,Brooklyn,30367001003,122,46,76,2.4
2020,CB2020,047,3,Brooklyn,30367001004,0,0,0,2.96
2020,CB2020,047,3,Brooklyn,30367001005,0,0,0,0.74
2020,CB2020,047,3,Brooklyn,30367002000,0,0,0,2.01
2020,CB2020,047,3,Brooklyn,30367002001,129,59,70,2.68
2020,CB2020,047,3,Brooklyn,30367002002,0,0,0,2.26
2020,CB2020,047,3,Brooklyn,30367002003,122,59,63,2.19
2020,CB2020,047,3,Brooklyn,30367002004,242,125,117,2.18
2020,CB2020,047,3,Brooklyn,30367002005,422,114,308,2.5
2020,CB2020,047,3,Brooklyn,30367003000,0,0,0,1.3
2020,CB2020,047,3,Brooklyn,30367003001,121,61,60,3.4
2020,CB2020,047,3,Brooklyn,30367003002,0,0,0,0.46
2020,CB2020,047,3,Brooklyn,30367003003,85,53,32,1.14
2020,CB2020,047,3,Brooklyn,30367003004,0,0,0,1.76
2020,CB2020,047,3,Brooklyn,30367003005,241,126,115,3.36
2020,CB2020,047,3,Brooklyn,30367003006,250,114,136,2.45
2020,CB2020,047,3,Brooklyn,30367004000,38,23,15,2.56
2020,CB2020,047,3,Brooklyn,30367004001,0,0,0,2.4
2020,CB2020,047,3,Brooklyn,30369001000,512,216,296,3.2
2020,CB2020,047,3,Brooklyn,30369001001,348,192,156,4.02
2020,CB2020,047,3,Brooklyn,30369001002,701,309,392,4.32
2020,CB2020,047,3,Brooklyn,30369001003,103,40,63,2.39
2020,CB2020,047,3,Brooklyn,30369002000,554,244,310,5.11
2020,CB2020,047,3,Brooklyn,30369002001,252,108,144,2.46
2020,CB2020,047,3,Brooklyn,30369002002,296,131,165,2.56
2020,CB2020,047,3,Brooklyn,30369002003,277,162,115,2.76
2020,CB2020,047,3,Brooklyn,30369003000,498,210,288,4.6
2020,CB2020,047,3,Brooklyn,30369003001,536,269,267,4.61
2020,CB2020,047,3,Brooklyn,30369003002,542,298,244,4.32
2020,CB2020,047,3,Brooklyn,30369003003,0,0,0,0.34
2020,CB2020,047,3,Brooklyn,30369004000,0,0,0,2.25
2020,CB2020,047,3,Brooklyn,30369004001,472,213,259,3.81
2020,CB2020,047,3,Brooklyn,30369004002,590,293,297,4.66
2020,CB2020,047,3,Brooklyn,30369004003,455,169,286,4.63
2020,CB2020,047,3,Brooklyn,30370001000,195,112,83,3.64
2020,CB2020,047,3,Brooklyn,30370001001,295,134,161,4.66
2020,CB2020,047,3,Brooklyn,30370001002,100,49,51,2.07
2020,CB2020,047,3,Brooklyn,30370001003,0,0,0,1.45
2020,CB2020,047,3,Brooklyn,30370001004,200,97,103,3.36
2020,CB2020,047,3,Brooklyn,30370001005,143,91,52,3.28
2020,CB2020,047,3,Brooklyn,30370001006,220,101,119,3.06
2020,CB2020,047,3,Brooklyn,30370001007,102,40,62,2.53
2020,CB2020,047,3,Brooklyn,30370002000,201,79,122,3.22
2020,CB2020,047,3,Brooklyn,30370002001,452,224,228,4.63
2020,CB2020,047,3,Brooklyn,30370002002,250,113,137,2.92
2020,CB2020,047,3,Brooklyn,30370002003,129,66,63,2.97
2020,CB2020,047,3,Brooklyn,30370003000,329,156,173,4.5
2020,CB2020,047,3,Brooklyn,30370003001,132,78,54,2.11
2020,CB2020,047,3,Brooklyn,30370003002,0,0,0,1.48
2020,CB2020,047,3,Brooklyn,30370003003,0,0,0,1.37
2020,CB2020,047,3,Brooklyn,30370003004,354,199,155,12.41
2020,CB2020,047,3,Brooklyn,30370003005,281,173,108,3.16
2020,CB2020,047,3,Brooklyn,30370003006,202,78,124,2.46
2020,CB2020,047,3,Brooklyn,30370003007,338,160,178,4.73
2020,CB2020,047,3,Brooklyn,30370004000,0,0,0,3.08
2020,CB2020,047,3,Brooklyn,30370004001,361,175,186,4.92
2020,CB2020,047,3,Brooklyn,30370004002,228,115,113,2.48
2020,CB2020,047,3,Brooklyn,30370004003,238,106,132,2.59
2020,CB2020,047,3,Brooklyn,30371001000,254,128,126,4.62
2020,CB2020,047,3,Brooklyn,30371001001,512,237,275,4.61
2020,CB2020,047,3,Brooklyn,30371002000,487,242,245,4.61
2020,CB2020,047,3,Brooklyn,30371002001,441,213,228,4.61
2020,CB2020,047,3,Brooklyn,30371003000,442,210,232,4.67
2020,CB2020,047,3,Brooklyn,30371003001,527,256,271,4.65
2020,CB2020,047,3,Brooklyn,30371004000,573,264,309,4.57
2020,CB2020,047,3,Brooklyn,30371004001,479,233,246,4.59
2020,CB2020,047,3,Brooklyn,30371005000,409,209,200,5.04
2020,CB2020,047,3,Brooklyn,30371005001,359,160,199,3.5
2020,CB2020,047,3,Brooklyn,30371005002,20,13,7,1.31
2020,CB2020,047,3,Brooklyn,30373001000,0,0,0,1.44
2020,CB2020,047,3,Brooklyn,30373001001,384,186,198,3.02
2020,CB2020,047,3,Brooklyn,30373001002,346,120,226,4.57
2020,CB2020,047,3,Brooklyn,30373001003,61,24,37,1.16
2020,CB2020,047,3,Brooklyn,30373001004,221,113,108,2.59
2020,CB2020,047,3,Brooklyn,30373001005,93,47,46,0.7
2020,CB2020,047,3,Brooklyn,30373001006,132,65,67,0.81
2020,CB2020,047,3,Brooklyn,30373002000,525,236,289,4.81
2020,CB2020,047,3,Brooklyn,30373002001,492,228,264,4.62
2020,CB2020,047,3,Brooklyn,30373003000,417,188,229,4.62
2020,CB2020,047,3,Brooklyn,30373003001,545,267,278,4.63
2020,CB2020,047,3,Brooklyn,30373004000,681,322,359,4.62
2020,CB2020,047,3,Brooklyn,30373004001,488,205,283,4.61
2020,CB2020,047,3,Brooklyn,30374011000,488,218,270,4.66
2020,CB2020,047,3,Brooklyn,30374011001,216,126,90,4.65
2020,CB2020,047,3,Brooklyn,30374012000,0,0,0,0.49
2020,CB2020,047,3,Brooklyn,30374012001,307,150,157,3.19
2020,CB2020,047,3,Brooklyn,30374012002,420,202,218,4.65
2020,CB2020,047,3,Brooklyn,30374012003,259,111,148,2.57
2020,CB2020,047,3,Brooklyn,30374012004,0,0,0,0.97
2020,CB2020,047,3,Brooklyn,30374012005,121,62,59,2.11
2020,CB2020,047,3,Brooklyn,30374013000,0,0,0,1.52
2020,CB2020,047,3,Brooklyn,30374013001,158,69,89,0.82
2020,CB2020,047,3,Brooklyn,30374013002,137,74,63,2.4
2020,CB2020,047,3,Brooklyn,30374013003,99,34,65,1.76
2020,CB2020,047,3,Brooklyn,30374013004,44,19,25,0.75
2020,CB2020,047,3,Brooklyn,30374013005,247,120,127,2.16
2020,CB2020,047,3,Brooklyn,30374014000,295,132,163,4.66
2020,CB2020,047,3,Brooklyn,30374014001,429,232,197,4.65
2020,CB2020,047,3,Brooklyn,30374015000,0,0,0,0.53
2020,CB2020,047,3,Brooklyn,30374015001,231,96,135,1.25
2020,CB2020,047,3,Brooklyn,30374015002,371,176,195,3.68
2020,CB2020,047,3,Brooklyn,30374015003,313,150,163,1.29
2020,CB2020,047,3,Brooklyn,30374015004,0,0,0,0.88
2020,CB2020,047,3,Brooklyn,30374015005,0,0,0,0.46
2020,CB2020,047,3,Brooklyn,30374015006,282,142,140,2.71
2020,CB2020,047,3,Brooklyn,30374015007,279,137,142,2.93
2020,CB2020,047,3,Brooklyn,30374021000,466,214,252,4.65
2020,CB2020,047,3,Brooklyn,30374021001,341,176,165,4.61
2020,CB2020,047,3,Brooklyn,30374021002,91,36,55,4.43
2020,CB2020,047,3,Brooklyn,30374021003,53,35,18,2.8
2020,CB2020,047,3,Brooklyn,30374021004,0,0,0,3.01
2020,CB2020,047,3,Brooklyn,30374021005,240,110,130,4.65
2020,CB2020,047,3,Brooklyn,30374021006,166,77,89,3.14
2020,CB2020,047,3,Brooklyn,30374021007,302,144,158,3.61
2020,CB2020,047,3,Brooklyn,30374022000,561,273,288,5.06
2020,CB2020,047,3,Brooklyn,30374022001,626,266,360,9.54
2020,CB2020,047,3,Brooklyn,30374022002,242,121,121,2.2
2020,CB2020,047,3,Brooklyn,30374022003,248,129,119,2.97
2020,CB2020,047,3,Brooklyn,30374023000,1015,501,514,9.84
2020,CB2020,047,3,Brooklyn,30374024000,372,192,180,4.66
2020,CB2020,047,3,Brooklyn,30374024001,106,44,62,4.66
2020,CB2020,047,3,Brooklyn,30374024002,538,285,253,4.66
2020,CB2020,047,3,Brooklyn,30375001000,200,87,113,2.25
2020,CB2020,047,3,Brooklyn,30375001001,226,94,132,2.52
2020,CB2020,047,3,Brooklyn,30375001002,422,202,220,2.94
2020,CB2020,047,3,Brooklyn,30375001003,108,48,60,1.68
2020,CB2020,047,3,Brooklyn,30375002000,57,22,35,0.89
2020,CB2020,047,3,Brooklyn,30375002001,67,36,31,2.52
2020,CB2020,047,3,Brooklyn,30375002002,358,172,186,4.11
2020,CB2020,047,3,Brooklyn,30375002003,509,269,240,4.61
2020,CB2020,047,3,Brooklyn,30375002004,0,0,0,1.25
2020,CB2020,047,3,Brooklyn,30375002005,353,172,181,2.83
2020,CB2020,047,3,Brooklyn,30375002006,578,293,285,4.63
2020,CB2020,047,3,Brooklyn,30375003000,367,166,201,4.41
2020,CB2020,047,3,Brooklyn,30375003001,564,272,292,4.61
2020,CB2020,047,3,Brooklyn,30377001000,707,365,342,4.77
2020,CB2020,047,3,Brooklyn,30377001001,165,86,79,4.61
2020,CB2020,047,3,Brooklyn,30377002000,0,0,0,4.78
2020,CB2020,047,3,Brooklyn,30377002001,520,224,296,4.77
2020,CB2020,047,3,Brooklyn,30377002002,447,230,217,4.77
2020,CB2020,047,3,Brooklyn,30377003000,468,234,234,4.77
2020,CB2020,047,3,Brooklyn,30377003001,533,230,303,4.67
2020,CB2020,047,3,Brooklyn,30377004000,425,202,223,4.62
2020,CB2020,047,3,Brooklyn,30377004001,353,149,204,4.62
2020,CB2020,047,3,Brooklyn,30377004002,352,157,195,4.62
2020,CB2020,047,3,Brooklyn,30379001000,559,252,307,4.78
2020,CB2020,047,3,Brooklyn,30379001001,470,205,265,4.66
2020,CB2020,047,3,Brooklyn,30379002000,510,237,273,4.79
2020,CB2020,047,3,Brooklyn,30379002001,422,218,204,4.71
2020,CB2020,047,3,Brooklyn,30379002002,91,48,43,4.69
2020,CB2020,047,3,Brooklyn,30379002003,413,192,221,4.74
2020,CB2020,047,3,Brooklyn,30379003000,499,230,269,4.77
2020,CB2020,047,3,Brooklyn,30379003001,364,156,208,4.75
2020,CB2020,047,3,Brooklyn,30379003002,124,76,48,2.16
2020,CB2020,047,3,Brooklyn,30379003003,367,157,210,4.62
2020,CB2020,047,3,Brooklyn,30379003004,32,18,14,0.74
2020,CB2020,047,3,Brooklyn,30381001000,576,221,355,5.69
2020,CB2020,047,3,Brooklyn,30381001001,619,289,330,5.73
2020,CB2020,047,3,Brooklyn,30381002000,2307,934,1373,21.18
2020,CB2020,047,3,Brooklyn,30381003000,575,246,329,5.09
2020,CB2020,047,3,Brooklyn,30381003001,0,0,0,5.25
2020,CB2020,047,3,Brooklyn,30381003002,262,133,129,6.08
2020,CB2020,047,3,Brooklyn,30381004000,426,170,256,5.06
2020,CB2020,047,3,Brooklyn,30381004001,548,263,285,5.12
2020,CB2020,047,3,Brooklyn,30382001000,540,287,253,4.77
2020,CB2020,047,3,Brooklyn,30382001001,561,277,284,4.63
2020,CB2020,047,3,Brooklyn,30382001002,221,97,124,4.97
2020,CB2020,047,3,Brooklyn,30382002000,2262,967,1295,16.24
2020,CB2020,047,3,Brooklyn,30382003000,2298,1006,1292,27.07
2020,CB2020,047,3,Brooklyn,30383001000,507,240,267,3.27
2020,CB2020,047,3,Brooklyn,30383001001,249,117,132,2.44
2020,CB2020,047,3,Brooklyn,30383001002,320,142,178,2.84
2020,CB2020,047,3,Brooklyn,30383001003,156,69,87,1.93
2020,CB2020,047,3,Brooklyn,30383001004,44,23,21,0.31
2020,CB2020,047,3,Brooklyn,30383002000,636,278,358,5.7
2020,CB2020,047,3,Brooklyn,30383002001,553,232,321,5.08
2020,CB2020,047,3,Brooklyn,30383003000,453,176,277,5.7
2020,CB2020,047,3,Brooklyn,30383003001,509,255,254,5.08
2020,CB2020,047,3,Brooklyn,30383004000,451,209,242,5.71
2020,CB2020,047,3,Brooklyn,30383004001,460,215,245,5.08
2020,CB2020,047,3,Brooklyn,30385001000,629,282,347,5.7
2020,CB2020,047,3,Brooklyn,30385001001,537,272,265,5.08
2020,CB2020,047,3,Brooklyn,30385002000,0,0,0,5.67
2020,CB2020,047,3,Brooklyn,30385002001,577,290,287,5.07
2020,CB2020,047,3,Brooklyn,30385003000,717,368,349,5.72
2020,CB2020,047,3,Brooklyn,30385003001,590,247,343,5.1
2020,CB2020,047,3,Brooklyn,30385004000,474,229,245,5.68
2020,CB2020,047,3,Brooklyn,30385004001,445,195,250,5.07
2020,CB2020,047,3,Brooklyn,30386001000,203,137,66,2.72
2020,CB2020,047,3,Brooklyn,30386001001,155,89,66,4.17
2020,CB2020,047,3,Brooklyn,30386001002,231,97,134,4.02
2020,CB2020,047,3,Brooklyn,30386001003,286,135,151,3.43
2020,CB2020,047,3,Brooklyn,30386001004,379,197,182,2.3
2020,CB2020,047,3,Brooklyn,30386001005,137,47,90,4.35
2020,CB2020,047,3,Brooklyn,30386001006,256,106,150,6.16
2020,CB2020,047,3,Brooklyn,30386001007,185,88,97,2.11
2020,CB2020,047,3,Brooklyn,30386001008,155,61,94,2.38
2020,CB2020,047,3,Brooklyn,30386001009,168,75,93,2.91
2020,CB2020,047,3,Brooklyn,30386002000,91,43,48,1.52
2020,CB2020,047,3,Brooklyn,30386002001,104,48,56,2.63
2020,CB2020,047,3,Brooklyn,30386002002,376,212,164,5.53
2020,CB2020,047,3,Brooklyn,30386002003,114,48,66,1.85
2020,CB2020,047,3,Brooklyn,30386002004,81,19,62,1.9
2020,CB2020,047,3,Brooklyn,30386002005,121,59,62,2.21
2020,CB2020,047,3,Brooklyn,30386002006,28,12,16,0.51
2020,CB2020,047,3,Brooklyn,30386002007,204,112,92,3.56
2020,CB2020,047,3,Brooklyn,30386002008,85,35,50,1.48
2020,CB2020,047,3,Brooklyn,30386002009,453,221,232,5.96
2020,CB2020,047,3,Brooklyn,30386002010,0,0,0,0.38
2020,CB2020,047,3,Brooklyn,30387001000,32,13,19,1.58
2020,CB2020,047,3,Brooklyn,30387001001,303,124,179,3.28
2020,CB2020,047,3,Brooklyn,30387001002,579,329,250,4.84
2020,CB2020,047,3,Brooklyn,30387001003,604,276,328,5.76
2020,CB2020,047,3,Brooklyn,30387002000,543,241,302,5.68
2020,CB2020,047,3,Brooklyn,30387002001,478,216,262,5.07
2020,CB2020,047,3,Brooklyn,30387003000,664,306,358,5.07
2020,CB2020,047,3,Brooklyn,30387003001,576,278,298,5.1
2020,CB2020,047,3,Brooklyn,30387004000,620,317,303,5.08
2020,CB2020,047,3,Brooklyn,30387004001,509,254,255,5.08
2020,CB2020,047,3,Brooklyn,30388001000,322,169,153,1.57
2020,CB2020,047,3,Brooklyn,30388001001,138,52,86,3.68
2020,CB2020,047,3,Brooklyn,30388001002,658,312,346,4.66
2020,CB2020,047,3,Brooklyn,30388002000,41,29,12,1.12
2020,CB2020,047,3,Brooklyn,30388002001,0,0,0,0.28
2020,CB2020,047,3,Brooklyn,30388002002,373,183,190,4.58
2020,CB2020,047,3,Brooklyn,30388002003,174,99,75,4.13
2020,CB2020,047,3,Brooklyn,30388002004,625,285,340,4.66
2020,CB2020,047,3,Brooklyn,30388003000,331,158,173,4.66
2020,CB2020,047,3,Brooklyn,30388003001,319,159,160,4.66
2020,CB2020,047,3,Brooklyn,30388003002,314,157,157,4.66
2020,CB2020,047,3,Brooklyn,30388004000,399,186,213,5.04
2020,CB2020,047,3,Brooklyn,30388004001,353,188,165,5.21
2020,CB2020,047,3,Brooklyn,30389001000,203,119,84,2.68
2020,CB2020,047,3,Brooklyn,30389001001,463,215,248,6.61
2020,CB2020,047,3,Brooklyn,30389001002,311,178,133,2.91
2020,CB2020,047,3,Brooklyn,30389001003,0,0,0,1.1
2020,CB2020,047,3,Brooklyn,30389001004,397,136,261,3.28
2020,CB2020,047,3,Brooklyn,30389001005,252,125,127,3.35
2020,CB2020,047,3,Brooklyn,30389002000,236,137,99,3.21
2020,CB2020,047,3,Brooklyn,30389002001,229,118,111,3.37
2020,CB2020,047,3,Brooklyn,30389002002,408,218,190,2.96
2020,CB2020,047,3,Brooklyn,30389003000,339,193,146,3.32
2020,CB2020,047,3,Brooklyn,30389003001,315,162,153,3.56
2020,CB2020,047,3,Brooklyn,30389003002,388,198,190,2.61
2020,CB2020,047,3,Brooklyn,30389003003,29,8,21,1.32
2020,CB2020,047,3,Brooklyn,30390001000,184,107,77,4.03
2020,CB2020,047,3,Brooklyn,30390001001,155,71,84,2.11
2020,CB2020,047,3,Brooklyn,30390001002,0,0,0,0.97
2020,CB2020,047,3,Brooklyn,30390001003,0,0,0,0.51
2020,CB2020,047,3,Brooklyn,30390001004,238,142,96,2.39
2020,CB2020,047,3,Brooklyn,30390001005,80,20,60,0.73
2020,CB2020,047,3,Brooklyn,30390001006,117,87,30,2.51
2020,CB2020,047,3,Brooklyn,30390001007,280,129,151,3.69
2020,CB2020,047,3,Brooklyn,30390001008,169,95,74,2.62
2020,CB2020,047,3,Brooklyn,30390001009,76,34,42,1.13
2020,CB2020,047,3,Brooklyn,30390002000,0,0,0,0.82
2020,CB2020,047,3,Brooklyn,30390002001,178,99,79,2.91
2020,CB2020,047,3,Brooklyn,30390002002,91,28,63,2
2020,CB2020,047,3,Brooklyn,30390002003,140,85,55,3.26
2020,CB2020,047,3,Brooklyn,30390002004,106,59,47,3.29
2020,CB2020,047,3,Brooklyn,30390002005,0,0,0,0.73
2020,CB2020,047,3,Brooklyn,30390002006,0,0,0,1.45
2020,CB2020,047,3,Brooklyn,30390002007,173,81,92,2.59
2020,CB2020,047,3,Brooklyn,30390002008,211,94,117,3.07
2020,CB2020,047,3,Brooklyn,30390002009,123,60,63,2.15
2020,CB2020,047,3,Brooklyn,30391001000,998,496,502,9.54
2020,CB2020,047,3,Brooklyn,30391001001,402,186,216,2.48
2020,CB2020,047,3,Brooklyn,30391001002,992,523,469,4.66
2020,CB2020,047,3,Brooklyn,30391001003,934,418,516,4.86
2020,CB2020,047,3,Brooklyn,30391001004,348,168,180,2.66
2020,CB2020,047,3,Brooklyn,30391002000,199,83,116,3.55
2020,CB2020,047,3,Brooklyn,30391002001,50,43,7,1.1
2020,CB2020,047,3,Brooklyn,30391002002,669,319,350,4.44
2020,CB2020,047,3,Brooklyn,30391002003,293,173,120,2.23
2020,CB2020,047,3,Brooklyn,30391002004,643,318,325,3.96
2020,CB2020,047,3,Brooklyn,30391002005,248,116,132,1.58
2020,CB2020,047,3,Brooklyn,30392001000,131,67,64,4
2020,CB2020,047,3,Brooklyn,30392001001,344,182,162,4.67
2020,CB2020,047,3,Brooklyn,30392001002,432,220,212,5.38
2020,CB2020,047,3,Brooklyn,30392001003,300,147,153,5.46
2020,CB2020,047,3,Brooklyn,30392001004,0,0,0,1.42
2020,CB2020,047,3,Brooklyn,30392002000,504,280,224,6.34
2020,CB2020,047,3,Brooklyn,30392002001,208,99,109,4.22
2020,CB2020,047,3,Brooklyn,30392002002,439,196,243,3.72
2020,CB2020,047,3,Brooklyn,30392002003,0,0,0,0.89
2020,CB2020,047,3,Brooklyn,30392002004,0,0,0,0.76
2020,CB2020,047,3,Brooklyn,30392002005,284,134,150,2.41
2020,CB2020,047,3,Brooklyn,30392002006,266,92,174,3.87
2020,CB2020,047,3,Brooklyn,30393001000,240,138,102,3.26
2020,CB2020,047,3,Brooklyn,30393001001,214,115,99,2.12
2020,CB2020,047,3,Brooklyn,30393001002,0,0,0,0.31
2020,CB2020,047,3,Brooklyn,30393001003,315,166,149,2.95
2020,CB2020,047,3,Brooklyn,30393001004,553,252,301,4.21
2020,CB2020,047,3,Brooklyn,30393001005,0,0,0,2.78
2020,CB2020,047,3,Brooklyn,30393002000,291,152,139,3.25
2020,CB2020,047,3,Brooklyn,30393002001,144,83,61,2.65
2020,CB2020,047,3,Brooklyn,30393002002,455,218,237,3.53
2020,CB2020,047,3,Brooklyn,30393002003,275,126,149,2.75
2020,CB2020,047,3,Brooklyn,30393002004,251,132,119,2.89
2020,CB2020,047,3,Brooklyn,30393003000,369,203,166,3.05
2020,CB2020,047,3,Brooklyn,30393003001,320,156,164,3.81
2020,CB2020,047,3,Brooklyn,30393003002,274,141,133,5.8
2020,CB2020,047,3,Brooklyn,30393003003,440,241,199,3.51
2020,CB2020,047,3,Brooklyn,30394001000,311,162,149,5.58
2020,CB2020,047,3,Brooklyn,30394001001,384,189,195,4.96
2020,CB2020,047,3,Brooklyn,30394002000,325,151,174,5.75
2020,CB2020,047,3,Brooklyn,30394002001,288,150,138,5.83
2020,CB2020,047,3,Brooklyn,30394002002,0,0,0,1.52
2020,CB2020,047,3,Brooklyn,30394003000,0,0,0,1.46
2020,CB2020,047,3,Brooklyn,30394003001,195,80,115,5.87
2020,CB2020,047,3,Brooklyn,30394003002,143,88,55,4.96
2020,CB2020,047,3,Brooklyn,30394003003,293,162,131,4.66
2020,CB2020,047,3,Brooklyn,30394003004,248,124,124,5.52
2020,CB2020,047,3,Brooklyn,30394003005,0,0,0,1.37
2020,CB2020,047,3,Brooklyn,30395001000,310,169,141,2.63
2020,CB2020,047,3,Brooklyn,30395001001,247,119,128,2.59
2020,CB2020,047,3,Brooklyn,30395001002,337,137,200,2.54
2020,CB2020,047,3,Brooklyn,30395001003,269,136,133,2.4
2020,CB2020,047,3,Brooklyn,30395002000,365,173,192,3.74
2020,CB2020,047,3,Brooklyn,30395002001,468,208,260,3.82
2020,CB2020,047,3,Brooklyn,30395002002,495,255,240,5.02
2020,CB2020,047,3,Brooklyn,30395002003,357,110,247,4.89
2020,CB2020,047,3,Brooklyn,30395003000,392,207,185,2.74
2020,CB2020,047,3,Brooklyn,30395003001,358,178,180,2.72
2020,CB2020,047,3,Brooklyn,30395003002,115,40,75,2.66
2020,CB2020,047,3,Brooklyn,30395003003,317,185,132,3.71
2020,CB2020,047,3,Brooklyn,30396001000,146,58,88,4.96
2020,CB2020,047,3,Brooklyn,30396001001,188,101,87,4.95
2020,CB2020,047,3,Brooklyn,30396001002,249,120,129,4.66
2020,CB2020,047,3,Brooklyn,30396001003,161,87,74,4.65
2020,CB2020,047,3,Brooklyn,30396002000,184,73,111,4.96
2020,CB2020,047,3,Brooklyn,30396002001,207,112,95,4.95
2020,CB2020,047,3,Brooklyn,30396002002,329,165,164,4.9
2020,CB2020,047,3,Brooklyn,30396002003,390,204,186,5.01
2020,CB2020,047,3,Brooklyn,30396002004,94,58,36,1.32
2020,CB2020,047,3,Brooklyn,30397001000,488,259,229,3.71
2020,CB2020,047,3,Brooklyn,30397001001,324,150,174,4.06
2020,CB2020,047,3,Brooklyn,30397001002,415,195,220,3.9
2020,CB2020,047,3,Brooklyn,30397002000,397,184,213,3.88
2020,CB2020,047,3,Brooklyn,30397002001,531,246,285,3.89
2020,CB2020,047,3,Brooklyn,30397002002,255,129,126,3.92
2020,CB2020,047,3,Brooklyn,30397003000,264,134,130,4.29
2020,CB2020,047,3,Brooklyn,30397003001,641,283,358,3.88
2020,CB2020,047,3,Brooklyn,30397003002,230,100,130,3.9
2020,CB2020,047,3,Brooklyn,30397003003,323,147,176,3.89
2020,CB2020,047,3,Brooklyn,30398001000,234,110,124,2.77
2020,CB2020,047,3,Brooklyn,30398001001,59,28,31,0.71
2020,CB2020,047,3,Brooklyn,30398001002,0,0,0,0.35
2020,CB2020,047,3,Brooklyn,30398001003,34,18,16,5.34
2020,CB2020,047,3,Brooklyn,30398001004,150,64,86,2.01
2020,CB2020,047,3,Brooklyn,30398001005,270,106,164,3.47
2020,CB2020,047,3,Brooklyn,30398001006,197,121,76,2.47
2020,CB2020,047,3,Brooklyn,30398001007,77,25,52,1.12
2020,CB2020,047,3,Brooklyn,30398001008,126,71,55,1.55
2020,CB2020,047,3,Brooklyn,30398001009,170,91,79,5.17
2020,CB2020,047,3,Brooklyn,30398001010,303,152,151,5.45
2020,CB2020,047,3,Brooklyn,30398001011,85,63,22,5.39
2020,CB2020,047,3,Brooklyn,30398002000,292,140,152,3.22
2020,CB2020,047,3,Brooklyn,30398002001,126,62,64,1.95
2020,CB2020,047,3,Brooklyn,30398002002,257,131,126,2.7
2020,CB2020,047,3,Brooklyn,30398002003,176,72,104,2.59
2020,CB2020,047,3,Brooklyn,30398002004,182,98,84,2.06
2020,CB2020,047,3,Brooklyn,30398002005,103,71,32,1.8
2020,CB2020,047,3,Brooklyn,30399001000,459,247,212,4.01
2020,CB2020,047,3,Brooklyn,30399001001,492,264,228,4
2020,CB2020,047,3,Brooklyn,30399001002,518,249,269,4.02
2020,CB2020,047,3,Brooklyn,30399002000,606,254,352,4
2020,CB2020,047,3,Brooklyn,30399002001,57,30,27,3.87
2020,CB2020,047,3,Brooklyn,30399002002,345,155,190,3.65
2020,CB2020,047,3,Brooklyn,30399002003,821,286,535,4
2020,CB2020,047,3,Brooklyn,30399003000,379,169,210,3.44
2020,CB2020,047,3,Brooklyn,30399003001,345,153,192,3.2
2020,CB2020,047,3,Brooklyn,30399003002,356,175,181,3.17
2020,CB2020,047,3,Brooklyn,30400001000,110,48,62,2.06
2020,CB2020,047,3,Brooklyn,30400001001,188,80,108,4.51
2020,CB2020,047,3,Brooklyn,30400001002,291,134,157,5.11
2020,CB2020,047,3,Brooklyn,30400001003,301,160,141,4.94
2020,CB2020,047,3,Brooklyn,30400001004,190,110,80,2.99
2020,CB2020,047,3,Brooklyn,30400001005,154,59,95,2.3
2020,CB2020,047,3,Brooklyn,30400002000,415,209,206,4.95
2020,CB2020,047,3,Brooklyn,30400002001,324,156,168,5.33
2020,CB2020,047,3,Brooklyn,30400003000,494,253,241,5.33
2020,CB2020,047,3,Brooklyn,30400003001,152,88,64,2.26
2020,CB2020,047,3,Brooklyn,30400003002,194,91,103,2.71
2020,CB2020,047,3,Brooklyn,30400003003,468,238,230,4.95
2020,CB2020,047,3,Brooklyn,30401001000,385,181,204,4.01
2020,CB2020,047,3,Brooklyn,30401001001,118,52,66,4
2020,CB2020,047,3,Brooklyn,30401001002,463,216,247,3.9
2020,CB2020,047,3,Brooklyn,30401002000,411,203,208,3.86
2020,CB2020,047,3,Brooklyn,30401002001,388,181,207,3.86
2020,CB2020,047,3,Brooklyn,30401002002,464,229,235,3.9
2020,CB2020,047,3,Brooklyn,30401003000,201,105,96,1.66
2020,CB2020,047,3,Brooklyn,30401003001,261,107,154,2.34
2020,CB2020,047,3,Brooklyn,30401003002,404,201,203,4
2020,CB2020,047,3,Brooklyn,30401003003,320,148,172,4
2020,CB2020,047,3,Brooklyn,30401003004,246,123,123,2.75
2020,CB2020,047,3,Brooklyn,30401003005,117,79,38,1.14
2020,CB2020,047,3,Brooklyn,30402001000,0,0,0,5
2020,CB2020,047,3,Brooklyn,30402002000,395,183,212,4.97
2020,CB2020,047,3,Brooklyn,30402002001,390,194,196,4.97
2020,CB2020,047,3,Brooklyn,30402002002,264,120,144,3.72
2020,CB2020,047,3,Brooklyn,30402002003,0,0,0,1.6
2020,CB2020,047,3,Brooklyn,30402003000,449,218,231,4.96
2020,CB2020,047,3,Brooklyn,30402003001,361,177,184,4.96
2020,CB2020,047,3,Brooklyn,30402004000,206,84,122,2.37
2020,CB2020,047,3,Brooklyn,30402004001,292,153,139,2.17
2020,CB2020,047,3,Brooklyn,30402004002,71,28,43,1.86
2020,CB2020,047,3,Brooklyn,30402004003,0,0,0,0.32
2020,CB2020,047,3,Brooklyn,30402004004,131,56,75,4.35
2020,CB2020,047,3,Brooklyn,30402004005,198,122,76,2.82
2020,CB2020,047,3,Brooklyn,30402004006,62,34,28,1.15
2020,CB2020,047,3,Brooklyn,30402004007,53,25,28,1.31
2020,CB2020,047,3,Brooklyn,30402004008,153,90,63,2.27
2020,CB2020,047,3,Brooklyn,30403001000,43,25,18,3.03
2020,CB2020,047,3,Brooklyn,30403001001,24,18,6,6.54
2020,CB2020,047,3,Brooklyn,30403001002,486,244,242,4.03
2020,CB2020,047,3,Brooklyn,30403001003,349,160,189,4.61
2020,CB2020,047,3,Brooklyn,30403001004,109,58,51,2.39
2020,CB2020,047,3,Brooklyn,30403001005,425,195,230,3.89
2020,CB2020,047,3,Brooklyn,30403002000,386,182,204,3.9
2020,CB2020,047,3,Brooklyn,30403002001,440,216,224,3.82
2020,CB2020,047,3,Brooklyn,30403002002,101,56,45,3.75
2020,CB2020,047,3,Brooklyn,30403002003,310,136,174,3.97
2020,CB2020,047,3,Brooklyn,30403003000,413,191,222,4.02
2020,CB2020,047,3,Brooklyn,30403003001,252,110,142,4.01
2020,CB2020,047,3,Brooklyn,30403003002,554,270,284,4.01
2020,CB2020,047,3,Brooklyn,30404001000,28,10,18,1.19
2020,CB2020,047,3,Brooklyn,30404001001,510,257,253,5.4
2020,CB2020,047,3,Brooklyn,30404001002,441,238,203,5.11
2020,CB2020,047,3,Brooklyn,30404001003,317,116,201,5.25
2020,CB2020,047,3,Brooklyn,30404002000,46,25,21,1.9
2020,CB2020,047,3,Brooklyn,30404002001,177,82,95,2.2
2020,CB2020,047,3,Brooklyn,30404002002,553,264,289,5.81
2020,CB2020,047,3,Brooklyn,30404002003,271,127,144,5.47
2020,CB2020,047,3,Brooklyn,30404002004,469,277,192,5.64
2020,CB2020,047,3,Brooklyn,30405001000,177,78,99,2.72
2020,CB2020,047,3,Brooklyn,30405001001,0,0,0,2.5
2020,CB2020,047,3,Brooklyn,30405001002,314,135,179,3.92
2020,CB2020,047,3,Brooklyn,30405001003,277,129,148,2.78
2020,CB2020,047,3,Brooklyn,30405001004,196,97,99,2.37
2020,CB2020,047,3,Brooklyn,30405001005,72,37,35,1.66
2020,CB2020,047,3,Brooklyn,30405001006,0,0,0,2.62
2020,CB2020,047,3,Brooklyn,30405001007,0,0,0,0.92
2020,CB2020,047,3,Brooklyn,30405001008,44,21,23,3.91
2020,CB2020,047,3,Brooklyn,30405001009,0,0,0,0.6
2020,CB2020,047,3,Brooklyn,30405001010,126,60,66,2.67
2020,CB2020,047,3,Brooklyn,30405002000,330,154,176,3.85
2020,CB2020,047,3,Brooklyn,30405002001,293,142,151,3.83
2020,CB2020,047,3,Brooklyn,30406001000,583,280,303,5.11
2020,CB2020,047,3,Brooklyn,30406001001,297,145,152,5.1
2020,CB2020,047,3,Brooklyn,30406001002,425,215,210,5.1
2020,CB2020,047,3,Brooklyn,30406002000,685,353,332,5.25
2020,CB2020,047,3,Brooklyn,30406002001,365,171,194,5.26
2020,CB2020,047,3,Brooklyn,30406003000,513,250,263,5.25
2020,CB2020,047,3,Brooklyn,30406003001,731,372,359,5.26
2020,CB2020,047,3,Brooklyn,30407001000,6,3,3,124.75
2020,CB2020,047,3,Brooklyn,30408001000,532,289,243,5.51
2020,CB2020,047,3,Brooklyn,30408001001,575,305,270,5.66
2020,CB2020,047,3,Brooklyn,30408002000,490,247,243,5.51
2020,CB2020,047,3,Brooklyn,30408002001,653,324,329,5.65
2020,CB2020,047,3,Brooklyn,30408003000,261,118,143,2.22
2020,CB2020,047,3,Brooklyn,30408003001,305,143,162,2.88
2020,CB2020,047,3,Brooklyn,30408003002,650,318,332,5.1
2020,CB2020,047,3,Brooklyn,30408003003,200,113,87,2.87
2020,CB2020,047,3,Brooklyn,30408003004,267,154,113,2.39
2020,CB2020,047,3,Brooklyn,30409001000,565,262,303,4.3
2020,CB2020,047,3,Brooklyn,30409001001,613,284,329,4.31
2020,CB2020,047,3,Brooklyn,30409001002,174,108,66,4.2
2020,CB2020,047,3,Brooklyn,30409001003,75,26,49,3.01
2020,CB2020,047,3,Brooklyn,30409001004,73,35,38,6.45
2020,CB2020,047,3,Brooklyn,30409002000,634,335,299,4
2020,CB2020,047,3,Brooklyn,30409002001,485,213,272,4.01
2020,CB2020,047,3,Brooklyn,30409002002,0,0,0,4
2020,CB2020,047,3,Brooklyn,30409003000,708,345,363,4.31
2020,CB2020,047,3,Brooklyn,30409003001,473,223,250,4
2020,CB2020,047,3,Brooklyn,30410001000,170,87,83,4.78
2020,CB2020,047,3,Brooklyn,30410001001,294,150,144,5.42
2020,CB2020,047,3,Brooklyn,30410001002,163,90,73,4.47
2020,CB2020,047,3,Brooklyn,30410001003,99,40,59,1.42
2020,CB2020,047,3,Brooklyn,30410001004,292,145,147,3.74
2020,CB2020,047,3,Brooklyn,30410002000,331,143,188,5.13
2020,CB2020,047,3,Brooklyn,30410002001,421,199,222,5.1
2020,CB2020,047,3,Brooklyn,30410002002,366,178,188,5.24
2020,CB2020,047,3,Brooklyn,30411001000,518,276,242,4
2020,CB2020,047,3,Brooklyn,30411001001,545,247,298,4.01
2020,CB2020,047,3,Brooklyn,30411001002,273,141,132,5.31
2020,CB2020,047,3,Brooklyn,30411002000,379,147,232,4.01
2020,CB2020,047,3,Brooklyn,30411002001,452,212,240,4.01
2020,CB2020,047,3,Brooklyn,30411002002,279,130,149,3.99
2020,CB2020,047,3,Brooklyn,30411003000,466,246,220,4
2020,CB2020,047,3,Brooklyn,30411003001,420,185,235,4
2020,CB2020,047,3,Brooklyn,30412001000,396,200,196,5.7
2020,CB2020,047,3,Brooklyn,30412001001,610,280,330,4.92
2020,CB2020,047,3,Brooklyn,30412001002,445,202,243,5.86
2020,CB2020,047,3,Brooklyn,30412001003,191,120,71,4.85
2020,CB2020,047,3,Brooklyn,30412002000,549,251,298,4.24
2020,CB2020,047,3,Brooklyn,30412002001,472,243,229,3.79
2020,CB2020,047,3,Brooklyn,30412002002,528,251,277,7.82
2020,CB2020,047,3,Brooklyn,30412002003,184,89,95,3.67
2020,CB2020,047,3,Brooklyn,30413001000,491,215,276,4.02
2020,CB2020,047,3,Brooklyn,30413001001,464,259,205,4.01
2020,CB2020,047,3,Brooklyn,30413001002,238,112,126,4
2020,CB2020,047,3,Brooklyn,30413001003,0,0,0,4
2020,CB2020,047,3,Brooklyn,30413002000,276,116,160,2.6
2020,CB2020,047,3,Brooklyn,30413002001,171,106,65,1.4
2020,CB2020,047,3,Brooklyn,30413002002,525,225,300,4.01
2020,CB2020,047,3,Brooklyn,30413002003,317,138,179,4
2020,CB2020,047,3,Brooklyn,30413003000,487,250,237,4.02
2020,CB2020,047,3,Brooklyn,30413003001,533,278,255,4.01
2020,CB2020,047,3,Brooklyn,30413003002,285,124,161,2.73
2020,CB2020,047,3,Brooklyn,30413003003,164,75,89,1.27
2020,CB2020,047,3,Brooklyn,30414011000,134,73,61,5.11
2020,CB2020,047,3,Brooklyn,30414011001,126,55,71,2.68
2020,CB2020,047,3,Brooklyn,30414011002,116,38,78,2.81
2020,CB2020,047,3,Brooklyn,30414011003,407,215,192,3.61
2020,CB2020,047,3,Brooklyn,30414012000,174,81,93,5.26
2020,CB2020,047,3,Brooklyn,30414012001,308,154,154,5.24
2020,CB2020,047,3,Brooklyn,30414012002,215,122,93,8.68
2020,CB2020,047,3,Brooklyn,30414021000,0,0,0,0.54
2020,CB2020,047,3,Brooklyn,30414021001,295,151,144,1.41
2020,CB2020,047,3,Brooklyn,30414021002,546,251,295,6.05
2020,CB2020,047,3,Brooklyn,30414021003,0,0,0,1.5
2020,CB2020,047,3,Brooklyn,30414021004,0,0,0,1.55
2020,CB2020,047,3,Brooklyn,30414021005,149,73,76,6.21
2020,CB2020,047,3,Brooklyn,30414022000,0,0,0,0.17
2020,CB2020,047,3,Brooklyn,30414022001,290,153,137,5.12
2020,CB2020,047,3,Brooklyn,30414022002,269,105,164,5.09
2020,CB2020,047,3,Brooklyn,30414022003,165,72,93,5.24
2020,CB2020,047,3,Brooklyn,30414022004,141,84,57,5.26
2020,CB2020,047,3,Brooklyn,30415001000,423,246,177,4.01
2020,CB2020,047,3,Brooklyn,30415001001,533,246,287,4
2020,CB2020,047,3,Brooklyn,30415001002,544,244,300,4
2020,CB2020,047,3,Brooklyn,30415002000,369,171,198,4.02
2020,CB2020,047,3,Brooklyn,30415002001,413,176,237,4
2020,CB2020,047,3,Brooklyn,30415002002,529,258,271,4
2020,CB2020,047,3,Brooklyn,30415002003,408,199,209,4
2020,CB2020,047,3,Brooklyn,30415003000,0,0,0,4.01
2020,CB2020,047,3,Brooklyn,30415003001,400,207,193,4
2020,CB2020,047,3,Brooklyn,30415003002,413,187,226,4.14
2020,CB2020,047,3,Brooklyn,30416001000,122,66,56,2.66
2020,CB2020,047,3,Brooklyn,30416001001,185,97,88,5.1
2020,CB2020,047,3,Brooklyn,30416001002,185,81,104,5.95
2020,CB2020,047,3,Brooklyn,30416001003,440,238,202,7.37
2020,CB2020,047,3,Brooklyn,30416001004,268,139,129,5.23
2020,CB2020,047,3,Brooklyn,30416002000,663,327,336,6.08
2020,CB2020,047,3,Brooklyn,30416002001,249,123,126,6.21
2020,CB2020,047,3,Brooklyn,30416002002,0,0,0,1.56
2020,CB2020,047,3,Brooklyn,30417001000,367,159,208,4.01
2020,CB2020,047,3,Brooklyn,30417001001,270,121,149,4.01
2020,CB2020,047,3,Brooklyn,30417002000,312,120,192,4.58
2020,CB2020,047,3,Brooklyn,30417002001,349,181,168,4.35
2020,CB2020,047,3,Brooklyn,30417003000,621,271,350,4.02
2020,CB2020,047,3,Brooklyn,30417003001,497,221,276,4.82
2020,CB2020,047,3,Brooklyn,30417004000,190,76,114,4.01
2020,CB2020,047,3,Brooklyn,30417004001,742,351,391,5.08
2020,CB2020,047,3,Brooklyn,30418001000,199,117,82,4.06
2020,CB2020,047,3,Brooklyn,30418001001,203,113,90,3.43
2020,CB2020,047,3,Brooklyn,30418001002,304,136,168,3.29
2020,CB2020,047,3,Brooklyn,30418001003,73,19,54,2.11
2020,CB2020,047,3,Brooklyn,30418001004,145,74,71,2.97
2020,CB2020,047,3,Brooklyn,30418001005,404,185,219,3.7
2020,CB2020,047,3,Brooklyn,30418001006,0,0,0,1
2020,CB2020,047,3,Brooklyn,30418002000,149,61,88,3.28
2020,CB2020,047,3,Brooklyn,30418002001,209,76,133,1.92
2020,CB2020,047,3,Brooklyn,30418002002,0,0,0,0.39
2020,CB2020,047,3,Brooklyn,30418002003,13,10,3,0.98
2020,CB2020,047,3,Brooklyn,30418002004,405,205,200,5.91
2020,CB2020,047,3,Brooklyn,30418002005,541,334,207,6.07
2020,CB2020,047,3,Brooklyn,30418002006,0,0,0,1.48
2020,CB2020,047,3,Brooklyn,30419001000,291,145,146,4.03
2020,CB2020,047,3,Brooklyn,30419001001,545,261,284,3.97
2020,CB2020,047,3,Brooklyn,30419001002,357,174,183,5.35
2020,CB2020,047,3,Brooklyn,30419001003,594,285,309,5.5
2020,CB2020,047,3,Brooklyn,30419002000,412,180,232,4.01
2020,CB2020,047,3,Brooklyn,30419002001,622,327,295,5.48
2020,CB2020,047,3,Brooklyn,30419003000,298,133,165,4
2020,CB2020,047,3,Brooklyn,30419003001,761,363,398,5.47
2020,CB2020,047,3,Brooklyn,30420001000,233,122,111,6.02
2020,CB2020,047,3,Brooklyn,30420001001,328,167,161,5.61
2020,CB2020,047,3,Brooklyn,30420002000,240,131,109,5.08
2020,CB2020,047,3,Brooklyn,30420002001,283,162,121,4.7
2020,CB2020,047,3,Brooklyn,30420002002,147,74,73,4.71
2020,CB2020,047,3,Brooklyn,30420002003,343,177,166,5.46
2020,CB2020,047,3,Brooklyn,30420002004,315,125,190,5.61
2020,CB2020,047,3,Brooklyn,30420002005,0,0,0,1.36
2020,CB2020,047,3,Brooklyn,30420002006,23,15,8,3.12
2020,CB2020,047,3,Brooklyn,30421001000,369,168,201,4.01
2020,CB2020,047,3,Brooklyn,30421001001,1023,485,538,5.46
2020,CB2020,047,3,Brooklyn,30421002000,27,16,11,0.43
2020,CB2020,047,3,Brooklyn,30421002001,420,161,259,3.58
2020,CB2020,047,3,Brooklyn,30421002002,609,297,312,5.48
2020,CB2020,047,3,Brooklyn,30421003000,135,67,68,0.68
2020,CB2020,047,3,Brooklyn,30421003001,282,143,139,2.73
2020,CB2020,047,3,Brooklyn,30421003002,66,26,40,0.57
2020,CB2020,047,3,Brooklyn,30421003003,717,351,366,5.48
2020,CB2020,047,3,Brooklyn,30421004000,182,73,109,1.55
2020,CB2020,047,3,Brooklyn,30421004001,87,41,46,0.36
2020,CB2020,047,3,Brooklyn,30421004002,241,114,127,2.09
2020,CB2020,047,3,Brooklyn,30421004003,708,368,340,5.46
2020,CB2020,047,3,Brooklyn,30422001000,0,0,0,1.44
2020,CB2020,047,3,Brooklyn,30422001001,354,170,184,2.37
2020,CB2020,047,3,Brooklyn,30422001002,154,92,62,1.94
2020,CB2020,047,3,Brooklyn,30422001003,183,95,88,2.77
2020,CB2020,047,3,Brooklyn,30422001004,339,162,177,3.18
2020,CB2020,047,3,Brooklyn,30422002000,0,0,0,1.11
2020,CB2020,047,3,Brooklyn,30422002001,375,166,209,4.92
2020,CB2020,047,3,Brooklyn,30422002002,260,145,115,5.21
2020,CB2020,047,3,Brooklyn,30422002003,366,192,174,5.41
2020,CB2020,047,3,Brooklyn,30422002004,398,202,196,5.95
2020,CB2020,047,3,Brooklyn,30422002005,51,33,18,2.62
2020,CB2020,047,3,Brooklyn,30422002006,199,91,108,3.84
2020,CB2020,047,3,Brooklyn,30422003000,381,201,180,4.72
2020,CB2020,047,3,Brooklyn,30422003001,345,162,183,5.18
2020,CB2020,047,3,Brooklyn,30422003002,258,136,122,5.5
2020,CB2020,047,3,Brooklyn,30423001000,519,276,243,4.65
2020,CB2020,047,3,Brooklyn,30423001001,351,179,172,4.04
2020,CB2020,047,3,Brooklyn,30423001002,130,71,59,2.07
2020,CB2020,047,3,Brooklyn,30423001003,31,19,12,0.25
2020,CB2020,047,3,Brooklyn,30423001004,400,163,237,4.25
2020,CB2020,047,3,Brooklyn,30423001005,385,189,196,3.32
2020,CB2020,047,3,Brooklyn,30423001006,59,19,40,0.89
2020,CB2020,047,3,Brooklyn,30423002000,0,0,0,4
2020,CB2020,047,3,Brooklyn,30423002001,501,245,256,3.99
2020,CB2020,047,3,Brooklyn,30423002002,125,68,57,0.56
2020,CB2020,047,3,Brooklyn,30423002003,203,120,83,3.44
2020,CB2020,047,3,Brooklyn,30423002004,453,250,203,3.29
2020,CB2020,047,3,Brooklyn,30423002005,336,181,155,2.27
2020,CB2020,047,3,Brooklyn,30423003000,608,294,314,4.01
2020,CB2020,047,3,Brooklyn,30423003001,151,78,73,0.71
2020,CB2020,047,3,Brooklyn,30423003002,314,160,154,3.28
2020,CB2020,047,3,Brooklyn,30424001000,116,72,44,0.52
2020,CB2020,047,3,Brooklyn,30424001001,326,145,181,4.9
2020,CB2020,047,3,Brooklyn,30424001002,494,260,234,4.7
2020,CB2020,047,3,Brooklyn,30424001003,257,125,132,4.73
2020,CB2020,047,3,Brooklyn,30424002000,532,241,291,4.72
2020,CB2020,047,3,Brooklyn,30424002001,398,218,180,4.71
2020,CB2020,047,3,Brooklyn,30424002002,437,218,219,3.28
2020,CB2020,047,3,Brooklyn,30424002003,341,162,179,2.12
2020,CB2020,047,3,Brooklyn,30424003000,548,268,280,4.71
2020,CB2020,047,3,Brooklyn,30424003001,523,247,276,2.74
2020,CB2020,047,3,Brooklyn,30424003002,203,114,89,2.66
2020,CB2020,047,3,Brooklyn,30425001000,236,96,140,1.5
2020,CB2020,047,3,Brooklyn,30425001001,330,186,144,2.51
2020,CB2020,047,3,Brooklyn,30425001002,665,334,331,4
2020,CB2020,047,3,Brooklyn,30425002000,42,20,22,4.17
2020,CB2020,047,3,Brooklyn,30425002001,20,10,10,3.53
2020,CB2020,047,3,Brooklyn,30425002002,0,0,0,4.12
2020,CB2020,047,3,Brooklyn,30425002003,40,25,15,4.11
2020,CB2020,047,3,Brooklyn,30425002004,678,339,339,4.14
2020,CB2020,047,3,Brooklyn,30425003000,79,56,23,3.91
2020,CB2020,047,3,Brooklyn,30425003001,14,12,2,1.46
2020,CB2020,047,3,Brooklyn,30425003002,289,126,163,3.19
2020,CB2020,047,3,Brooklyn,30425003003,78,55,23,0.82
2020,CB2020,047,3,Brooklyn,30425003004,88,28,60,0.59
2020,CB2020,047,3,Brooklyn,30425003005,467,241,226,3.43
2020,CB2020,047,3,Brooklyn,30426001000,650,300,350,5.03
2020,CB2020,047,3,Brooklyn,30426001001,282,151,131,2.34
2020,CB2020,047,3,Brooklyn,30426001002,163,95,68,3.46
2020,CB2020,047,3,Brooklyn,30426001003,467,235,232,4.03
2020,CB2020,047,3,Brooklyn,30426002000,541,290,251,5.12
2020,CB2020,047,3,Brooklyn,30426002001,172,88,84,2.45
2020,CB2020,047,3,Brooklyn,30426002002,249,116,133,2.26
2020,CB2020,047,3,Brooklyn,30426002003,99,63,36,1.18
2020,CB2020,047,3,Brooklyn,30426002004,197,111,86,1.82
2020,CB2020,047,3,Brooklyn,30426002005,209,90,119,2.26
2020,CB2020,047,3,Brooklyn,30426002006,172,64,108,1.94
2020,CB2020,047,3,Brooklyn,30426003000,117,58,59,0.82
2020,CB2020,047,3,Brooklyn,30426003001,589,278,311,3.9
2020,CB2020,047,3,Brooklyn,30426003002,17,10,7,0.74
2020,CB2020,047,3,Brooklyn,30426003003,426,207,219,4.66
2020,CB2020,047,3,Brooklyn,30427001000,759,386,373,4.31
2020,CB2020,047,3,Brooklyn,30427001001,556,276,280,4.01
2020,CB2020,047,3,Brooklyn,30427002000,806,432,374,4.3
2020,CB2020,047,3,Brooklyn,30427002001,618,298,320,4.01
2020,CB2020,047,3,Brooklyn,30427003000,656,315,341,4.31
2020,CB2020,047,3,Brooklyn,30427003001,672,338,334,4
2020,CB2020,047,3,Brooklyn,30427004000,40,22,18,3.31
2020,CB2020,047,3,Brooklyn,30427004001,413,183,230,4.02
2020,CB2020,047,3,Brooklyn,30427004002,340,159,181,3.55
2020,CB2020,047,3,Brooklyn,30427004003,60,42,18,0.81
2020,CB2020,047,3,Brooklyn,30428001000,177,77,100,0.83
2020,CB2020,047,3,Brooklyn,30428001001,779,361,418,3.91
2020,CB2020,047,3,Brooklyn,30428001002,0,0,0,0.26
2020,CB2020,047,3,Brooklyn,30428001003,425,199,226,5.11
2020,CB2020,047,3,Brooklyn,30428002000,743,321,422,4.75
2020,CB2020,047,3,Brooklyn,30428002001,269,131,138,5.38
2020,CB2020,047,3,Brooklyn,30428002002,354,188,166,5.39
2020,CB2020,047,3,Brooklyn,30428003000,181,75,106,0.82
2020,CB2020,047,3,Brooklyn,30428003001,226,79,147,0.81
2020,CB2020,047,3,Brooklyn,30428003002,156,81,75,2.69
2020,CB2020,047,3,Brooklyn,30428003003,192,83,109,3.24
2020,CB2020,047,3,Brooklyn,30428003004,0,0,0,0.67
2020,CB2020,047,3,Brooklyn,30428003005,69,47,22,3.19
2020,CB2020,047,3,Brooklyn,30428003006,416,217,199,1.31
2020,CB2020,047,3,Brooklyn,30428003007,303,178,125,2.35
2020,CB2020,047,3,Brooklyn,30429001000,0,0,0,8.61
2020,CB2020,047,3,Brooklyn,30429001001,754,397,357,4.02
2020,CB2020,047,3,Brooklyn,30429001002,507,264,243,4
2020,CB2020,047,3,Brooklyn,30429002000,870,413,457,4.31
2020,CB2020,047,3,Brooklyn,30429002001,707,355,352,3.99
2020,CB2020,047,3,Brooklyn,30429003000,851,423,428,4.3
2020,CB2020,047,3,Brooklyn,30429003001,528,257,271,4
2020,CB2020,047,3,Brooklyn,30429004000,743,405,338,4.31
2020,CB2020,047,3,Brooklyn,30429004001,596,288,308,4.01
2020,CB2020,047,3,Brooklyn,30430001000,564,285,279,4.43
2020,CB2020,047,3,Brooklyn,30430001001,743,324,419,5.61
2020,CB2020,047,3,Brooklyn,30430002000,297,146,151,2.97
2020,CB2020,047,3,Brooklyn,30430002001,645,286,359,5.62
2020,CB2020,047,3,Brooklyn,30430003000,0,0,0,1.47
2020,CB2020,047,3,Brooklyn,30430003001,975,465,510,5.6
2020,CB2020,047,3,Brooklyn,30430003002,618,287,331,5.66
2020,CB2020,047,3,Brooklyn,30430003003,0,0,0,6.96
2020,CB2020,047,3,Brooklyn,30430003004,0,0,0,1.22
2020,CB2020,047,3,Brooklyn,30431001000,540,249,291,4.3
2020,CB2020,047,3,Brooklyn,30431001001,582,299,283,4.01
2020,CB2020,047,3,Brooklyn,30431001002,0,0,0,0.31
2020,CB2020,047,3,Brooklyn,30431001003,0,0,0,4.04
2020,CB2020,047,3,Brooklyn,30431002000,688,344,344,4.31
2020,CB2020,047,3,Brooklyn,30431002001,280,135,145,2.85
2020,CB2020,047,3,Brooklyn,30431002002,25,17,8,1.32
2020,CB2020,047,3,Brooklyn,30431002003,146,68,78,2.65
2020,CB2020,047,3,Brooklyn,30431002004,106,44,62,1.15
2020,CB2020,047,3,Brooklyn,30431003000,679,317,362,4.3
2020,CB2020,047,3,Brooklyn,30431003001,445,207,238,4.01
2020,CB2020,047,3,Brooklyn,30431004000,763,387,376,4.31
2020,CB2020,047,3,Brooklyn,30431004001,630,290,340,4.01
2020,CB2020,047,3,Brooklyn,30432001000,672,346,326,5.78
2020,CB2020,047,3,Brooklyn,30432001001,632,323,309,6.05
2020,CB2020,047,3,Brooklyn,30432002000,1077,528,549,7.24
2020,CB2020,047,3,Brooklyn,30432002001,890,441,449,6.05
2020,CB2020,047,3,Brooklyn,30432003000,341,180,161,3.57
2020,CB2020,047,3,Brooklyn,30432003001,352,163,189,2.47
2020,CB2020,047,3,Brooklyn,30432003002,306,161,145,2.52
2020,CB2020,047,3,Brooklyn,30432003003,244,125,119,3.1
2020,CB2020,047,3,Brooklyn,30433001000,375,156,219,4.03
2020,CB2020,047,3,Brooklyn,30433001001,80,29,51,3.99
2020,CB2020,047,3,Brooklyn,30433001002,188,87,101,3
2020,CB2020,047,3,Brooklyn,30433001003,84,19,65,0.99
2020,CB2020,047,3,Brooklyn,30433001004,308,127,181,4.02
2020,CB2020,047,3,Brooklyn,30433001005,0,0,0,4.01
2020,CB2020,047,3,Brooklyn,30433002000,351,154,197,2.57
2020,CB2020,047,3,Brooklyn,30433002001,113,64,49,1.04
2020,CB2020,047,3,Brooklyn,30433002002,401,209,192,3.27
2020,CB2020,047,3,Brooklyn,30433002003,91,61,30,1.73
2020,CB2020,047,3,Brooklyn,30433003000,627,311,316,3.57
2020,CB2020,047,3,Brooklyn,30433003001,462,260,202,3.64
2020,CB2020,047,3,Brooklyn,30433003002,331,182,149,4.31
2020,CB2020,047,3,Brooklyn,30433003003,174,65,109,0.66
2020,CB2020,047,3,Brooklyn,30433003004,258,141,117,0.74
2020,CB2020,047,3,Brooklyn,30434001000,820,405,415,5.49
2020,CB2020,047,3,Brooklyn,30434001001,332,147,185,4.21
2020,CB2020,047,3,Brooklyn,30434001002,437,223,214,2.6
2020,CB2020,047,3,Brooklyn,30434002000,564,270,294,5.49
2020,CB2020,047,3,Brooklyn,30434002001,550,257,293,5.63
2020,CB2020,047,3,Brooklyn,30434003000,438,228,210,3.34
2020,CB2020,047,3,Brooklyn,30434003001,251,147,104,1.84
2020,CB2020,047,3,Brooklyn,30434003002,0,0,0,0.32
2020,CB2020,047,3,Brooklyn,30434003003,474,213,261,5.59
2020,CB2020,047,3,Brooklyn,30435001000,146,65,81,8.61
2020,CB2020,047,3,Brooklyn,30435001001,774,399,375,4.31
2020,CB2020,047,3,Brooklyn,30435001002,480,241,239,3.59
2020,CB2020,047,3,Brooklyn,30435001003,141,78,63,0.71
2020,CB2020,047,3,Brooklyn,30435002000,601,320,281,3.99
2020,CB2020,047,3,Brooklyn,30435002001,478,223,255,4.01
2020,CB2020,047,3,Brooklyn,30435002002,671,347,324,4
2020,CB2020,047,3,Brooklyn,30435003000,403,185,218,4.31
2020,CB2020,047,3,Brooklyn,30435003001,453,229,224,4.01
2020,CB2020,047,3,Brooklyn,30435003002,562,292,270,4.01
2020,CB2020,047,3,Brooklyn,30436001000,469,219,250,4.66
2020,CB2020,047,3,Brooklyn,30436001001,721,335,386,4.65
2020,CB2020,047,3,Brooklyn,30436001002,576,287,289,3.38
2020,CB2020,047,3,Brooklyn,30436001003,211,110,101,1.72
2020,CB2020,047,3,Brooklyn,30436002000,596,286,310,5.09
2020,CB2020,047,3,Brooklyn,30436002001,633,294,339,5.04
2020,CB2020,047,3,Brooklyn,30436003000,516,244,272,4.73
2020,CB2020,047,3,Brooklyn,30436003001,972,495,477,4.72
2020,CB2020,047,3,Brooklyn,30437001000,750,374,376,4.29
2020,CB2020,047,3,Brooklyn,30437001001,607,291,316,4.29
2020,CB2020,047,3,Brooklyn,30437002000,479,250,229,4.01
2020,CB2020,047,3,Brooklyn,30437002001,0,0,0,4
2020,CB2020,047,3,Brooklyn,30437002002,473,238,235,4.01
2020,CB2020,047,3,Brooklyn,30437002003,555,279,276,4.01
2020,CB2020,047,3,Brooklyn,30437003000,703,356,347,4.31
2020,CB2020,047,3,Brooklyn,30437003001,554,292,262,4.01
2020,CB2020,047,3,Brooklyn,30437004000,551,278,273,4.31
2020,CB2020,047,3,Brooklyn,30437004001,610,313,297,4.3
2020,CB2020,047,3,Brooklyn,30438001000,0,0,0,1.61
2020,CB2020,047,3,Brooklyn,30438001001,937,463,474,6.71
2020,CB2020,047,3,Brooklyn,30438001002,210,103,107,5.62
2020,CB2020,047,3,Brooklyn,30438002000,443,227,216,5.61
2020,CB2020,047,3,Brooklyn,30438002001,363,172,191,6.16
2020,CB2020,047,3,Brooklyn,30438002002,455,233,222,6.57
2020,CB2020,047,3,Brooklyn,30438002003,136,67,69,2.64
2020,CB2020,047,3,Brooklyn,30438002004,339,176,163,2.72
2020,CB2020,047,3,Brooklyn,30438002005,22,12,10,0.94
2020,CB2020,047,3,Brooklyn,30439001000,230,107,123,1.35
2020,CB2020,047,3,Brooklyn,30439001001,307,153,154,2.87
2020,CB2020,047,3,Brooklyn,30439001002,350,159,191,2.86
2020,CB2020,047,3,Brooklyn,30439001003,112,67,45,1.37
2020,CB2020,047,3,Brooklyn,30439001004,0,0,0,1.39
2020,CB2020,047,3,Brooklyn,30439001005,321,151,170,2.87
2020,CB2020,047,3,Brooklyn,30439001006,166,91,75,2.82
2020,CB2020,047,3,Brooklyn,30439001007,0,0,0,1.45
2020,CB2020,047,3,Brooklyn,30439001008,99,82,17,1.59
2020,CB2020,047,3,Brooklyn,30439001009,34,10,24,2.56
2020,CB2020,047,3,Brooklyn,30439002000,157,79,78,1.33
2020,CB2020,047,3,Brooklyn,30439002001,333,160,173,2.89
2020,CB2020,047,3,Brooklyn,30439002002,296,137,159,2.18
2020,CB2020,047,3,Brooklyn,30439002003,283,144,139,2.17
2020,CB2020,047,3,Brooklyn,30439002004,374,190,184,2.17
2020,CB2020,047,3,Brooklyn,30439003000,283,148,135,3.09
2020,CB2020,047,3,Brooklyn,30439003001,163,92,71,2.12
2020,CB2020,047,3,Brooklyn,30439003002,0,0,0,0.67
2020,CB2020,047,3,Brooklyn,30439003003,359,158,201,3.49
2020,CB2020,047,3,Brooklyn,30439003004,126,65,61,2.04
2020,CB2020,047,3,Brooklyn,30439003005,104,40,64,6.15
2020,CB2020,047,3,Brooklyn,30440001000,298,144,154,6.92
2020,CB2020,047,3,Brooklyn,30440001001,0,0,0,1.73
2020,CB2020,047,3,Brooklyn,30440001002,0,0,0,1.69
2020,CB2020,047,3,Brooklyn,30440001003,38,18,20,1.17
2020,CB2020,047,3,Brooklyn,30440001004,546,268,278,5.8
2020,CB2020,047,3,Brooklyn,30440002000,199,95,104,1.48
2020,CB2020,047,3,Brooklyn,30440002001,148,77,71,1.94
2020,CB2020,047,3,Brooklyn,30440002002,194,104,90,3.91
2020,CB2020,047,3,Brooklyn,30440002003,208,113,95,4.37
2020,CB2020,047,3,Brooklyn,30440002004,188,78,110,3.77
2020,CB2020,047,3,Brooklyn,30440003000,227,120,107,2.67
2020,CB2020,047,3,Brooklyn,30440003001,288,140,148,3.44
2020,CB2020,047,3,Brooklyn,30440003002,65,31,34,3.41
2020,CB2020,047,3,Brooklyn,30440003003,57,35,22,1.86
2020,CB2020,047,3,Brooklyn,30440003004,293,135,158,2.24
2020,CB2020,047,3,Brooklyn,30440003005,129,68,61,3.39
2020,CB2020,047,3,Brooklyn,30441001000,452,223,229,3.18
2020,CB2020,047,3,Brooklyn,30441001001,258,124,134,3.12
2020,CB2020,047,3,Brooklyn,30441001002,420,210,210,3.61
2020,CB2020,047,3,Brooklyn,30441001003,746,419,327,4.1
2020,CB2020,047,3,Brooklyn,30441001004,0,0,0,0.52
2020,CB2020,047,3,Brooklyn,30441002000,509,263,246,3.27
2020,CB2020,047,3,Brooklyn,30441002001,729,329,400,4.06
2020,CB2020,047,3,Brooklyn,30441002002,664,314,350,4.08
2020,CB2020,047,3,Brooklyn,30441003000,637,293,344,2.97
2020,CB2020,047,3,Brooklyn,30441003001,570,307,263,2.96
2020,CB2020,047,3,Brooklyn,30441003002,541,268,273,3.23
2020,CB2020,047,3,Brooklyn,30442001000,432,204,228,6.27
2020,CB2020,047,3,Brooklyn,30442001001,275,136,139,5.86
2020,CB2020,047,3,Brooklyn,30442001002,409,210,199,5.85
2020,CB2020,047,3,Brooklyn,30442001003,310,146,164,5.62
2020,CB2020,047,3,Brooklyn,30442002000,244,129,115,6.77
2020,CB2020,047,3,Brooklyn,30442002001,580,308,272,6.5
2020,CB2020,047,3,Brooklyn,30442002002,381,150,231,6.66
2020,CB2020,047,3,Brooklyn,30442002003,0,0,0,1.64
2020,CB2020,047,3,Brooklyn,30443001000,456,220,236,2.96
2020,CB2020,047,3,Brooklyn,30443001001,553,282,271,2.95
2020,CB2020,047,3,Brooklyn,30443001002,384,195,189,3.26
2020,CB2020,047,3,Brooklyn,30443002000,327,165,162,3.22
2020,CB2020,047,3,Brooklyn,30443002001,557,261,296,4.17
2020,CB2020,047,3,Brooklyn,30443002002,709,363,346,4.1
2020,CB2020,047,3,Brooklyn,30443003000,602,334,268,4.31
2020,CB2020,047,3,Brooklyn,30443003001,629,272,357,4.24
2020,CB2020,047,3,Brooklyn,30443004000,360,167,193,2.96
2020,CB2020,047,3,Brooklyn,30443004001,0,0,0,3.14
2020,CB2020,047,3,Brooklyn,30443004002,230,148,82,3.18
2020,CB2020,047,3,Brooklyn,30443004003,388,193,195,2.96
2020,CB2020,047,3,Brooklyn,30444001000,414,195,219,4.22
2020,CB2020,047,3,Brooklyn,30444001001,294,141,153,5.52
2020,CB2020,047,3,Brooklyn,30444001002,285,141,144,6.19
2020,CB2020,047,3,Brooklyn,30444001003,0,0,0,1.58
2020,CB2020,047,3,Brooklyn,30444001004,43,15,28,1.02
2020,CB2020,047,3,Brooklyn,30444001005,30,14,16,0.56
2020,CB2020,047,3,Brooklyn,30444002000,0,0,0,1.54
2020,CB2020,047,3,Brooklyn,30444002001,744,364,380,6.23
2020,CB2020,047,3,Brooklyn,30444002002,383,165,218,5.25
2020,CB2020,047,3,Brooklyn,30444003000,441,232,209,5.24
2020,CB2020,047,3,Brooklyn,30444003001,626,295,331,5.78
2020,CB2020,047,3,Brooklyn,30445001000,288,124,164,2.96
2020,CB2020,047,3,Brooklyn,30445001001,486,249,237,3.06
2020,CB2020,047,3,Brooklyn,30445001002,466,255,211,3.1
2020,CB2020,047,3,Brooklyn,30445001003,220,111,109,2.96
2020,CB2020,047,3,Brooklyn,30445002000,105,57,48,4.59
2020,CB2020,047,3,Brooklyn,30445002001,299,149,150,4.51
2020,CB2020,047,3,Brooklyn,30445002002,510,223,287,4.45
2020,CB2020,047,3,Brooklyn,30445002003,473,267,206,4.38
2020,CB2020,047,3,Brooklyn,30445003000,101,47,54,2.96
2020,CB2020,047,3,Brooklyn,30445003001,463,231,232,2.98
2020,CB2020,047,3,Brooklyn,30445003002,439,209,230,3.02
2020,CB2020,047,3,Brooklyn,30445003003,357,170,187,2.96
2020,CB2020,047,3,Brooklyn,30446001000,340,173,167,4.72
2020,CB2020,047,3,Brooklyn,30446001001,455,223,232,4.52
2020,CB2020,047,3,Brooklyn,30446001002,0,0,0,0.24
2020,CB2020,047,3,Brooklyn,30446002000,440,247,193,6.16
2020,CB2020,047,3,Brooklyn,30446002001,208,94,114,4.95
2020,CB2020,047,3,Brooklyn,30446002002,96,42,54,1.47
2020,CB2020,047,3,Brooklyn,30446002003,222,117,105,4.89
2020,CB2020,047,3,Brooklyn,30446002004,30,5,25,4.9
2020,CB2020,047,3,Brooklyn,30446002005,235,114,121,3.17
2020,CB2020,047,3,Brooklyn,30447001000,0,0,0,0.92
2020,CB2020,047,3,Brooklyn,30447001001,0,0,0,1.03
2020,CB2020,047,3,Brooklyn,30447001002,283,154,129,2.32
2020,CB2020,047,3,Brooklyn,30447001003,70,43,27,2.92
2020,CB2020,047,3,Brooklyn,30447001004,505,238,267,2.96
2020,CB2020,047,3,Brooklyn,30447001005,126,68,58,2.94
2020,CB2020,047,3,Brooklyn,30447001006,138,84,54,2.94
2020,CB2020,047,3,Brooklyn,30447001007,64,36,28,2.91
2020,CB2020,047,3,Brooklyn,30447001008,0,0,0,0.59
2020,CB2020,047,3,Brooklyn,30447001009,455,195,260,2.13
2020,CB2020,047,3,Brooklyn,30447002000,34,15,19,4.43
2020,CB2020,047,3,Brooklyn,30447002001,104,65,39,4.79
2020,CB2020,047,3,Brooklyn,30447002002,245,104,141,4.72
2020,CB2020,047,3,Brooklyn,30447002003,435,234,201,4.64
2020,CB2020,047,3,Brooklyn,30448001000,532,288,244,18.28
2020,CB2020,047,3,Brooklyn,30448001001,0,0,0,19.29
2020,CB2020,047,3,Brooklyn,30448002000,0,0,0,0.71
2020,CB2020,047,3,Brooklyn,30448002001,481,238,243,2.57
2020,CB2020,047,3,Brooklyn,30448002002,98,37,61,1.61
2020,CB2020,047,3,Brooklyn,30448002003,430,209,221,5.26
2020,CB2020,047,3,Brooklyn,30448002004,424,222,202,6.24
2020,CB2020,047,3,Brooklyn,30448002005,0,0,0,1.53
2020,CB2020,047,3,Brooklyn,30449011000,459,180,279,4.48
2020,CB2020,047,3,Brooklyn,30449011001,1279,521,758,10.34
2020,CB2020,047,3,Brooklyn,30449011002,106,52,54,1.76
2020,CB2020,047,3,Brooklyn,30449011003,20,6,14,3.02
2020,CB2020,047,3,Brooklyn,30449011004,99,31,68,3.37
2020,CB2020,047,3,Brooklyn,30449011005,10,8,2,8.11
2020,CB2020,047,3,Brooklyn,30449012000,103,53,50,2.65
2020,CB2020,047,3,Brooklyn,30449012001,212,111,101,2.84
2020,CB2020,047,3,Brooklyn,30449012002,90,30,60,4.12
2020,CB2020,047,3,Brooklyn,30449012003,19,7,12,3.52
2020,CB2020,047,3,Brooklyn,30449012004,0,0,0,0.28
2020,CB2020,047,3,Brooklyn,30449012005,0,0,0,0.33
2020,CB2020,047,3,Brooklyn,30449012006,0,0,0,0.41
2020,CB2020,047,3,Brooklyn,30449012007,0,0,0,0.43
2020,CB2020,047,3,Brooklyn,30449012008,102,55,47,2.55
2020,CB2020,047,3,Brooklyn,30449012009,59,27,32,2.85
2020,CB2020,047,3,Brooklyn,30449012010,0,0,0,2.75
2020,CB2020,047,3,Brooklyn,30449012011,25,20,5,1.67
2020,CB2020,047,3,Brooklyn,30449012012,71,35,36,1.98
2020,CB2020,047,3,Brooklyn,30449012013,0,0,0,2.75
2020,CB2020,047,3,Brooklyn,30449012014,0,0,0,2.82
2020,CB2020,047,3,Brooklyn,30449012015,16,7,9,2.4
2020,CB2020,047,3,Brooklyn,30449012016,0,0,0,0.27
2020,CB2020,047,3,Brooklyn,30449013000,0,0,0,0.62
2020,CB2020,047,3,Brooklyn,30449013001,0,0,0,0.44
2020,CB2020,047,3,Brooklyn,30449013002,0,0,0,0.51
2020,CB2020,047,3,Brooklyn,30449013003,0,0,0,0.45
2020,CB2020,047,3,Brooklyn,30449013004,0,0,0,1.78
2020,CB2020,047,3,Brooklyn,30449013005,0,0,0,2.58
2020,CB2020,047,3,Brooklyn,30449013006,0,0,0,2.66
2020,CB2020,047,3,Brooklyn,30449013007,0,0,0,2.84
2020,CB2020,047,3,Brooklyn,30449013008,0,0,0,0.66
2020,CB2020,047,3,Brooklyn,30449014000,0,0,0,2.83
2020,CB2020,047,3,Brooklyn,30449014001,0,0,0,2.95
2020,CB2020,047,3,Brooklyn,30449014002,24,10,14,2.76
2020,CB2020,047,3,Brooklyn,30449014003,0,0,0,2.98
2020,CB2020,047,3,Brooklyn,30449014004,0,0,0,2.89
2020,CB2020,047,3,Brooklyn,30449014005,0,0,0,2.76
2020,CB2020,047,3,Brooklyn,30449021000,0,0,0,0
2020,CB2020,047,3,Brooklyn,30449021001,0,0,0,0
2020,CB2020,047,3,Brooklyn,30449021002,0,0,0,0.47
2020,CB2020,047,3,Brooklyn,30449021003,0,0,0,3.55
2020,CB2020,047,3,Brooklyn,30449021004,0,0,0,5.95
2020,CB2020,047,3,Brooklyn,30449021005,0,0,0,3.57
2020,CB2020,047,3,Brooklyn,30449021006,0,0,0,2.71
2020,CB2020,047,3,Brooklyn,30449021007,0,0,0,0.86
2020,CB2020,047,3,Brooklyn,30449021008,0,0,0,0.43
2020,CB2020,047,3,Brooklyn,30449021009,0,0,0,0.27
2020,CB2020,047,3,Brooklyn,30449021010,0,0,0,3.32
2020,CB2020,047,3,Brooklyn,30449021011,0,0,0,0
2020,CB2020,047,3,Brooklyn,30449021012,0,0,0,5.73
2020,CB2020,047,3,Brooklyn,30449021013,0,0,0,2.68
2020,CB2020,047,3,Brooklyn,30449021014,0,0,0,1.87
2020,CB2020,047,3,Brooklyn,30449021015,0,0,0,0.77
2020,CB2020,047,3,Brooklyn,30449021016,0,0,0,0.7
2020,CB2020,047,3,Brooklyn,30449021017,0,0,0,0.61
2020,CB2020,047,3,Brooklyn,30449021018,0,0,0,1.94
2020,CB2020,047,3,Brooklyn,30449021019,0,0,0,1.71
2020,CB2020,047,3,Brooklyn,30449021020,0,0,0,0.52
2020,CB2020,047,3,Brooklyn,30449021021,0,0,0,2.93
2020,CB2020,047,3,Brooklyn,30449021022,0,0,0,2.68
2020,CB2020,047,3,Brooklyn,30449021023,0,0,0,2.76
2020,CB2020,047,3,Brooklyn,30449021024,0,0,0,5.52
2020,CB2020,047,3,Brooklyn,30449021025,0,0,0,2.78
2020,CB2020,047,3,Brooklyn,30449021026,0,0,0,0.67
2020,CB2020,047,3,Brooklyn,30449021027,0,0,0,3.43
2020,CB2020,047,3,Brooklyn,30449021028,0,0,0,2.71
2020,CB2020,047,3,Brooklyn,30449022000,0,0,0,0
2020,CB2020,047,3,Brooklyn,30449022001,0,0,0,135.07
2020,CB2020,047,3,Brooklyn,30449022002,0,0,0,37.98
2020,CB2020,047,3,Brooklyn,30449022003,3,1,2,4.48
2020,CB2020,047,3,Brooklyn,30449022004,0,0,0,6.37
2020,CB2020,047,3,Brooklyn,30449022005,0,0,0,1.04
2020,CB2020,047,3,Brooklyn,30449022006,0,0,0,0.32
2020,CB2020,047,3,Brooklyn,30449022007,0,0,0,0
2020,CB2020,047,3,Brooklyn,30449022008,0,0,0,26.32
2020,CB2020,047,3,Brooklyn,30449022009,12,7,5,3.51
2020,CB2020,047,3,Brooklyn,30449023000,0,0,0,0
2020,CB2020,047,3,Brooklyn,30449023001,4,1,3,9.19
2020,CB2020,047,3,Brooklyn,30449023002,0,0,0,4.13
2020,CB2020,047,3,Brooklyn,30449023003,0,0,0,1.46
2020,CB2020,047,3,Brooklyn,30449023004,0,0,0,0.56
2020,CB2020,047,3,Brooklyn,30449023005,0,0,0,24.58
2020,CB2020,047,3,Brooklyn,30449023006,14,4,10,3.21
2020,CB2020,047,3,Brooklyn,30449023007,0,0,0,0.43
2020,CB2020,047,3,Brooklyn,30449023008,0,0,0,0.6
2020,CB2020,047,3,Brooklyn,30449023009,0,0,0,3.55
2020,CB2020,047,3,Brooklyn,30449023010,0,0,0,6.97
2020,CB2020,047,3,Brooklyn,30449023011,0,0,0,1.51
2020,CB2020,047,3,Brooklyn,30449023012,0,0,0,2.44
2020,CB2020,047,3,Brooklyn,30449023013,0,0,0,13.7
2020,CB2020,047,3,Brooklyn,30449023014,0,0,0,5.5
2020,CB2020,047,3,Brooklyn,30449023015,0,0,0,2.73
2020,CB2020,047,3,Brooklyn,30449023016,0,0,0,12.06
2020,CB2020,047,3,Brooklyn,30449023017,0,0,0,0
2020,CB2020,047,3,Brooklyn,30449023018,0,0,0,25.34
2020,CB2020,047,3,Brooklyn,30449023019,0,0,0,0
2020,CB2020,047,3,Brooklyn,30449023020,0,0,0,2.71
2020,CB2020,047,3,Brooklyn,30449023021,0,0,0,2.76
2020,CB2020,047,3,Brooklyn,30449023022,0,0,0,2.76
2020,CB2020,047,3,Brooklyn,30449023023,8,2,6,2.78
2020,CB2020,047,3,Brooklyn,30449023024,0,0,0,2.73
2020,CB2020,047,3,Brooklyn,30449023025,0,0,0,12.32
2020,CB2020,047,3,Brooklyn,30449023026,0,0,0,4.12
2020,CB2020,047,3,Brooklyn,30449023027,0,0,0,3.91
2020,CB2020,047,3,Brooklyn,30449023028,0,0,0,3.13
2020,CB2020,047,3,Brooklyn,30449023029,3,2,1,2.65
2020,CB2020,047,3,Brooklyn,30450001000,0,0,0,2.28
2020,CB2020,047,3,Brooklyn,30450001001,180,86,94,41.18
2020,CB2020,047,3,Brooklyn,30450001002,50,22,28,1.36
2020,CB2020,047,3,Brooklyn,30450001003,162,100,62,2.97
2020,CB2020,047,3,Brooklyn,30450001004,253,124,129,6.19
2020,CB2020,047,3,Brooklyn,30450001005,0,0,0,0.48
2020,CB2020,047,3,Brooklyn,30452001000,280,124,156,5.26
2020,CB2020,047,3,Brooklyn,30452001001,336,202,134,6.08
2020,CB2020,047,3,Brooklyn,30452001002,381,190,191,6.09
2020,CB2020,047,3,Brooklyn,30452001003,281,149,132,5.26
2020,CB2020,047,3,Brooklyn,30452002000,199,95,104,6.25
2020,CB2020,047,3,Brooklyn,30452002001,0,0,0,1.54
2020,CB2020,047,3,Brooklyn,30452002002,0,0,0,1.57
2020,CB2020,047,3,Brooklyn,30452002003,465,232,233,6.21
2020,CB2020,047,3,Brooklyn,30452002004,676,343,333,6.15
2020,CB2020,047,3,Brooklyn,30452002005,0,0,0,1.62
2020,CB2020,047,3,Brooklyn,30453001000,0,0,0,2.92
2020,CB2020,047,3,Brooklyn,30453001001,11,6,5,2.68
2020,CB2020,047,3,Brooklyn,30453001002,87,52,35,10.72
2020,CB2020,047,3,Brooklyn,30453001003,200,186,14,2.75
2020,CB2020,047,3,Brooklyn,30453001004,18,3,15,4.81
2020,CB2020,047,3,Brooklyn,30453001005,12,7,5,4.15
2020,CB2020,047,3,Brooklyn,30453001006,62,39,23,2.75
2020,CB2020,047,3,Brooklyn,30453001007,32,21,11,2.76
2020,CB2020,047,3,Brooklyn,30453001008,175,110,65,3.47
2020,CB2020,047,3,Brooklyn,30453001009,93,62,31,2.8
2020,CB2020,047,3,Brooklyn,30453001010,311,122,189,2.75
2020,CB2020,047,3,Brooklyn,30453001011,46,38,8,1.4
2020,CB2020,047,3,Brooklyn,30453001012,103,64,39,1.57
2020,CB2020,047,3,Brooklyn,30453001013,0,0,0,1.62
2020,CB2020,047,3,Brooklyn,30453001014,0,0,0,2.59
2020,CB2020,047,3,Brooklyn,30453001015,0,0,0,0.94
2020,CB2020,047,3,Brooklyn,30453002000,0,0,0,0.71
2020,CB2020,047,3,Brooklyn,30453002001,51,23,28,2.46
2020,CB2020,047,3,Brooklyn,30453002002,0,0,0,2.74
2020,CB2020,047,3,Brooklyn,30453002003,42,12,30,0.28
2020,CB2020,047,3,Brooklyn,30453002004,80,42,38,2.47
2020,CB2020,047,3,Brooklyn,30453002005,127,55,72,2.02
2020,CB2020,047,3,Brooklyn,30453002006,0,0,0,1.36
2020,CB2020,047,3,Brooklyn,30453002007,153,105,48,2.71
2020,CB2020,047,3,Brooklyn,30453002008,20,7,13,0.55
2020,CB2020,047,3,Brooklyn,30453002009,45,14,31,0.28
2020,CB2020,047,3,Brooklyn,30453002010,38,19,19,2.17
2020,CB2020,047,3,Brooklyn,30453002011,0,0,0,2.76
2020,CB2020,047,3,Brooklyn,30453002012,111,51,60,2.37
2020,CB2020,047,3,Brooklyn,30453002013,69,35,34,2.78
2020,CB2020,047,3,Brooklyn,30453002014,0,0,0,2.6
2020,CB2020,047,3,Brooklyn,30454001000,339,143,196,5.65
2020,CB2020,047,3,Brooklyn,30454001001,272,131,141,5.67
2020,CB2020,047,3,Brooklyn,30454001002,173,100,73,3.48
2020,CB2020,047,3,Brooklyn,30454001003,194,118,76,2.16
2020,CB2020,047,3,Brooklyn,30454002000,224,127,97,5.24
2020,CB2020,047,3,Brooklyn,30454002001,356,173,183,5.25
2020,CB2020,047,3,Brooklyn,30454002002,377,182,195,3.73
2020,CB2020,047,3,Brooklyn,30454002003,101,64,37,1.52
2020,CB2020,047,3,Brooklyn,30456001000,299,162,137,2.11
2020,CB2020,047,3,Brooklyn,30456001001,58,26,32,3.55
2020,CB2020,047,3,Brooklyn,30456001002,366,181,185,5.64
2020,CB2020,047,3,Brooklyn,30456001003,561,350,211,5.66
2020,CB2020,047,3,Brooklyn,30456002000,487,253,234,1.95
2020,CB2020,047,3,Brooklyn,30456002001,419,209,210,1.94
2020,CB2020,047,3,Brooklyn,30456002002,111,48,63,3.31
2020,CB2020,047,3,Brooklyn,30456002003,105,40,65,3.31
2020,CB2020,047,3,Brooklyn,30456002004,212,119,93,5.26
2020,CB2020,047,3,Brooklyn,30456002005,149,68,81,5.25
2020,CB2020,047,3,Brooklyn,30458001000,308,137,171,2.23
2020,CB2020,047,3,Brooklyn,30458001001,305,164,141,2.28
2020,CB2020,047,3,Brooklyn,30458001002,0,0,0,0.57
2020,CB2020,047,3,Brooklyn,30458001003,0,0,0,0.35
2020,CB2020,047,3,Brooklyn,30458001004,0,0,0,0.87
2020,CB2020,047,3,Brooklyn,30458001005,86,34,52,3.16
2020,CB2020,047,3,Brooklyn,30458001006,115,78,37,3.85
2020,CB2020,047,3,Brooklyn,30458001007,0,0,0,0.55
2020,CB2020,047,3,Brooklyn,30458002000,119,72,47,5.25
2020,CB2020,047,3,Brooklyn,30458002001,188,104,84,6.09
2020,CB2020,047,3,Brooklyn,30458002002,147,61,86,6.27
2020,CB2020,047,3,Brooklyn,30458002003,0,0,0,1.53
2020,CB2020,047,3,Brooklyn,30458002004,140,89,51,6.09
2020,CB2020,047,3,Brooklyn,30458002005,150,70,80,5.25
2020,CB2020,047,3,Brooklyn,30460001000,326,187,139,4.44
2020,CB2020,047,3,Brooklyn,30460001001,496,256,240,4.29
2020,CB2020,047,3,Brooklyn,30460001002,497,229,268,3.28
2020,CB2020,047,3,Brooklyn,30460001003,0,0,0,0.78
2020,CB2020,047,3,Brooklyn,30460002000,733,336,397,5.74
2020,CB2020,047,3,Brooklyn,30460002001,1094,562,532,5.1
2020,CB2020,047,3,Brooklyn,30460003000,144,81,63,5.76
2020,CB2020,047,3,Brooklyn,30460003001,106,57,49,7.22
2020,CB2020,047,3,Brooklyn,30460003002,73,38,35,2.91
2020,CB2020,047,3,Brooklyn,30460003003,80,32,48,2.76
2020,CB2020,047,3,Brooklyn,30460003004,111,50,61,2.08
2020,CB2020,047,3,Brooklyn,30460003005,68,34,34,1.01
2020,CB2020,047,3,Brooklyn,30460003006,40,23,17,0.6
2020,CB2020,047,3,Brooklyn,30460003007,60,46,14,2.49
2020,CB2020,047,3,Brooklyn,30462011000,0,0,0,1.14
2020,CB2020,047,3,Brooklyn,30462011001,850,407,443,5.97
2020,CB2020,047,3,Brooklyn,30462011002,561,314,247,3.69
2020,CB2020,047,3,Brooklyn,30462011003,125,56,69,2.77
2020,CB2020,047,3,Brooklyn,30462012000,0,0,0,0.31
2020,CB2020,047,3,Brooklyn,30462012001,224,115,109,3.24
2020,CB2020,047,3,Brooklyn,30462012002,22,8,14,1.3
2020,CB2020,047,3,Brooklyn,30462012003,0,0,0,0.45
2020,CB2020,047,3,Brooklyn,30462012004,118,70,48,2.85
2020,CB2020,047,3,Brooklyn,30462012005,171,103,68,2.24
2020,CB2020,047,3,Brooklyn,30462012006,112,51,61,2.24
2020,CB2020,047,3,Brooklyn,30462012007,221,110,111,2.21
2020,CB2020,047,3,Brooklyn,30462012008,296,87,209,2.66
2020,CB2020,047,3,Brooklyn,30462012009,0,0,0,0.63
2020,CB2020,047,3,Brooklyn,30462021000,0,0,0,0.31
2020,CB2020,047,3,Brooklyn,30462021001,0,0,0,1.16
2020,CB2020,047,3,Brooklyn,30462021002,355,191,164,2.97
2020,CB2020,047,3,Brooklyn,30462021003,206,125,81,3.31
2020,CB2020,047,3,Brooklyn,30462021004,189,70,119,4.91
2020,CB2020,047,3,Brooklyn,30462021005,217,114,103,5.24
2020,CB2020,047,3,Brooklyn,30462021006,0,0,0,0.38
2020,CB2020,047,3,Brooklyn,30462022000,270,124,146,5.26
2020,CB2020,047,3,Brooklyn,30462022001,346,167,179,6.59
2020,CB2020,047,3,Brooklyn,30462022002,53,21,32,3.42
2020,CB2020,047,3,Brooklyn,30462022003,0,0,0,1.17
2020,CB2020,047,3,Brooklyn,30462022004,103,57,46,1.31
2020,CB2020,047,3,Brooklyn,30462022005,73,44,29,5.03
2020,CB2020,047,3,Brooklyn,30462022006,79,33,46,1.67
2020,CB2020,047,3,Brooklyn,30464001000,94,50,44,2.32
2020,CB2020,047,3,Brooklyn,30464001001,235,135,100,8.25
2020,CB2020,047,3,Brooklyn,30464001002,452,235,217,4.64
2020,CB2020,047,3,Brooklyn,30464001003,26,14,12,0.62
2020,CB2020,047,3,Brooklyn,30464001004,224,121,103,2.26
2020,CB2020,047,3,Brooklyn,30464001005,295,143,152,3.86
2020,CB2020,047,3,Brooklyn,30464001006,32,20,12,4.1
2020,CB2020,047,3,Brooklyn,30464001007,0,0,0,0.51
2020,CB2020,047,3,Brooklyn,30464002000,573,263,310,4.66
2020,CB2020,047,3,Brooklyn,30464002001,448,244,204,4.66
2020,CB2020,047,3,Brooklyn,30464002002,353,195,158,4.64
2020,CB2020,047,3,Brooklyn,30468001000,305,155,150,23.28
2020,CB2020,047,3,Brooklyn,30468001001,611,296,315,14.17
2020,CB2020,047,3,Brooklyn,30468001002,189,104,85,14.44
2020,CB2020,047,3,Brooklyn,30468001003,324,158,166,4.38
2020,CB2020,047,3,Brooklyn,30468001004,250,128,122,4.72
2020,CB2020,047,3,Brooklyn,30468001005,459,250,209,12.13
2020,CB2020,047,3,Brooklyn,30470001000,252,110,142,3.7
2020,CB2020,047,3,Brooklyn,30470001001,46,17,29,1.79
2020,CB2020,047,3,Brooklyn,30470001002,231,126,105,4.59
2020,CB2020,047,3,Brooklyn,30470001003,371,180,191,4.61
2020,CB2020,047,3,Brooklyn,30470001004,317,165,152,4.66
2020,CB2020,047,3,Brooklyn,30470001005,340,173,167,4.79
2020,CB2020,047,3,Brooklyn,30470002000,291,157,134,5.19
2020,CB2020,047,3,Brooklyn,30470002001,528,269,259,4.89
2020,CB2020,047,3,Brooklyn,30470002002,273,140,133,8.37
2020,CB2020,047,3,Brooklyn,30470002003,174,80,94,2.33
2020,CB2020,047,3,Brooklyn,30472001000,207,125,82,2.98
2020,CB2020,047,3,Brooklyn,30472001001,72,30,42,1.48
2020,CB2020,047,3,Brooklyn,30472001002,132,56,76,1.53
2020,CB2020,047,3,Brooklyn,30472001003,512,249,263,3.36
2020,CB2020,047,3,Brooklyn,30472002000,260,112,148,4.46
2020,CB2020,047,3,Brooklyn,30472002001,564,291,273,4.83
2020,CB2020,047,3,Brooklyn,30472002002,285,157,128,4.81
2020,CB2020,047,3,Brooklyn,30472003000,243,130,113,5.28
2020,CB2020,047,3,Brooklyn,30472003001,375,191,184,5.19
2020,CB2020,047,3,Brooklyn,30472003002,254,128,126,5.21
2020,CB2020,047,3,Brooklyn,30472003003,195,87,108,3.55
2020,CB2020,047,3,Brooklyn,30474001000,280,111,169,3.79
2020,CB2020,047,3,Brooklyn,30474001001,1037,567,470,9.92
2020,CB2020,047,3,Brooklyn,30474001002,178,100,78,3.04
2020,CB2020,047,3,Brooklyn,30474001003,186,100,86,2.25
2020,CB2020,047,3,Brooklyn,30474001004,123,76,47,2.88
2020,CB2020,047,3,Brooklyn,30474001005,66,15,51,2.07
2020,CB2020,047,3,Brooklyn,30474002000,434,232,202,5.25
2020,CB2020,047,3,Brooklyn,30474002001,465,235,230,5.21
2020,CB2020,047,3,Brooklyn,30474002002,280,169,111,5.13
2020,CB2020,047,3,Brooklyn,30474002003,125,74,51,2.11
2020,CB2020,047,3,Brooklyn,30474002004,58,16,42,1.34
2020,CB2020,047,3,Brooklyn,30474002005,0,0,0,0.46
2020,CB2020,047,3,Brooklyn,30476001000,348,207,141,2.6
2020,CB2020,047,3,Brooklyn,30476001001,445,220,225,3.33
2020,CB2020,047,3,Brooklyn,30476001002,106,49,57,1.96
2020,CB2020,047,3,Brooklyn,30476001003,154,74,80,2.6
2020,CB2020,047,3,Brooklyn,30476001004,357,176,181,5.01
2020,CB2020,047,3,Brooklyn,30476001005,0,0,0,0.8
2020,CB2020,047,3,Brooklyn,30476002000,346,177,169,5.21
2020,CB2020,047,3,Brooklyn,30476002001,584,303,281,4.54
2020,CB2020,047,3,Brooklyn,30476002002,181,97,84,4.25
2020,CB2020,047,3,Brooklyn,30476003000,443,231,212,5.19
2020,CB2020,047,3,Brooklyn,30476003001,346,167,179,5.21
2020,CB2020,047,3,Brooklyn,30476003002,383,181,202,5.2
2020,CB2020,047,3,Brooklyn,30476003003,361,192,169,5.29
2020,CB2020,047,3,Brooklyn,30477001000,0,0,0,0.43
2020,CB2020,047,3,Brooklyn,30477001001,0,0,0,0.3
2020,CB2020,047,3,Brooklyn,30477001002,0,0,0,0.37
2020,CB2020,047,3,Brooklyn,30477001003,0,0,0,0.38
2020,CB2020,047,3,Brooklyn,30477001004,0,0,0,0.55
2020,CB2020,047,3,Brooklyn,30477001005,0,0,0,0.35
2020,CB2020,047,3,Brooklyn,30477001006,0,0,0,0.4
2020,CB2020,047,3,Brooklyn,30477001007,0,0,0,0.27
2020,CB2020,047,3,Brooklyn,30477001008,124,59,65,1.57
2020,CB2020,047,3,Brooklyn,30477001009,300,148,152,2.54
2020,CB2020,047,3,Brooklyn,30477001010,268,144,124,2.81
2020,CB2020,047,3,Brooklyn,30477001011,211,120,91,2.75
2020,CB2020,047,3,Brooklyn,30477001012,188,102,86,2.73
2020,CB2020,047,3,Brooklyn,30477001013,141,83,58,1.74
2020,CB2020,047,3,Brooklyn,30477001014,16,11,5,1.51
2020,CB2020,047,3,Brooklyn,30477001015,0,0,0,0.36
2020,CB2020,047,3,Brooklyn,30477001016,0,0,0,0.41
2020,CB2020,047,3,Brooklyn,30477001017,0,0,0,0.38
2020,CB2020,047,3,Brooklyn,30477001018,0,0,0,0.44
2020,CB2020,047,3,Brooklyn,30477001019,0,0,0,0.48
2020,CB2020,047,3,Brooklyn,30477001020,0,0,0,0.45
2020,CB2020,047,3,Brooklyn,30477001021,44,36,8,0.7
2020,CB2020,047,3,Brooklyn,30477001022,61,15,46,1.52
2020,CB2020,047,3,Brooklyn,30477001023,155,87,68,1.81
2020,CB2020,047,3,Brooklyn,30477001024,287,140,147,2.96
2020,CB2020,047,3,Brooklyn,30477002000,28,6,22,0.99
2020,CB2020,047,3,Brooklyn,30477002001,252,124,128,3.71
2020,CB2020,047,3,Brooklyn,30477002002,281,102,179,2.61
2020,CB2020,047,3,Brooklyn,30477002003,171,123,48,2.1
2020,CB2020,047,3,Brooklyn,30477002004,432,254,178,3.02
2020,CB2020,047,3,Brooklyn,30477002005,143,72,71,1.74
2020,CB2020,047,3,Brooklyn,30477002006,11,7,4,1.26
2020,CB2020,047,3,Brooklyn,30477002007,402,179,223,3.25
2020,CB2020,047,3,Brooklyn,30477002008,32,21,11,0.69
2020,CB2020,047,3,Brooklyn,30477002009,0,0,0,0.42
2020,CB2020,047,3,Brooklyn,30477002010,679,345,334,5.5
2020,CB2020,047,3,Brooklyn,30477002011,0,0,0,0.33
2020,CB2020,047,3,Brooklyn,30478001000,438,217,221,6.56
2020,CB2020,047,3,Brooklyn,30478001001,483,241,242,6.22
2020,CB2020,047,3,Brooklyn,30478001002,531,271,260,6.34
2020,CB2020,047,3,Brooklyn,30478002000,81,43,38,1.38
2020,CB2020,047,3,Brooklyn,30478002001,219,110,109,2.06
2020,CB2020,047,3,Brooklyn,30478002002,724,402,322,5.19
2020,CB2020,047,3,Brooklyn,30478002003,265,191,74,0.96
2020,CB2020,047,3,Brooklyn,30478002004,434,203,231,4.61
2020,CB2020,047,3,Brooklyn,30478003000,125,63,62,1.87
2020,CB2020,047,3,Brooklyn,30478003001,405,221,184,3.28
2020,CB2020,047,3,Brooklyn,30478003002,218,116,102,2.83
2020,CB2020,047,3,Brooklyn,30478003003,287,169,118,2.04
2020,CB2020,047,3,Brooklyn,30478003004,693,345,348,5.21
2020,CB2020,047,3,Brooklyn,30478003005,405,197,208,6.12
2020,CB2020,047,3,Brooklyn,30480001000,447,255,192,3.88
2020,CB2020,047,3,Brooklyn,30480001001,289,137,152,3.54
2020,CB2020,047,3,Brooklyn,30480001002,428,194,234,6.05
2020,CB2020,047,3,Brooklyn,30480001003,580,287,293,5.17
2020,CB2020,047,3,Brooklyn,30480002000,455,246,209,4.63
2020,CB2020,047,3,Brooklyn,30480002001,606,319,287,4.59
2020,CB2020,047,3,Brooklyn,30480002002,473,249,224,3.79
2020,CB2020,047,3,Brooklyn,30480002003,340,168,172,3.32
2020,CB2020,047,3,Brooklyn,30480002004,140,72,68,1.35
2020,CB2020,047,3,Brooklyn,30480002005,66,25,41,1.53
2020,CB2020,047,3,Brooklyn,30481001000,434,217,217,5.51
2020,CB2020,047,3,Brooklyn,30481001001,153,57,96,2.28
2020,CB2020,047,3,Brooklyn,30481001002,125,69,56,3.68
2020,CB2020,047,3,Brooklyn,30481002000,173,99,74,4.07
2020,CB2020,047,3,Brooklyn,30481002001,145,62,83,1.78
2020,CB2020,047,3,Brooklyn,30481002002,460,209,251,4.02
2020,CB2020,047,3,Brooklyn,30481003000,286,153,133,2.44
2020,CB2020,047,3,Brooklyn,30481003001,384,193,191,5.24
2020,CB2020,047,3,Brooklyn,30481003002,104,37,67,2.2
2020,CB2020,047,3,Brooklyn,30481003003,462,233,229,3.33
2020,CB2020,047,3,Brooklyn,30481003004,379,194,185,2.84
2020,CB2020,047,3,Brooklyn,30482001000,490,238,252,3.65
2020,CB2020,047,3,Brooklyn,30482001001,287,166,121,2.37
2020,CB2020,047,3,Brooklyn,30482001002,344,175,169,2.98
2020,CB2020,047,3,Brooklyn,30482002000,510,243,267,5.42
2020,CB2020,047,3,Brooklyn,30482002001,955,484,471,6.13
2020,CB2020,047,3,Brooklyn,30482002002,0,0,0,0.55
2020,CB2020,047,3,Brooklyn,30482002003,0,0,0,0.49
2020,CB2020,047,3,Brooklyn,30482002004,0,0,0,0.44
2020,CB2020,047,3,Brooklyn,30482002005,0,0,0,0.43
2020,CB2020,047,3,Brooklyn,30482003000,1240,609,631,4.64
2020,CB2020,047,3,Brooklyn,30482003001,777,371,406,4.94
2020,CB2020,047,3,Brooklyn,30482003002,0,0,0,0.51
2020,CB2020,047,3,Brooklyn,30482003003,0,0,0,0.54
2020,CB2020,047,3,Brooklyn,30482003004,0,0,0,0.55
2020,CB2020,047,3,Brooklyn,30482003005,0,0,0,0.51
2020,CB2020,047,3,Brooklyn,30482004000,360,172,188,2.54
2020,CB2020,047,3,Brooklyn,30482004001,387,198,189,1.84
2020,CB2020,047,3,Brooklyn,30482005000,415,228,187,5.52
2020,CB2020,047,3,Brooklyn,30482005001,357,191,166,4.53
2020,CB2020,047,3,Brooklyn,30484001000,372,200,172,6.07
2020,CB2020,047,3,Brooklyn,30484001001,878,435,443,7.15
2020,CB2020,047,3,Brooklyn,30484001002,113,49,64,1.94
2020,CB2020,047,3,Brooklyn,30484001003,0,0,0,2.18
2020,CB2020,047,3,Brooklyn,30484001004,1179,595,584,6.08
2020,CB2020,047,3,Brooklyn,30484002000,483,248,235,5.26
2020,CB2020,047,3,Brooklyn,30484002001,543,290,253,5.26
2020,CB2020,047,3,Brooklyn,30484002002,756,400,356,5.24
2020,CB2020,047,3,Brooklyn,30484003000,342,158,184,2.13
2020,CB2020,047,3,Brooklyn,30484003001,365,177,188,2.92
2020,CB2020,047,3,Brooklyn,30484003002,202,103,99,3.37
2020,CB2020,047,3,Brooklyn,30484003003,689,362,327,4.09
2020,CB2020,047,3,Brooklyn,30485001000,16,10,6,3.5
2020,CB2020,047,3,Brooklyn,30485001001,41,13,28,2.49
2020,CB2020,047,3,Brooklyn,30485001002,74,36,38,5.68
2020,CB2020,047,3,Brooklyn,30485001003,12,3,9,3.14
2020,CB2020,047,3,Brooklyn,30485001004,8,5,3,2.67
2020,CB2020,047,3,Brooklyn,30485001005,10,4,6,2.77
2020,CB2020,047,3,Brooklyn,30485001006,0,0,0,2.77
2020,CB2020,047,3,Brooklyn,30485001007,26,15,11,3.55
2020,CB2020,047,3,Brooklyn,30485001008,15,14,1,2.44
2020,CB2020,047,3,Brooklyn,30485001009,0,0,0,3.62
2020,CB2020,047,3,Brooklyn,30485001010,13,13,0,14.78
2020,CB2020,047,3,Brooklyn,30485001011,278,132,146,5.03
2020,CB2020,047,3,Brooklyn,30485001012,20,15,5,4.97
2020,CB2020,047,3,Brooklyn,30485001013,18,7,11,3.87
2020,CB2020,047,3,Brooklyn,30485001014,32,18,14,18.59
2020,CB2020,047,3,Brooklyn,30485001015,19,13,6,2.89
2020,CB2020,047,3,Brooklyn,30485001016,90,36,54,5.15
2020,CB2020,047,3,Brooklyn,30485001017,0,0,0,2.36
2020,CB2020,047,3,Brooklyn,30485001018,30,17,13,3.24
2020,CB2020,047,3,Brooklyn,30485001019,246,138,108,7.22
2020,CB2020,047,3,Brooklyn,30485002000,122,39,83,3.2
2020,CB2020,047,3,Brooklyn,30485002001,83,32,51,1.28
2020,CB2020,047,3,Brooklyn,30485002002,313,196,117,3.15
2020,CB2020,047,3,Brooklyn,30485002003,65,24,41,2.33
2020,CB2020,047,3,Brooklyn,30485002004,32,11,21,6.3
2020,CB2020,047,3,Brooklyn,30485002005,50,42,8,3.13
2020,CB2020,047,3,Brooklyn,30485002006,470,334,136,3.06
2020,CB2020,047,3,Brooklyn,30485002007,55,17,38,5.39
2020,CB2020,047,3,Brooklyn,30485002008,130,60,70,4.73
2020,CB2020,047,3,Brooklyn,30485002009,77,53,24,3.02
2020,CB2020,047,3,Brooklyn,30485002010,79,49,30,5.61
2020,CB2020,047,3,Brooklyn,30485002011,46,27,19,1.77
2020,CB2020,047,3,Brooklyn,30486001000,0,0,0,0.37
2020,CB2020,047,3,Brooklyn,30486001001,841,454,387,6.97
2020,CB2020,047,3,Brooklyn,30486001002,391,209,182,6.87
2020,CB2020,047,3,Brooklyn,30486002000,553,288,265,5.25
2020,CB2020,047,3,Brooklyn,30486002001,651,331,320,6.86
2020,CB2020,047,3,Brooklyn,30486003000,794,446,348,5.72
2020,CB2020,047,3,Brooklyn,30486003001,312,168,144,5.69
2020,CB2020,047,3,Brooklyn,30486003002,55,27,28,5.63
2020,CB2020,047,3,Brooklyn,30488001000,328,150,178,1.8
2020,CB2020,047,3,Brooklyn,30488001001,40,20,20,1.22
2020,CB2020,047,3,Brooklyn,30488001002,408,227,181,5.26
2020,CB2020,047,3,Brooklyn,30488001003,555,254,301,5.25
2020,CB2020,047,3,Brooklyn,30488002000,700,360,340,5.24
2020,CB2020,047,3,Brooklyn,30488002001,689,336,353,5.25
2020,CB2020,047,3,Brooklyn,30488003000,1338,660,678,6.15
2020,CB2020,047,3,Brooklyn,30488003001,478,247,231,5.25
2020,CB2020,047,3,Brooklyn,30489001000,532,177,355,3.54
2020,CB2020,047,3,Brooklyn,30489001001,619,262,357,4.61
2020,CB2020,047,3,Brooklyn,30489002000,1186,526,660,4.73
2020,CB2020,047,3,Brooklyn,30489003000,1420,570,850,9.76
2020,CB2020,047,3,Brooklyn,30490001000,1149,536,613,5.94
2020,CB2020,047,3,Brooklyn,30490001001,1038,521,517,6.24
2020,CB2020,047,3,Brooklyn,30490001002,0,0,0,1.53
2020,CB2020,047,3,Brooklyn,30490001003,0,0,0,1.64
2020,CB2020,047,3,Brooklyn,30490001004,336,164,172,5.97
2020,CB2020,047,3,Brooklyn,30490002000,1451,721,730,6.24
2020,CB2020,047,3,Brooklyn,30490002001,0,0,0,1.54
2020,CB2020,047,3,Brooklyn,30490002002,0,0,0,1.57
2020,CB2020,047,3,Brooklyn,30490002003,1219,586,633,6.22
2020,CB2020,047,3,Brooklyn,30490003000,369,205,164,5.25
2020,CB2020,047,3,Brooklyn,30490003001,474,251,223,5.25
2020,CB2020,047,3,Brooklyn,30491001000,1660,732,928,8.14
2020,CB2020,047,3,Brooklyn,30491001001,192,96,96,3.01
2020,CB2020,047,3,Brooklyn,30491002000,342,172,170,2.89
2020,CB2020,047,3,Brooklyn,30491002001,192,101,91,2.84
2020,CB2020,047,3,Brooklyn,30491002002,174,73,101,5.75
2020,CB2020,047,3,Brooklyn,30491002003,165,79,86,3.42
2020,CB2020,047,3,Brooklyn,30491003000,355,166,189,2.87
2020,CB2020,047,3,Brooklyn,30491003001,390,148,242,2.89
2020,CB2020,047,3,Brooklyn,30491003002,386,190,196,2.85
2020,CB2020,047,3,Brooklyn,30491003003,647,313,334,2.87
2020,CB2020,047,3,Brooklyn,30491003004,100,43,57,2.45
2020,CB2020,047,3,Brooklyn,30491003005,40,18,22,0.84
2020,CB2020,047,3,Brooklyn,30491004000,867,392,475,6.18
2020,CB2020,047,3,Brooklyn,30491004001,856,385,471,1.87
2020,CB2020,047,3,Brooklyn,30491004002,0,0,0,3.81
2020,CB2020,047,3,Brooklyn,30492001000,112,61,51,2.86
2020,CB2020,047,3,Brooklyn,30492001001,105,37,68,2.69
2020,CB2020,047,3,Brooklyn,30492001002,309,157,152,2.89
2020,CB2020,047,3,Brooklyn,30492001003,546,273,273,5.34
2020,CB2020,047,3,Brooklyn,30492002000,351,250,101,4.23
2020,CB2020,047,3,Brooklyn,30492002001,343,170,173,5.6
2020,CB2020,047,3,Brooklyn,30492002002,569,277,292,5.39
2020,CB2020,047,3,Brooklyn,30492003000,250,140,110,6.84
2020,CB2020,047,3,Brooklyn,30492003001,781,382,399,5.34
2020,CB2020,047,3,Brooklyn,30493011000,345,141,204,2.72
2020,CB2020,047,3,Brooklyn,30493011001,348,136,212,2.68
2020,CB2020,047,3,Brooklyn,30493011002,248,85,163,2.96
2020,CB2020,047,3,Brooklyn,30493011003,278,103,175,2.9
2020,CB2020,047,3,Brooklyn,30493011004,340,137,203,2.75
2020,CB2020,047,3,Brooklyn,30493011005,338,136,202,2.74
2020,CB2020,047,3,Brooklyn,30493021000,560,326,234,2.83
2020,CB2020,047,3,Brooklyn,30493021001,506,268,238,2.82
2020,CB2020,047,3,Brooklyn,30493021002,400,198,202,2.92
2020,CB2020,047,3,Brooklyn,30493022000,282,113,169,2.08
2020,CB2020,047,3,Brooklyn,30493022001,449,236,213,2.92
2020,CB2020,047,3,Brooklyn,30493022002,214,114,100,2.91
2020,CB2020,047,3,Brooklyn,30493022003,182,80,102,2.01
2020,CB2020,047,3,Brooklyn,30493023000,120,51,69,1.31
2020,CB2020,047,3,Brooklyn,30493023001,143,52,91,2.81
2020,CB2020,047,3,Brooklyn,30493023002,1233,528,705,5.59
2020,CB2020,047,3,Brooklyn,30493024000,374,172,202,2.92
2020,CB2020,047,3,Brooklyn,30493024001,261,125,136,2.82
2020,CB2020,047,3,Brooklyn,30493024002,752,302,450,5.64
2020,CB2020,047,3,Brooklyn,30494001000,630,300,330,5.46
2020,CB2020,047,3,Brooklyn,30494001001,710,350,360,4.9
2020,CB2020,047,3,Brooklyn,30494001002,0,0,0,1.01
2020,CB2020,047,3,Brooklyn,30494001003,0,0,0,0.99
2020,CB2020,047,3,Brooklyn,30494002000,666,351,315,6
2020,CB2020,047,3,Brooklyn,30494002001,992,461,531,6.2
2020,CB2020,047,3,Brooklyn,30494002002,37,18,19,1.58
2020,CB2020,047,3,Brooklyn,30494002003,0,0,0,1.64
2020,CB2020,047,3,Brooklyn,30494003000,1193,590,603,6.13
2020,CB2020,047,3,Brooklyn,30494003001,564,263,301,5.26
2020,CB2020,047,3,Brooklyn,30494004000,453,225,228,3.57
2020,CB2020,047,3,Brooklyn,30494004001,282,144,138,2.39
2020,CB2020,047,3,Brooklyn,30495001000,111,54,57,1.59
2020,CB2020,047,3,Brooklyn,30495001001,290,157,133,1.98
2020,CB2020,047,3,Brooklyn,30495001002,240,123,117,2.46
2020,CB2020,047,3,Brooklyn,30495001003,432,217,215,2.9
2020,CB2020,047,3,Brooklyn,30495002000,282,98,184,2.81
2020,CB2020,047,3,Brooklyn,30495002001,259,151,108,2.8
2020,CB2020,047,3,Brooklyn,30495002002,277,125,152,2.92
2020,CB2020,047,3,Brooklyn,30495002003,135,71,64,1.63
2020,CB2020,047,3,Brooklyn,30495002004,119,69,50,1.31
2020,CB2020,047,3,Brooklyn,30495003000,164,81,83,2.82
2020,CB2020,047,3,Brooklyn,30495003001,191,84,107,2.81
2020,CB2020,047,3,Brooklyn,30495003002,301,154,147,2.93
2020,CB2020,047,3,Brooklyn,30495003003,184,97,87,1.46
2020,CB2020,047,3,Brooklyn,30495003004,129,64,65,1.48
2020,CB2020,047,3,Brooklyn,30496001000,153,64,89,2.64
2020,CB2020,047,3,Brooklyn,30496001001,293,166,127,2.88
2020,CB2020,047,3,Brooklyn,30496001002,272,135,137,3.45
2020,CB2020,047,3,Brooklyn,30496001003,407,220,187,4.03
2020,CB2020,047,3,Brooklyn,30496001004,685,328,357,5.99
2020,CB2020,047,3,Brooklyn,30496002000,547,283,264,6.03
2020,CB2020,047,3,Brooklyn,30496002001,532,282,250,5.38
2020,CB2020,047,3,Brooklyn,30496002002,426,183,243,4.89
2020,CB2020,047,3,Brooklyn,30496003000,306,176,130,2.93
2020,CB2020,047,3,Brooklyn,30496003001,283,145,138,3.58
2020,CB2020,047,3,Brooklyn,30496003002,143,77,66,2.59
2020,CB2020,047,3,Brooklyn,30496003003,218,105,113,2.53
2020,CB2020,047,3,Brooklyn,30496003004,381,151,230,3.24
2020,CB2020,047,3,Brooklyn,30497001000,116,57,59,1.83
2020,CB2020,047,3,Brooklyn,30497001001,94,52,42,0.97
2020,CB2020,047,3,Brooklyn,30497001002,236,112,124,2.64
2020,CB2020,047,3,Brooklyn,30497001003,0,0,0,0.08
2020,CB2020,047,3,Brooklyn,30497001004,249,122,127,2.81
2020,CB2020,047,3,Brooklyn,30497001005,202,86,116,2.81
2020,CB2020,047,3,Brooklyn,30497002000,218,127,91,2.81
2020,CB2020,047,3,Brooklyn,30497002001,231,83,148,2.81
2020,CB2020,047,3,Brooklyn,30497002002,83,39,44,2.81
2020,CB2020,047,3,Brooklyn,30497002003,293,136,157,2.78
2020,CB2020,047,3,Brooklyn,30497002004,202,111,91,2.93
2020,CB2020,047,3,Brooklyn,30497002005,84,45,39,1.28
2020,CB2020,047,3,Brooklyn,30497003000,301,133,168,2.81
2020,CB2020,047,3,Brooklyn,30497003001,290,163,127,2.81
2020,CB2020,047,3,Brooklyn,30497003002,201,87,114,2.83
2020,CB2020,047,3,Brooklyn,30497003003,122,69,53,2.76
2020,CB2020,047,3,Brooklyn,30497003004,219,114,105,2.91
2020,CB2020,047,3,Brooklyn,30498001000,471,215,256,4.8
2020,CB2020,047,3,Brooklyn,30498001001,931,467,464,6.1
2020,CB2020,047,3,Brooklyn,30498001002,59,31,28,5.37
2020,CB2020,047,3,Brooklyn,30498001003,87,27,60,1.55
2020,CB2020,047,3,Brooklyn,30498001004,125,61,64,1.52
2020,CB2020,047,3,Brooklyn,30498002000,696,339,357,6.49
2020,CB2020,047,3,Brooklyn,30498002001,244,133,111,4.42
2020,CB2020,047,3,Brooklyn,30498002002,788,369,419,6.01
2020,CB2020,047,3,Brooklyn,30498003000,186,100,86,5.7
2020,CB2020,047,3,Brooklyn,30498003001,527,269,258,4.54
2020,CB2020,047,3,Brooklyn,30498003002,403,171,232,4
2020,CB2020,047,3,Brooklyn,30499001000,113,54,59,2.57
2020,CB2020,047,3,Brooklyn,30499001001,0,0,0,0.25
2020,CB2020,047,3,Brooklyn,30499001002,59,23,36,0.68
2020,CB2020,047,3,Brooklyn,30499001003,249,133,116,2.52
2020,CB2020,047,3,Brooklyn,30499001004,163,81,82,2.74
2020,CB2020,047,3,Brooklyn,30499001005,182,92,90,1.92
2020,CB2020,047,3,Brooklyn,30499001006,0,0,0,0.29
2020,CB2020,047,3,Brooklyn,30499001007,96,23,73,1.4
2020,CB2020,047,3,Brooklyn,30499002000,88,54,34,1.31
2020,CB2020,047,3,Brooklyn,30499002001,225,114,111,1.47
2020,CB2020,047,3,Brooklyn,30499002002,129,61,68,2.05
2020,CB2020,047,3,Brooklyn,30499002003,272,157,115,2.87
2020,CB2020,047,3,Brooklyn,30499002004,82,44,38,1.12
2020,CB2020,047,3,Brooklyn,30499002005,0,0,0,4.35
2020,CB2020,047,3,Brooklyn,30499002006,238,124,114,2.13
2020,CB2020,047,3,Brooklyn,30499002007,109,48,61,2.16
2020,CB2020,047,3,Brooklyn,30499002008,88,36,52,2.33
2020,CB2020,047,3,Brooklyn,30499002009,54,25,29,2.85
2020,CB2020,047,3,Brooklyn,30500011000,277,133,144,4.01
2020,CB2020,047,3,Brooklyn,30500011001,622,286,336,5.07
2020,CB2020,047,3,Brooklyn,30500011002,0,0,0,1.52
2020,CB2020,047,3,Brooklyn,30500011003,0,0,0,1.8
2020,CB2020,047,3,Brooklyn,30500012000,0,0,0,3.86
2020,CB2020,047,3,Brooklyn,30500012001,170,87,83,3.98
2020,CB2020,047,3,Brooklyn,30500012002,269,115,154,4.01
2020,CB2020,047,3,Brooklyn,30500012003,266,129,137,2.34
2020,CB2020,047,3,Brooklyn,30500012004,175,88,87,2.85
2020,CB2020,047,3,Brooklyn,30500012005,283,145,138,3.61
2020,CB2020,047,3,Brooklyn,30500012006,0,0,0,0.51
2020,CB2020,047,3,Brooklyn,30500012007,0,0,0,1.06
2020,CB2020,047,3,Brooklyn,30500021000,975,448,527,5.76
2020,CB2020,047,3,Brooklyn,30500021001,399,197,202,4.8
2020,CB2020,047,3,Brooklyn,30500021002,233,100,133,4.8
2020,CB2020,047,3,Brooklyn,30501001000,38,25,13,0.54
2020,CB2020,047,3,Brooklyn,30501001001,154,68,86,2.51
2020,CB2020,047,3,Brooklyn,30501001002,241,130,111,2.77
2020,CB2020,047,3,Brooklyn,30501001003,277,132,145,2.76
2020,CB2020,047,3,Brooklyn,30501001004,188,105,83,2.75
2020,CB2020,047,3,Brooklyn,30501002000,337,157,180,2.7
2020,CB2020,047,3,Brooklyn,30501002001,367,181,186,2.69
2020,CB2020,047,3,Brooklyn,30501002002,230,104,126,2.74
2020,CB2020,047,3,Brooklyn,30501003000,0,0,0,0.14
2020,CB2020,047,3,Brooklyn,30501003001,0,0,0,0.55
2020,CB2020,047,3,Brooklyn,30501003002,0,0,0,0.39
2020,CB2020,047,3,Brooklyn,30501003003,0,0,0,0.54
2020,CB2020,047,3,Brooklyn,30501003004,0,0,0,0.6
2020,CB2020,047,3,Brooklyn,30501003005,0,0,0,0.62
2020,CB2020,047,3,Brooklyn,30501003006,0,0,0,0.56
2020,CB2020,047,3,Brooklyn,30501003007,0,0,0,0.36
2020,CB2020,047,3,Brooklyn,30501003008,131,44,87,2.37
2020,CB2020,047,3,Brooklyn,30501003009,184,115,69,2.25
2020,CB2020,047,3,Brooklyn,30501003010,217,119,98,2.76
2020,CB2020,047,3,Brooklyn,30501003011,0,0,0,0.94
2020,CB2020,047,3,Brooklyn,30501003012,0,0,0,0.78
2020,CB2020,047,3,Brooklyn,30501003013,0,0,0,0.51
2020,CB2020,047,3,Brooklyn,30501003014,0,0,0,0.63
2020,CB2020,047,3,Brooklyn,30501003015,0,0,0,0.4
2020,CB2020,047,3,Brooklyn,30501003016,0,0,0,0.74
2020,CB2020,047,3,Brooklyn,30501003017,303,155,148,3.6
2020,CB2020,047,3,Brooklyn,30501003018,284,133,151,3.03
2020,CB2020,047,3,Brooklyn,30501003019,0,0,0,1.42
2020,CB2020,047,3,Brooklyn,30502021000,787,368,419,7.53
2020,CB2020,047,3,Brooklyn,30502021001,380,186,194,5.72
2020,CB2020,047,3,Brooklyn,30502022000,393,167,226,4.14
2020,CB2020,047,3,Brooklyn,30502022001,140,74,66,2.9
2020,CB2020,047,3,Brooklyn,30502022002,216,100,116,3.07
2020,CB2020,047,3,Brooklyn,30502022003,159,69,90,5.16
2020,CB2020,047,3,Brooklyn,30502022004,129,69,60,2.46
2020,CB2020,047,3,Brooklyn,30502022005,108,45,63,2.56
2020,CB2020,047,3,Brooklyn,30503001000,218,98,120,2.86
2020,CB2020,047,3,Brooklyn,30503001001,219,108,111,2.75
2020,CB2020,047,3,Brooklyn,30503001002,164,71,93,2.75
2020,CB2020,047,3,Brooklyn,30503001003,198,115,83,2.86
2020,CB2020,047,3,Brooklyn,30503002000,292,114,178,1.34
2020,CB2020,047,3,Brooklyn,30503002001,91,51,40,1.35
2020,CB2020,047,3,Brooklyn,30503002002,149,85,64,1.53
2020,CB2020,047,3,Brooklyn,30503002003,108,50,58,1.52
2020,CB2020,047,3,Brooklyn,30503002004,475,207,268,2.77
2020,CB2020,047,3,Brooklyn,30503003000,172,93,79,2.89
2020,CB2020,047,3,Brooklyn,30503003001,247,117,130,2.75
2020,CB2020,047,3,Brooklyn,30503003002,252,122,130,2.75
2020,CB2020,047,3,Brooklyn,30503003003,174,86,88,2.86
2020,CB2020,047,3,Brooklyn,30504011000,530,245,285,4.86
2020,CB2020,047,3,Brooklyn,30504011001,244,124,120,3.05
2020,CB2020,047,3,Brooklyn,30504011002,331,146,185,3.12
2020,CB2020,047,3,Brooklyn,30504011003,0,0,0,1.81
2020,CB2020,047,3,Brooklyn,30504011004,0,0,0,0.99
2020,CB2020,047,3,Brooklyn,30504012000,0,0,0,3.22
2020,CB2020,047,3,Brooklyn,30504012001,0,0,0,1.79
2020,CB2020,047,3,Brooklyn,30504012002,616,282,334,3.23
2020,CB2020,047,3,Brooklyn,30504012003,524,239,285,4
2020,CB2020,047,3,Brooklyn,30504012004,0,0,0,0.73
2020,CB2020,047,3,Brooklyn,30504012005,212,69,143,1.37
2020,CB2020,047,3,Brooklyn,30504012006,201,115,86,2.29
2020,CB2020,047,3,Brooklyn,30504012007,223,137,86,3.76
2020,CB2020,047,3,Brooklyn,30504012008,116,62,54,1.58
2020,CB2020,047,3,Brooklyn,30504021000,1146,515,631,6.78
2020,CB2020,047,3,Brooklyn,30504021001,0,0,0,1.52
2020,CB2020,047,3,Brooklyn,30504021002,0,0,0,1.69
2020,CB2020,047,3,Brooklyn,30504022000,117,33,84,2.42
2020,CB2020,047,3,Brooklyn,30504022001,71,47,24,1.2
2020,CB2020,047,3,Brooklyn,30504022002,465,238,227,3.62
2020,CB2020,047,3,Brooklyn,30504022003,205,132,73,3.62
2020,CB2020,047,3,Brooklyn,30505001000,362,141,221,2.71
2020,CB2020,047,3,Brooklyn,30505001001,342,132,210,2.61
2020,CB2020,047,3,Brooklyn,30505001002,305,101,204,2.83
2020,CB2020,047,3,Brooklyn,30505001003,29,13,16,5.7
2020,CB2020,047,3,Brooklyn,30505001004,408,166,242,2.63
2020,CB2020,047,3,Brooklyn,30505002000,351,166,185,2.82
2020,CB2020,047,3,Brooklyn,30505002001,254,134,120,2.75
2020,CB2020,047,3,Brooklyn,30505002002,379,181,198,2.86
2020,CB2020,047,3,Brooklyn,30505002003,539,279,260,2.94
2020,CB2020,047,3,Brooklyn,30505003000,160,79,81,2.95
2020,CB2020,047,3,Brooklyn,30505003001,855,420,435,5.32
2020,CB2020,047,3,Brooklyn,30505003002,362,190,172,2.85
2020,CB2020,047,3,Brooklyn,30505003003,221,102,119,2.88
2020,CB2020,047,3,Brooklyn,30506001000,116,57,59,1.43
2020,CB2020,047,3,Brooklyn,30506001001,1016,487,529,4.37
2020,CB2020,047,3,Brooklyn,30506001002,250,125,125,1.67
2020,CB2020,047,3,Brooklyn,30506002000,611,280,331,4.38
2020,CB2020,047,3,Brooklyn,30506002001,153,71,82,4.22
2020,CB2020,047,3,Brooklyn,30506002002,73,30,43,4.22
2020,CB2020,047,3,Brooklyn,30506003000,583,306,277,4.22
2020,CB2020,047,3,Brooklyn,30506003001,1115,539,576,4.22
2020,CB2020,047,3,Brooklyn,30506004000,948,470,478,4.19
2020,CB2020,047,3,Brooklyn,30506004001,526,238,288,4.84
2020,CB2020,047,3,Brooklyn,30506004002,221,109,112,2.93
2020,CB2020,047,3,Brooklyn,30507001000,555,286,269,1.29
2020,CB2020,047,3,Brooklyn,30507001001,469,240,229,4.16
2020,CB2020,047,3,Brooklyn,30507001002,457,244,213,1.67
2020,CB2020,047,3,Brooklyn,30507001003,0,0,0,2.76
2020,CB2020,047,3,Brooklyn,30507001004,497,260,237,1.56
2020,CB2020,047,3,Brooklyn,30507001005,0,0,0,0.34
2020,CB2020,047,3,Brooklyn,30507001006,4,2,2,3.96
2020,CB2020,047,3,Brooklyn,30507001007,554,285,269,4.15
2020,CB2020,047,3,Brooklyn,30507001008,43,6,37,4.15
2020,CB2020,047,3,Brooklyn,30507001009,418,188,230,2.08
2020,CB2020,047,3,Brooklyn,30507001010,311,175,136,2.49
2020,CB2020,047,3,Brooklyn,30507001011,63,24,39,2.76
2020,CB2020,047,3,Brooklyn,30507001012,97,70,27,2.59
2020,CB2020,047,3,Brooklyn,30507001013,35,16,19,1.71
2020,CB2020,047,3,Brooklyn,30507001014,42,15,27,4
2020,CB2020,047,3,Brooklyn,30507001015,0,0,0,0.45
2020,CB2020,047,3,Brooklyn,30507001016,0,0,0,2.99
2020,CB2020,047,3,Brooklyn,30508011000,962,419,543,3.91
2020,CB2020,047,3,Brooklyn,30508011001,420,189,231,2.98
2020,CB2020,047,3,Brooklyn,30508012000,1185,532,653,6.98
2020,CB2020,047,3,Brooklyn,30508012001,1744,820,924,5.46
2020,CB2020,047,3,Brooklyn,30508031000,631,334,297,4.06
2020,CB2020,047,3,Brooklyn,30508031001,844,408,436,5.15
2020,CB2020,047,3,Brooklyn,30508031002,1073,454,619,4.65
2020,CB2020,047,3,Brooklyn,30508041000,1133,499,634,4.28
2020,CB2020,047,3,Brooklyn,30508041001,801,378,423,4.03
2020,CB2020,047,3,Brooklyn,30508042000,797,364,433,4.33
2020,CB2020,047,3,Brooklyn,30508042001,1129,483,646,4.16
2020,CB2020,047,3,Brooklyn,30508043000,591,268,323,2.47
2020,CB2020,047,3,Brooklyn,30508043001,384,174,210,1.87
2020,CB2020,047,3,Brooklyn,30508043002,1361,680,681,4.33
2020,CB2020,047,3,Brooklyn,30509001000,0,0,0,0.8
2020,CB2020,047,3,Brooklyn,30509001001,618,317,301,3.04
2020,CB2020,047,3,Brooklyn,30509001002,228,115,113,1.67
2020,CB2020,047,3,Brooklyn,30509001003,740,402,338,2.49
2020,CB2020,047,3,Brooklyn,30509001004,637,318,319,4.03
2020,CB2020,047,3,Brooklyn,30509001005,0,0,0,4.16
2020,CB2020,047,3,Brooklyn,30509001006,85,41,44,0.89
2020,CB2020,047,3,Brooklyn,30509001007,0,0,0,0.42
2020,CB2020,047,3,Brooklyn,30509001008,0,0,0,0.29
2020,CB2020,047,3,Brooklyn,30509002000,0,0,0,4.31
2020,CB2020,047,3,Brooklyn,30509002001,802,393,409,4.31
2020,CB2020,047,3,Brooklyn,30509002002,1217,633,584,4.3
2020,CB2020,047,3,Brooklyn,30509002003,204,85,119,1.28
2020,CB2020,047,3,Brooklyn,30509002004,581,299,282,3.04
2020,CB2020,047,3,Brooklyn,30510011000,1662,756,906,6.81
2020,CB2020,047,3,Brooklyn,30510012000,192,78,114,3.15
2020,CB2020,047,3,Brooklyn,30510012001,1003,441,562,3.28
2020,CB2020,047,3,Brooklyn,30510012002,421,198,223,2.58
2020,CB2020,047,3,Brooklyn,30510012003,462,233,229,3.19
2020,CB2020,047,3,Brooklyn,30510021000,422,201,221,9.04
2020,CB2020,047,3,Brooklyn,30510021001,1385,615,770,7
2020,CB2020,047,3,Brooklyn,30510022000,1657,732,925,6.45
2020,CB2020,047,3,Brooklyn,30510023000,1136,542,594,3.97
2020,CB2020,047,3,Brooklyn,30511001000,0,0,0,5.62
2020,CB2020,047,3,Brooklyn,30511001001,862,379,483,6.14
2020,CB2020,047,3,Brooklyn,30511001002,794,366,428,1.21
2020,CB2020,047,3,Brooklyn,30511002000,83,44,39,2.77
2020,CB2020,047,3,Brooklyn,30511002001,490,240,250,3.72
2020,CB2020,047,3,Brooklyn,30511002002,606,302,304,3.87
2020,CB2020,047,3,Brooklyn,30511002003,317,169,148,2.91
2020,CB2020,047,3,Brooklyn,30511003000,357,209,148,2.83
2020,CB2020,047,3,Brooklyn,30511003001,305,131,174,3.72
2020,CB2020,047,3,Brooklyn,30511003002,356,161,195,3.7
2020,CB2020,047,3,Brooklyn,30511003003,375,176,199,2.8
2020,CB2020,047,3,Brooklyn,30512001000,694,288,406,5.07
2020,CB2020,047,3,Brooklyn,30512001001,187,93,94,4.84
2020,CB2020,047,3,Brooklyn,30512001002,919,400,519,3.11
2020,CB2020,047,3,Brooklyn,30512002000,1487,648,839,5.36
2020,CB2020,047,3,Brooklyn,30512003000,1318,612,706,5.43
2020,CB2020,047,3,Brooklyn,30512004000,1274,563,711,6.41
2020,CB2020,047,3,Brooklyn,30512004001,67,36,31,4.36
2020,CB2020,047,3,Brooklyn,30513001000,375,161,214,4.47
2020,CB2020,047,3,Brooklyn,30513001001,263,141,122,3.7
2020,CB2020,047,3,Brooklyn,30513001002,337,185,152,3.71
2020,CB2020,047,3,Brooklyn,30513001003,292,142,150,3.85
2020,CB2020,047,3,Brooklyn,30513002000,137,59,78,1.93
2020,CB2020,047,3,Brooklyn,30513002001,261,135,126,1.93
2020,CB2020,047,3,Brooklyn,30513002002,596,281,315,3.7
2020,CB2020,047,3,Brooklyn,30513003000,267,144,123,3.87
2020,CB2020,047,3,Brooklyn,30513003001,179,92,87,2.09
2020,CB2020,047,3,Brooklyn,30513003002,142,79,63,2.19
2020,CB2020,047,3,Brooklyn,30513003003,299,146,153,1.5
2020,CB2020,047,3,Brooklyn,30513003004,249,136,113,2.27
2020,CB2020,047,3,Brooklyn,30513003005,339,195,144,3.09
2020,CB2020,047,3,Brooklyn,30513003006,122,53,69,1.39
2020,CB2020,047,3,Brooklyn,30513003007,186,69,117,1.77
2020,CB2020,047,3,Brooklyn,30513003008,62,22,40,0.93
2020,CB2020,047,3,Brooklyn,30513003009,114,59,55,1.41
2020,CB2020,047,3,Brooklyn,30513003010,307,131,176,2.3
2020,CB2020,047,3,Brooklyn,30513004000,0,0,0,2.12
2020,CB2020,047,3,Brooklyn,30513004001,0,0,0,1.69
2020,CB2020,047,3,Brooklyn,30513004002,0,0,0,2.31
2020,CB2020,047,3,Brooklyn,30513004003,0,0,0,0.77
2020,CB2020,047,3,Brooklyn,30513004004,0,0,0,2.18
2020,CB2020,047,3,Brooklyn,30513004005,0,0,0,0.54
2020,CB2020,047,3,Brooklyn,30513004006,0,0,0,0.39
2020,CB2020,047,3,Brooklyn,30513004007,0,0,0,0.47
2020,CB2020,047,3,Brooklyn,30513004008,0,0,0,0.84
2020,CB2020,047,3,Brooklyn,30513004009,0,0,0,1.61
2020,CB2020,047,3,Brooklyn,30513004010,240,117,123,1.55
2020,CB2020,047,3,Brooklyn,30513004011,59,37,22,0.56
2020,CB2020,047,3,Brooklyn,30513004012,700,324,376,2.65
2020,CB2020,047,3,Brooklyn,30514001000,309,150,159,4.59
2020,CB2020,047,3,Brooklyn,30514001001,111,50,61,5.35
2020,CB2020,047,3,Brooklyn,30514001002,560,266,294,6.03
2020,CB2020,047,3,Brooklyn,30514002000,1012,470,542,4.34
2020,CB2020,047,3,Brooklyn,30514002001,896,436,460,4.4
2020,CB2020,047,3,Brooklyn,30514003000,1408,581,827,5.33
2020,CB2020,047,3,Brooklyn,30514003001,905,412,493,4.23
2020,CB2020,047,3,Brooklyn,30514004000,428,175,253,2.28
2020,CB2020,047,3,Brooklyn,30514004001,704,353,351,3.33
2020,CB2020,047,3,Brooklyn,30514004002,690,314,376,4.86
2020,CB2020,047,3,Brooklyn,30515001000,122,78,44,1.22
2020,CB2020,047,3,Brooklyn,30515001001,0,0,0,10.78
2020,CB2020,047,3,Brooklyn,30515001002,0,0,0,11.46
2020,CB2020,047,3,Brooklyn,30515001003,0,0,0,1.26
2020,CB2020,047,3,Brooklyn,30515001004,149,91,58,1.28
2020,CB2020,047,3,Brooklyn,30515001005,135,52,83,1.48
2020,CB2020,047,3,Brooklyn,30515001006,516,265,251,3.72
2020,CB2020,047,3,Brooklyn,30515001007,279,151,128,3.69
2020,CB2020,047,3,Brooklyn,30515001008,656,315,341,2.73
2020,CB2020,047,3,Brooklyn,30515001009,35,13,22,0.83
2020,CB2020,047,3,Brooklyn,30515001010,331,175,156,3.79
2020,CB2020,047,3,Brooklyn,30515001011,74,34,40,1.07
2020,CB2020,047,3,Brooklyn,30515001012,154,43,111,2.39
2020,CB2020,047,3,Brooklyn,30515001013,0,0,0,0.48
2020,CB2020,047,3,Brooklyn,30516011000,900,435,465,3.75
2020,CB2020,047,3,Brooklyn,30516011001,726,301,425,2.82
2020,CB2020,047,3,Brooklyn,30516011002,180,62,118,0.71
2020,CB2020,047,3,Brooklyn,30516012000,780,345,435,3.37
2020,CB2020,047,3,Brooklyn,30516012001,503,235,268,2.24
2020,CB2020,047,3,Brooklyn,30516012002,226,103,123,0.93
2020,CB2020,047,3,Brooklyn,30516013000,334,162,172,2.78
2020,CB2020,047,3,Brooklyn,30516013001,706,289,417,3.17
2020,CB2020,047,3,Brooklyn,30516013002,386,164,222,3.18
2020,CB2020,047,3,Brooklyn,30516013003,326,128,198,2.42
2020,CB2020,047,3,Brooklyn,30516013004,111,58,53,1.93
2020,CB2020,047,3,Brooklyn,30516013005,229,100,129,1.35
2020,CB2020,047,3,Brooklyn,30516021000,1070,469,601,4.54
2020,CB2020,047,3,Brooklyn,30516021001,820,350,470,5.29
2020,CB2020,047,3,Brooklyn,30516022000,384,166,218,3.92
2020,CB2020,047,3,Brooklyn,30516022001,1600,725,875,8.77
2020,CB2020,047,3,Brooklyn,30517001000,0,0,0,14.77
2020,CB2020,047,3,Brooklyn,30517001001,587,307,280,2.75
2020,CB2020,047,3,Brooklyn,30517001002,309,163,146,2.76
2020,CB2020,047,3,Brooklyn,30517001003,199,108,91,2.75
2020,CB2020,047,3,Brooklyn,30517001004,185,103,82,2.75
2020,CB2020,047,3,Brooklyn,30517002000,0,0,0,9.54
2020,CB2020,047,3,Brooklyn,30517002001,316,175,141,2.74
2020,CB2020,047,3,Brooklyn,30517002002,407,206,201,2.75
2020,CB2020,047,3,Brooklyn,30517002003,279,134,145,2.75
2020,CB2020,047,3,Brooklyn,30517002004,354,191,163,2.75
2020,CB2020,047,3,Brooklyn,30518001000,95,52,43,6.16
2020,CB2020,047,3,Brooklyn,30518001001,90,59,31,4.4
2020,CB2020,047,3,Brooklyn,30518001002,948,369,579,4.1
2020,CB2020,047,3,Brooklyn,30518002000,74,38,36,4.85
2020,CB2020,047,3,Brooklyn,30518002001,73,29,44,4.93
2020,CB2020,047,3,Brooklyn,30518002002,63,35,28,3.56
2020,CB2020,047,3,Brooklyn,30518002003,70,28,42,3.47
2020,CB2020,047,3,Brooklyn,30518002004,621,267,354,3.22
2020,CB2020,047,3,Brooklyn,30518002005,499,224,275,3.29
2020,CB2020,047,3,Brooklyn,30518003000,102,50,52,4.94
2020,CB2020,047,3,Brooklyn,30518003001,279,122,157,3.58
2020,CB2020,047,3,Brooklyn,30518003002,614,293,321,3.26
2020,CB2020,047,3,Brooklyn,30519001000,108,58,50,2.66
2020,CB2020,047,3,Brooklyn,30519001001,0,0,0,0.34
2020,CB2020,047,3,Brooklyn,30519001002,138,55,83,1.82
2020,CB2020,047,3,Brooklyn,30519001003,332,158,174,2.69
2020,CB2020,047,3,Brooklyn,30519001004,360,222,138,2.7
2020,CB2020,047,3,Brooklyn,30519001005,313,166,147,2.69
2020,CB2020,047,3,Brooklyn,30519001006,540,261,279,3.12
2020,CB2020,047,3,Brooklyn,30519001007,332,171,161,2.82
2020,CB2020,047,3,Brooklyn,30519001008,232,118,114,2.7
2020,CB2020,047,3,Brooklyn,30519001009,458,187,271,2.82
2020,CB2020,047,3,Brooklyn,30519001010,217,105,112,2.44
2020,CB2020,047,3,Brooklyn,30519001011,173,81,92,2.75
2020,CB2020,047,3,Brooklyn,30519002000,258,141,117,2.67
2020,CB2020,047,3,Brooklyn,30519002001,242,117,125,2.69
2020,CB2020,047,3,Brooklyn,30519002002,0,0,0,2.67
2020,CB2020,047,3,Brooklyn,30519002003,279,138,141,2.7
2020,CB2020,047,3,Brooklyn,30519002004,248,113,135,2.82
2020,CB2020,047,3,Brooklyn,30519002005,0,0,0,2.82
2020,CB2020,047,3,Brooklyn,30519002006,187,89,98,2.38
2020,CB2020,047,3,Brooklyn,30519002007,183,98,85,1.78
2020,CB2020,047,3,Brooklyn,30519003000,337,183,154,3.54
2020,CB2020,047,3,Brooklyn,30519003001,154,89,65,2.65
2020,CB2020,047,3,Brooklyn,30519003002,177,86,91,2.18
2020,CB2020,047,3,Brooklyn,30519003003,130,72,58,1.53
2020,CB2020,047,3,Brooklyn,30519003004,0,0,0,0.56
2020,CB2020,047,3,Brooklyn,30519003005,221,89,132,2.5
2020,CB2020,047,3,Brooklyn,30519003006,272,149,123,2.82
2020,CB2020,047,3,Brooklyn,30519003007,210,84,126,2.08
2020,CB2020,047,3,Brooklyn,30520001000,160,66,94,2.37
2020,CB2020,047,3,Brooklyn,30520001001,178,90,88,1.9
2020,CB2020,047,3,Brooklyn,30520001002,391,202,189,4.31
2020,CB2020,047,3,Brooklyn,30520001003,384,189,195,2.93
2020,CB2020,047,3,Brooklyn,30520001004,303,122,181,1.42
2020,CB2020,047,3,Brooklyn,30520001005,70,43,27,2.75
2020,CB2020,047,3,Brooklyn,30520001006,69,20,49,2
2020,CB2020,047,3,Brooklyn,30520002000,39,8,31,2.09
2020,CB2020,047,3,Brooklyn,30520002001,81,45,36,2.66
2020,CB2020,047,3,Brooklyn,30520002002,140,70,70,4.75
2020,CB2020,047,3,Brooklyn,30520002003,83,58,25,2.61
2020,CB2020,047,3,Brooklyn,30520002004,51,23,28,0.86
2020,CB2020,047,3,Brooklyn,30520002005,58,20,38,2.16
2020,CB2020,047,3,Brooklyn,30520002006,65,29,36,1.3
2020,CB2020,047,3,Brooklyn,30520002007,144,86,58,1.58
2020,CB2020,047,3,Brooklyn,30520002008,87,33,54,1.64
2020,CB2020,047,3,Brooklyn,30520002009,286,159,127,1.42
2020,CB2020,047,3,Brooklyn,30520002010,378,185,193,1.69
2020,CB2020,047,3,Brooklyn,30520003000,306,151,155,3.5
2020,CB2020,047,3,Brooklyn,30520003001,902,444,458,3.14
2020,CB2020,047,3,Brooklyn,30523001000,340,196,144,1.96
2020,CB2020,047,3,Brooklyn,30523001001,498,147,351,2.42
2020,CB2020,047,3,Brooklyn,30523001002,550,261,289,2.84
2020,CB2020,047,3,Brooklyn,30523001003,143,76,67,0.84
2020,CB2020,047,3,Brooklyn,30523001004,0,0,0,0.41
2020,CB2020,047,3,Brooklyn,30523002000,676,299,377,3.24
2020,CB2020,047,3,Brooklyn,30523002001,459,237,222,2.89
2020,CB2020,047,3,Brooklyn,30523002002,22,18,4,1.76
2020,CB2020,047,3,Brooklyn,30523003000,416,169,247,3.17
2020,CB2020,047,3,Brooklyn,30523003001,625,315,310,2.67
2020,CB2020,047,3,Brooklyn,30523003002,0,0,0,1.99
2020,CB2020,047,3,Brooklyn,30523003003,123,65,58,1.42
2020,CB2020,047,3,Brooklyn,30523003004,0,0,0,0.26
2020,CB2020,047,3,Brooklyn,30523004000,338,173,165,2.25
2020,CB2020,047,3,Brooklyn,30523004001,440,208,232,2.7
2020,CB2020,047,3,Brooklyn,30523005000,209,107,102,2.24
2020,CB2020,047,3,Brooklyn,30523005001,566,247,319,2.75
2020,CB2020,047,3,Brooklyn,30525001000,0,0,0,1.07
2020,CB2020,047,3,Brooklyn,30525001001,129,64,65,2.75
2020,CB2020,047,3,Brooklyn,30525001002,0,0,0,1.2
2020,CB2020,047,3,Brooklyn,30525001003,0,0,0,3.43
2020,CB2020,047,3,Brooklyn,30525001004,222,130,92,2.5
2020,CB2020,047,3,Brooklyn,30525001005,77,40,37,2.05
2020,CB2020,047,3,Brooklyn,30525001006,143,80,63,3.07
2020,CB2020,047,3,Brooklyn,30525001007,505,233,272,1.51
2020,CB2020,047,3,Brooklyn,30525001008,0,0,0,1.6
2020,CB2020,047,3,Brooklyn,30525001009,851,376,475,2.88
2020,CB2020,047,3,Brooklyn,30525001010,581,270,311,2.38
2020,CB2020,047,3,Brooklyn,30525002000,583,307,276,3.07
2020,CB2020,047,3,Brooklyn,30525002001,629,270,359,3.18
2020,CB2020,047,3,Brooklyn,30526001000,659,301,358,4.39
2020,CB2020,047,3,Brooklyn,30526001001,642,278,364,4.45
2020,CB2020,047,3,Brooklyn,30526001002,410,238,172,4.02
2020,CB2020,047,3,Brooklyn,30526001003,291,142,149,3.25
2020,CB2020,047,3,Brooklyn,30526002000,164,82,82,4.76
2020,CB2020,047,3,Brooklyn,30526002001,269,144,125,1.34
2020,CB2020,047,3,Brooklyn,30526002002,516,246,270,3.9
2020,CB2020,047,3,Brooklyn,30526002003,236,95,141,4.29
2020,CB2020,047,3,Brooklyn,30526003000,102,48,54,4.77
2020,CB2020,047,3,Brooklyn,30526003001,150,82,68,3.52
2020,CB2020,047,3,Brooklyn,30526003002,914,439,475,3.16
2020,CB2020,047,3,Brooklyn,30527001000,761,350,411,3.16
2020,CB2020,047,3,Brooklyn,30527001001,66,21,45,0.75
2020,CB2020,047,3,Brooklyn,30527001002,224,100,124,1.61
2020,CB2020,047,3,Brooklyn,30527002000,404,191,213,2.65
2020,CB2020,047,3,Brooklyn,30527002001,295,135,160,2.54
2020,CB2020,047,3,Brooklyn,30527003000,314,142,172,2.35
2020,CB2020,047,3,Brooklyn,30527003001,109,52,57,1.77
2020,CB2020,047,3,Brooklyn,30527003002,315,165,150,2.83
2020,CB2020,047,3,Brooklyn,30527003003,0,0,0,0.36
2020,CB2020,047,3,Brooklyn,30527003004,0,0,0,1.81
2020,CB2020,047,3,Brooklyn,30527003005,0,0,0,0.35
2020,CB2020,047,3,Brooklyn,30527004000,481,205,276,2.86
2020,CB2020,047,3,Brooklyn,30527004001,224,98,126,2.24
2020,CB2020,047,3,Brooklyn,30527004002,52,38,14,0.92
2020,CB2020,047,3,Brooklyn,30527004003,0,0,0,0.31
2020,CB2020,047,3,Brooklyn,30527004004,63,26,37,0.98
2020,CB2020,047,3,Brooklyn,30527005000,405,193,212,2.07
2020,CB2020,047,3,Brooklyn,30527005001,0,0,0,0.85
2020,CB2020,047,3,Brooklyn,30527005002,0,0,0,0.41
2020,CB2020,047,3,Brooklyn,30527005003,0,0,0,0.83
2020,CB2020,047,3,Brooklyn,30527005004,0,0,0,0.95
2020,CB2020,047,3,Brooklyn,30527005005,0,0,0,0.36
2020,CB2020,047,3,Brooklyn,30527005006,22,14,8,0.93
2020,CB2020,047,3,Brooklyn,30527005007,345,147,198,2.16
2020,CB2020,047,3,Brooklyn,30527006000,662,331,331,2.65
2020,CB2020,047,3,Brooklyn,30527006001,528,253,275,2.66
2020,CB2020,047,3,Brooklyn,30527007000,774,342,432,3.17
2020,CB2020,047,3,Brooklyn,30527007001,1,0,1,2.45
2020,CB2020,047,3,Brooklyn,30528001000,90,44,46,5.45
2020,CB2020,047,3,Brooklyn,30528001001,213,99,114,8.1
2020,CB2020,047,3,Brooklyn,30528001002,150,94,56,7.86
2020,CB2020,047,3,Brooklyn,30528001003,180,81,99,2.1
2020,CB2020,047,3,Brooklyn,30528001004,266,114,152,3.32
2020,CB2020,047,3,Brooklyn,30528002000,131,69,62,5.26
2020,CB2020,047,3,Brooklyn,30528002001,201,95,106,5.25
2020,CB2020,047,3,Brooklyn,30528002002,573,307,266,6.06
2020,CB2020,047,3,Brooklyn,30529001000,336,172,164,3.51
2020,CB2020,047,3,Brooklyn,30529001001,0,0,0,4.32
2020,CB2020,047,3,Brooklyn,30529001002,697,347,350,4.3
2020,CB2020,047,3,Brooklyn,30529002000,190,94,96,3.05
2020,CB2020,047,3,Brooklyn,30529002001,111,64,47,2.45
2020,CB2020,047,3,Brooklyn,30529002002,175,111,64,1.53
2020,CB2020,047,3,Brooklyn,30529002003,560,290,270,4.3
2020,CB2020,047,3,Brooklyn,30529002004,779,380,399,4.3
2020,CB2020,047,3,Brooklyn,30529003000,185,95,90,1.76
2020,CB2020,047,3,Brooklyn,30529003001,409,200,209,2.26
2020,CB2020,047,3,Brooklyn,30529003002,0,0,0,0.33
2020,CB2020,047,3,Brooklyn,30529003003,0,0,0,0.62
2020,CB2020,047,3,Brooklyn,30529003004,0,0,0,2.73
2020,CB2020,047,3,Brooklyn,30529003005,849,443,406,4.22
2020,CB2020,047,3,Brooklyn,30529003006,0,0,0,1.02
2020,CB2020,047,3,Brooklyn,30529003007,0,0,0,0.4
2020,CB2020,047,3,Brooklyn,30529003008,8,3,5,1.3
2020,CB2020,047,3,Brooklyn,30529003009,0,0,0,0.8
2020,CB2020,047,3,Brooklyn,30530001000,310,169,141,2.12
2020,CB2020,047,3,Brooklyn,30530001001,304,146,158,3.13
2020,CB2020,047,3,Brooklyn,30530001002,602,298,304,5.25
2020,CB2020,047,3,Brooklyn,30530002000,166,92,74,1.98
2020,CB2020,047,3,Brooklyn,30530002001,267,107,160,3.27
2020,CB2020,047,3,Brooklyn,30530002002,529,271,258,5.26
2020,CB2020,047,3,Brooklyn,30530003000,424,231,193,4.09
2020,CB2020,047,3,Brooklyn,30530003001,391,195,196,6.82
2020,CB2020,047,3,Brooklyn,30530003002,254,110,144,5.66
2020,CB2020,047,3,Brooklyn,30530003003,359,183,176,5.25
2020,CB2020,047,3,Brooklyn,30531011000,1587,766,821,4.55
2020,CB2020,047,3,Brooklyn,30531011001,37,20,17,1.95
2020,CB2020,047,3,Brooklyn,30531012000,500,260,240,4.3
2020,CB2020,047,3,Brooklyn,30531012001,642,303,339,4.36
2020,CB2020,047,3,Brooklyn,30531012002,231,138,93,4.31
2020,CB2020,047,3,Brooklyn,30531021000,2554,1304,1250,5.56
2020,CB2020,047,3,Brooklyn,30531021001,545,278,267,3.4
2020,CB2020,047,3,Brooklyn,30531021002,628,322,306,2.72
2020,CB2020,047,3,Brooklyn,30531022000,1465,756,709,4.34
2020,CB2020,047,3,Brooklyn,30531022001,573,311,262,3.6
2020,CB2020,047,3,Brooklyn,30531022002,125,47,78,0.88
2020,CB2020,047,3,Brooklyn,30532001000,247,122,125,2.09
2020,CB2020,047,3,Brooklyn,30532001001,149,86,63,2.08
2020,CB2020,047,3,Brooklyn,30532001002,70,23,47,1.56
2020,CB2020,047,3,Brooklyn,30532001003,481,199,282,3.56
2020,CB2020,047,3,Brooklyn,30532001004,0,0,0,1.46
2020,CB2020,047,3,Brooklyn,30532001005,140,75,65,2.54
2020,CB2020,047,3,Brooklyn,30532001006,196,92,104,2.72
2020,CB2020,047,3,Brooklyn,30532002000,121,60,61,5.46
2020,CB2020,047,3,Brooklyn,30532002001,233,116,117,5.45
2020,CB2020,047,3,Brooklyn,30532002002,175,97,78,5.45
2020,CB2020,047,3,Brooklyn,30532002003,169,92,77,5.44
2020,CB2020,047,3,Brooklyn,30532002004,149,66,83,2.29
2020,CB2020,047,3,Brooklyn,30532002005,380,176,204,2.96
2020,CB2020,047,3,Brooklyn,30533001000,875,463,412,4.32
2020,CB2020,047,3,Brooklyn,30533001001,409,208,201,2.87
2020,CB2020,047,3,Brooklyn,30533001002,267,134,133,1.45
2020,CB2020,047,3,Brooklyn,30533002000,551,293,258,3.84
2020,CB2020,047,3,Brooklyn,30533002001,445,239,206,2.4
2020,CB2020,047,3,Brooklyn,30533002002,95,45,50,1.5
2020,CB2020,047,3,Brooklyn,30533003000,822,445,377,3.95
2020,CB2020,047,3,Brooklyn,30533003001,591,277,314,3.91
2020,CB2020,047,3,Brooklyn,30533004000,905,446,459,4.3
2020,CB2020,047,3,Brooklyn,30533004001,822,414,408,4.31
2020,CB2020,047,3,Brooklyn,30533005000,20,10,10,1.44
2020,CB2020,047,3,Brooklyn,30533005001,0,0,0,0.8
2020,CB2020,047,3,Brooklyn,30533005002,0,0,0,1.35
2020,CB2020,047,3,Brooklyn,30533005003,363,190,173,2.6
2020,CB2020,047,3,Brooklyn,30533005004,643,313,330,4.32
2020,CB2020,047,3,Brooklyn,30533005005,307,139,168,1.56
2020,CB2020,047,3,Brooklyn,30533005006,0,0,0,1.13
2020,CB2020,047,3,Brooklyn,30533005007,0,0,0,0.7
2020,CB2020,047,3,Brooklyn,30533005008,0,0,0,1
2020,CB2020,047,3,Brooklyn,30534001000,825,381,444,5.24
2020,CB2020,047,3,Brooklyn,30534001001,622,324,298,5.26
2020,CB2020,047,3,Brooklyn,30534002000,780,384,396,5.27
2020,CB2020,047,3,Brooklyn,30534002001,534,271,263,5.25
2020,CB2020,047,3,Brooklyn,30534003000,501,256,245,5.24
2020,CB2020,047,3,Brooklyn,30534003001,564,263,301,5.25
2020,CB2020,047,3,Brooklyn,30534004000,117,66,51,2.84
2020,CB2020,047,3,Brooklyn,30534004001,290,142,148,2.83
2020,CB2020,047,3,Brooklyn,30534004002,544,280,264,5.66
2020,CB2020,047,3,Brooklyn,30535001000,910,469,441,3.79
2020,CB2020,047,3,Brooklyn,30535001001,540,276,264,2.48
2020,CB2020,047,3,Brooklyn,30535002000,588,285,303,3.88
2020,CB2020,047,3,Brooklyn,30535002001,354,191,163,3.23
2020,CB2020,047,3,Brooklyn,30535003000,23,10,13,3.71
2020,CB2020,047,3,Brooklyn,30535003001,686,363,323,3.88
2020,CB2020,047,3,Brooklyn,30535004000,249,132,117,2.53
2020,CB2020,047,3,Brooklyn,30535004001,0,0,0,0.58
2020,CB2020,047,3,Brooklyn,30535004002,631,314,317,4.11
2020,CB2020,047,3,Brooklyn,30535004003,488,246,242,4.02
2020,CB2020,047,3,Brooklyn,30537001000,0,0,0,1.24
2020,CB2020,047,3,Brooklyn,30537001001,0,0,0,0.85
2020,CB2020,047,3,Brooklyn,30537001002,0,0,0,1.21
2020,CB2020,047,3,Brooklyn,30537001003,90,53,37,1.23
2020,CB2020,047,3,Brooklyn,30537001004,585,277,308,3.87
2020,CB2020,047,3,Brooklyn,30537001005,540,287,253,4.01
2020,CB2020,047,3,Brooklyn,30537002000,528,293,235,4.05
2020,CB2020,047,3,Brooklyn,30537002001,530,277,253,2.92
2020,CB2020,047,3,Brooklyn,30537002002,68,35,33,0.41
2020,CB2020,047,3,Brooklyn,30537002003,279,117,162,2.3
2020,CB2020,047,3,Brooklyn,30537002004,0,0,0,2.69
2020,CB2020,047,3,Brooklyn,30537002005,0,0,0,0.45
2020,CB2020,047,3,Brooklyn,30537002006,0,0,0,0.74
2020,CB2020,047,3,Brooklyn,30537002007,0,0,0,0.71
2020,CB2020,047,3,Brooklyn,30537002008,0,0,0,1.32
2020,CB2020,047,3,Brooklyn,30537002009,0,0,0,1.69
2020,CB2020,047,3,Brooklyn,30537002010,0,0,0,0.83
2020,CB2020,047,3,Brooklyn,30537002011,0,0,0,1.77
2020,CB2020,047,3,Brooklyn,30537002012,0,0,0,0.54
2020,CB2020,047,3,Brooklyn,30537002013,226,124,102,2.65
2020,CB2020,047,3,Brooklyn,30537002014,578,310,268,2.37
2020,CB2020,047,3,Brooklyn,30537002015,0,0,0,0.27
2020,CB2020,047,3,Brooklyn,30537002016,289,144,145,1.08
2020,CB2020,047,3,Brooklyn,30537002017,108,56,52,0.8
2020,CB2020,047,3,Brooklyn,30537002018,483,213,270,1.38
2020,CB2020,047,3,Brooklyn,30538001000,960,444,516,6.8
2020,CB2020,047,3,Brooklyn,30538001001,963,453,510,5.36
2020,CB2020,047,3,Brooklyn,30538002000,427,229,198,3.14
2020,CB2020,047,3,Brooklyn,30538002001,10,6,4,0.33
2020,CB2020,047,3,Brooklyn,30538002002,748,360,388,5.01
2020,CB2020,047,3,Brooklyn,30538002003,596,273,323,3.64
2020,CB2020,047,3,Brooklyn,30538003000,296,133,163,3.42
2020,CB2020,047,3,Brooklyn,30538003001,217,114,103,1.33
2020,CB2020,047,3,Brooklyn,30538003002,44,14,30,0.69
2020,CB2020,047,3,Brooklyn,30538003003,839,396,443,5.46
2020,CB2020,047,3,Brooklyn,30538003004,161,79,82,1.38
2020,CB2020,047,3,Brooklyn,30538003005,274,137,137,4.07
2020,CB2020,047,3,Brooklyn,30539001000,0,0,0,3.33
2020,CB2020,047,3,Brooklyn,30539001001,226,119,107,2.85
2020,CB2020,047,3,Brooklyn,30539001002,120,59,61,2.06
2020,CB2020,047,3,Brooklyn,30539001003,0,0,0,2.67
2020,CB2020,047,3,Brooklyn,30539001004,0,0,0,0.38
2020,CB2020,047,3,Brooklyn,30539002000,2322,1129,1193,13.76
2020,CB2020,047,3,Brooklyn,30542001000,568,270,298,5.85
2020,CB2020,047,3,Brooklyn,30542001001,704,348,356,5.6
2020,CB2020,047,3,Brooklyn,30542001002,626,295,331,5.57
2020,CB2020,047,3,Brooklyn,30542002000,651,302,349,6.3
2020,CB2020,047,3,Brooklyn,30542002001,612,315,297,6.1
2020,CB2020,047,3,Brooklyn,30542002002,454,212,242,5.65
2020,CB2020,047,3,Brooklyn,30542003000,551,255,296,5.81
2020,CB2020,047,3,Brooklyn,30542003001,584,265,319,5.87
2020,CB2020,047,3,Brooklyn,30543001000,0,0,0,0
2020,CB2020,047,3,Brooklyn,30543001001,5,0,5,59.06
2020,CB2020,047,3,Brooklyn,30543001002,0,0,0,1.51
2020,CB2020,047,3,Brooklyn,30543001003,0,0,0,1.83
2020,CB2020,047,3,Brooklyn,30543001004,0,0,0,46.62
2020,CB2020,047,3,Brooklyn,30543001005,0,0,0,6.62
2020,CB2020,047,3,Brooklyn,30543001006,0,0,0,1.53
2020,CB2020,047,3,Brooklyn,30543001007,0,0,0,11.12
2020,CB2020,047,3,Brooklyn,30543001008,0,0,0,3.12
2020,CB2020,047,3,Brooklyn,30543001009,0,0,0,0
2020,CB2020,047,3,Brooklyn,30543001010,0,0,0,1.69
2020,CB2020,047,3,Brooklyn,30543001011,0,0,0,1.19
2020,CB2020,047,3,Brooklyn,30543001012,0,0,0,6.44
2020,CB2020,047,3,Brooklyn,30543001013,0,0,0,10.77
2020,CB2020,047,3,Brooklyn,30543001014,0,0,0,6.19
2020,CB2020,047,3,Brooklyn,30543001015,0,0,0,6.67
2020,CB2020,047,3,Brooklyn,30543001016,0,0,0,0
2020,CB2020,047,3,Brooklyn,30543001017,0,0,0,6.17
2020,CB2020,047,3,Brooklyn,30543001018,0,0,0,2.25
2020,CB2020,047,3,Brooklyn,30543001019,0,0,0,2.28
2020,CB2020,047,3,Brooklyn,30543001020,0,0,0,3.1
2020,CB2020,047,3,Brooklyn,30543001021,0,0,0,1.04
2020,CB2020,047,3,Brooklyn,30543001022,0,0,0,4.35
2020,CB2020,047,3,Brooklyn,30543001023,0,0,0,1.38
2020,CB2020,047,3,Brooklyn,30543001024,0,0,0,2.46
2020,CB2020,047,3,Brooklyn,30543001025,0,0,0,2.44
2020,CB2020,047,3,Brooklyn,30543001026,0,0,0,4.31
2020,CB2020,047,3,Brooklyn,30543001027,0,0,0,1.01
2020,CB2020,047,3,Brooklyn,30543001028,0,0,0,1.23
2020,CB2020,047,3,Brooklyn,30543001029,0,0,0,1.22
2020,CB2020,047,3,Brooklyn,30543001030,0,0,0,2.67
2020,CB2020,047,3,Brooklyn,30543001031,0,0,0,6.43
2020,CB2020,047,3,Brooklyn,30543001032,0,0,0,5.51
2020,CB2020,047,3,Brooklyn,30543001033,0,0,0,2.71
2020,CB2020,047,3,Brooklyn,30543001034,0,0,0,1.48
2020,CB2020,047,3,Brooklyn,30543001035,0,0,0,2.97
2020,CB2020,047,3,Brooklyn,30543001036,0,0,0,2.94
2020,CB2020,047,3,Brooklyn,30543001037,0,0,0,6.22
2020,CB2020,047,3,Brooklyn,30543001038,0,0,0,2.75
2020,CB2020,047,3,Brooklyn,30543001039,0,0,0,0.62
2020,CB2020,047,3,Brooklyn,30543001040,0,0,0,0.35
2020,CB2020,047,3,Brooklyn,30543001041,0,0,0,3.83
2020,CB2020,047,3,Brooklyn,30544001000,507,251,256,5.94
2020,CB2020,047,3,Brooklyn,30544001001,764,353,411,5.72
2020,CB2020,047,3,Brooklyn,30544002000,702,334,368,5.83
2020,CB2020,047,3,Brooklyn,30544002001,349,177,172,5.84
2020,CB2020,047,3,Brooklyn,30544002002,164,66,98,2.46
2020,CB2020,047,3,Brooklyn,30544002003,272,121,151,3.15
2020,CB2020,047,3,Brooklyn,30544003000,284,145,139,6.08
2020,CB2020,047,3,Brooklyn,30544003001,412,210,202,6.08
2020,CB2020,047,3,Brooklyn,30544003002,127,59,68,2.62
2020,CB2020,047,3,Brooklyn,30544003003,204,104,100,3.24
2020,CB2020,047,3,Brooklyn,30545001000,187,99,88,2
2020,CB2020,047,3,Brooklyn,30545001001,194,105,89,1.89
2020,CB2020,047,3,Brooklyn,30545001002,192,101,91,1.8
2020,CB2020,047,3,Brooklyn,30545002000,0,0,0,2.44
2020,CB2020,047,3,Brooklyn,30545002001,1234,635,599,2.02
2020,CB2020,047,3,Brooklyn,30545002002,0,0,0,1.97
2020,CB2020,047,3,Brooklyn,30545003000,1469,679,790,8.91
2020,CB2020,047,3,Brooklyn,30545004000,722,356,366,2.95
2020,CB2020,047,3,Brooklyn,30545005000,912,396,516,4.13
2020,CB2020,047,3,Brooklyn,30545005001,951,435,516,3.95
2020,CB2020,047,3,Brooklyn,30545006000,1443,687,756,9.39
2020,CB2020,047,3,Brooklyn,30546001000,257,123,134,2.96
2020,CB2020,047,3,Brooklyn,30546001001,88,60,28,5.04
2020,CB2020,047,3,Brooklyn,30546001002,556,284,272,5.51
2020,CB2020,047,3,Brooklyn,30546001003,0,0,0,0.86
2020,CB2020,047,3,Brooklyn,30546001004,154,63,91,1.46
2020,CB2020,047,3,Brooklyn,30546001005,214,87,127,1.22
2020,CB2020,047,3,Brooklyn,30546002000,342,168,174,2.35
2020,CB2020,047,3,Brooklyn,30546002001,518,260,258,2.93
2020,CB2020,047,3,Brooklyn,30546002002,1367,595,772,7.26
2020,CB2020,047,3,Brooklyn,30546002003,227,94,133,0.98
2020,CB2020,047,3,Brooklyn,30546003000,252,108,144,2.95
2020,CB2020,047,3,Brooklyn,30546003001,813,375,438,3.56
2020,CB2020,047,3,Brooklyn,30546003002,621,329,292,7.57
2020,CB2020,047,3,Brooklyn,30547001000,211,78,133,2.17
2020,CB2020,047,3,Brooklyn,30547001001,289,136,153,2.21
2020,CB2020,047,3,Brooklyn,30547001002,389,189,200,2.72
2020,CB2020,047,3,Brooklyn,30547001003,237,121,116,1.42
2020,CB2020,047,3,Brooklyn,30547001004,108,52,56,1.9
2020,CB2020,047,3,Brooklyn,30547002000,872,415,457,3.72
2020,CB2020,047,3,Brooklyn,30547002001,390,190,200,2.7
2020,CB2020,047,3,Brooklyn,30547003000,520,276,244,3.12
2020,CB2020,047,3,Brooklyn,30547003001,705,359,346,3.12
2020,CB2020,047,3,Brooklyn,30547003002,453,234,219,2.52
2020,CB2020,047,3,Brooklyn,30547003003,2322,1142,1180,6.93
2020,CB2020,047,3,Brooklyn,30547003004,1359,682,677,9.52
2020,CB2020,047,3,Brooklyn,30548001000,139,31,108,1.23
2020,CB2020,047,3,Brooklyn,30548001001,285,151,134,1.71
2020,CB2020,047,3,Brooklyn,30548001002,387,205,182,2.88
2020,CB2020,047,3,Brooklyn,30548001003,182,90,92,4.89
2020,CB2020,047,3,Brooklyn,30548001004,187,96,91,4.68
2020,CB2020,047,3,Brooklyn,30548002000,237,116,121,5.4
2020,CB2020,047,3,Brooklyn,30548002001,219,122,97,5.41
2020,CB2020,047,3,Brooklyn,30548002002,207,90,117,5.6
2020,CB2020,047,3,Brooklyn,30548002003,192,96,96,5.61
2020,CB2020,047,3,Brooklyn,30548002004,154,66,88,5.39
2020,CB2020,047,3,Brooklyn,30549001000,479,229,250,2.71
2020,CB2020,047,3,Brooklyn,30549001001,596,258,338,2.93
2020,CB2020,047,3,Brooklyn,30549001002,337,187,150,2.35
2020,CB2020,047,3,Brooklyn,30549001003,839,449,390,2.99
2020,CB2020,047,3,Brooklyn,30549002000,314,151,163,2.83
2020,CB2020,047,3,Brooklyn,30549002001,366,142,224,3.2
2020,CB2020,047,3,Brooklyn,30549002002,359,197,162,2.69
2020,CB2020,047,3,Brooklyn,30549002003,324,176,148,3.2
2020,CB2020,047,3,Brooklyn,30549002004,0,0,0,0.88
2020,CB2020,047,3,Brooklyn,30549002005,0,0,0,0.59
2020,CB2020,047,3,Brooklyn,30549002006,0,0,0,0.17
2020,CB2020,047,3,Brooklyn,30549002007,0,0,0,0.66
2020,CB2020,047,3,Brooklyn,30549002008,0,0,0,0.55
2020,CB2020,047,3,Brooklyn,30549002009,0,0,0,0.29
2020,CB2020,047,3,Brooklyn,30549002010,0,0,0,0.38
2020,CB2020,047,3,Brooklyn,30549002011,0,0,0,0.69
2020,CB2020,047,3,Brooklyn,30549002012,0,0,0,1.28
2020,CB2020,047,3,Brooklyn,30549002013,301,159,142,5.56
2020,CB2020,047,3,Brooklyn,30549002014,282,135,147,2.16
2020,CB2020,047,3,Brooklyn,30549002015,154,95,59,1.78
2020,CB2020,047,3,Brooklyn,30549002016,152,79,73,1.88
2020,CB2020,047,3,Brooklyn,30549002017,49,23,26,0.96
2020,CB2020,047,3,Brooklyn,30549002018,0,0,0,0.28
2020,CB2020,047,3,Brooklyn,30549002019,0,0,0,0.45
2020,CB2020,047,3,Brooklyn,30549002020,0,0,0,0.41
2020,CB2020,047,3,Brooklyn,30549002021,0,0,0,0.39
2020,CB2020,047,3,Brooklyn,30549002022,0,0,0,0.68
2020,CB2020,047,3,Brooklyn,30549002023,59,30,29,1.51
2020,CB2020,047,3,Brooklyn,30549002024,103,56,47,1.35
2020,CB2020,047,3,Brooklyn,30549002025,34,14,20,1.97
2020,CB2020,047,3,Brooklyn,30549002026,0,0,0,0.52
2020,CB2020,047,3,Brooklyn,30550001000,145,84,61,4.66
2020,CB2020,047,3,Brooklyn,30550001001,358,199,159,4.67
2020,CB2020,047,3,Brooklyn,30550001002,655,308,347,4.83
2020,CB2020,047,3,Brooklyn,30550002000,219,105,114,5.41
2020,CB2020,047,3,Brooklyn,30550002001,223,112,111,5.41
2020,CB2020,047,3,Brooklyn,30550002002,575,260,315,6.02
2020,CB2020,047,3,Brooklyn,30550003000,0,0,0,0.36
2020,CB2020,047,3,Brooklyn,30550003001,73,37,36,1.21
2020,CB2020,047,3,Brooklyn,30550003002,673,329,344,4.88
2020,CB2020,047,3,Brooklyn,30550003003,1035,480,555,6.98
2020,CB2020,047,3,Brooklyn,30551001000,0,0,0,3.09
2020,CB2020,047,3,Brooklyn,30551001001,318,170,148,2.92
2020,CB2020,047,3,Brooklyn,30551001002,55,31,24,4.98
2020,CB2020,047,3,Brooklyn,30551001003,0,0,0,2.78
2020,CB2020,047,3,Brooklyn,30551001004,561,266,295,3.43
2020,CB2020,047,3,Brooklyn,30551001005,189,114,75,3.3
2020,CB2020,047,3,Brooklyn,30551001006,304,131,173,2.97
2020,CB2020,047,3,Brooklyn,30551001007,362,180,182,3.09
2020,CB2020,047,3,Brooklyn,30551001008,168,76,92,2.29
2020,CB2020,047,3,Brooklyn,30551001009,711,337,374,2.65
2020,CB2020,047,3,Brooklyn,30551001010,0,0,0,3.15
2020,CB2020,047,3,Brooklyn,30551002000,252,111,141,2.51
2020,CB2020,047,3,Brooklyn,30551002001,461,224,237,2.74
2020,CB2020,047,3,Brooklyn,30551002002,459,192,267,3.23
2020,CB2020,047,3,Brooklyn,30551003000,329,179,150,2.73
2020,CB2020,047,3,Brooklyn,30551003001,461,235,226,2.74
2020,CB2020,047,3,Brooklyn,30551003002,470,216,254,3.23
2020,CB2020,047,3,Brooklyn,30551004000,760,338,422,2.69
2020,CB2020,047,3,Brooklyn,30551004001,483,194,289,2.69
2020,CB2020,047,3,Brooklyn,30552001000,33,16,17,1.48
2020,CB2020,047,3,Brooklyn,30552001001,554,243,311,3.32
2020,CB2020,047,3,Brooklyn,30552001002,703,291,412,5.51
2020,CB2020,047,3,Brooklyn,30552002000,97,32,65,2.1
2020,CB2020,047,3,Brooklyn,30552002001,219,116,103,2.79
2020,CB2020,047,3,Brooklyn,30552002002,360,179,181,2.79
2020,CB2020,047,3,Brooklyn,30552002003,635,300,335,5.61
2020,CB2020,047,3,Brooklyn,30552003000,30,10,20,1.39
2020,CB2020,047,3,Brooklyn,30552003001,158,69,89,1.94
2020,CB2020,047,3,Brooklyn,30552003002,197,96,101,3.78
2020,CB2020,047,3,Brooklyn,30552003003,132,61,71,3.01
2020,CB2020,047,3,Brooklyn,30552003004,134,71,63,2.1
2020,CB2020,047,3,Brooklyn,30552003005,483,237,246,5.62
2020,CB2020,047,3,Brooklyn,30553001000,282,150,132,2.76
2020,CB2020,047,3,Brooklyn,30553001001,252,102,150,2.75
2020,CB2020,047,3,Brooklyn,30553001002,178,71,107,2.76
2020,CB2020,047,3,Brooklyn,30553001003,259,144,115,2.76
2020,CB2020,047,3,Brooklyn,30553002000,300,258,42,3.02
2020,CB2020,047,3,Brooklyn,30553002001,0,0,0,0.54
2020,CB2020,047,3,Brooklyn,30553002002,181,69,112,1.82
2020,CB2020,047,3,Brooklyn,30553002003,119,51,68,1.9
2020,CB2020,047,3,Brooklyn,30553002004,212,110,102,2.12
2020,CB2020,047,3,Brooklyn,30553002005,85,42,43,1.71
2020,CB2020,047,3,Brooklyn,30553002006,218,122,96,2.55
2020,CB2020,047,3,Brooklyn,30553003000,222,111,111,2.75
2020,CB2020,047,3,Brooklyn,30553003001,138,63,75,2.76
2020,CB2020,047,3,Brooklyn,30553003002,221,102,119,2.74
2020,CB2020,047,3,Brooklyn,30553003003,243,126,117,2.76
2020,CB2020,047,3,Brooklyn,30553003004,168,95,73,2.92
2020,CB2020,047,3,Brooklyn,30554001000,157,77,80,3.93
2020,CB2020,047,3,Brooklyn,30554001001,795,364,431,6.18
2020,CB2020,047,3,Brooklyn,30554001002,1102,518,584,5.62
2020,CB2020,047,3,Brooklyn,30554002000,1221,535,686,5.65
2020,CB2020,047,3,Brooklyn,30554002001,363,189,174,4.91
2020,CB2020,047,3,Brooklyn,30554003000,265,131,134,4.49
2020,CB2020,047,3,Brooklyn,30554003001,426,210,216,4.72
2020,CB2020,047,3,Brooklyn,30554003002,335,162,173,2.96
2020,CB2020,047,3,Brooklyn,30554003003,149,79,70,2.16
2020,CB2020,047,3,Brooklyn,30554003004,0,0,0,0.92
2020,CB2020,047,3,Brooklyn,30554003005,0,0,0,0.28
2020,CB2020,047,3,Brooklyn,30555001000,388,212,176,3.99
2020,CB2020,047,3,Brooklyn,30555001001,4030,2043,1987,8.97
2020,CB2020,047,3,Brooklyn,30555001002,833,403,430,1.78
2020,CB2020,047,3,Brooklyn,30555001003,251,101,150,2.72
2020,CB2020,047,3,Brooklyn,30555001004,187,97,90,2.74
2020,CB2020,047,3,Brooklyn,30555001005,191,89,102,3.05
2020,CB2020,047,3,Brooklyn,30555001006,96,65,31,3.04
2020,CB2020,047,3,Brooklyn,30555001007,102,46,56,3.07
2020,CB2020,047,3,Brooklyn,30555001008,429,186,243,2.88
2020,CB2020,047,3,Brooklyn,30555001009,440,224,216,2.84
2020,CB2020,047,3,Brooklyn,30555001010,0,0,0,1.02
2020,CB2020,047,3,Brooklyn,30555001011,0,0,0,2.03
2020,CB2020,047,3,Brooklyn,30555001012,0,0,0,1.86
2020,CB2020,047,3,Brooklyn,30555001013,229,122,107,2.62
2020,CB2020,047,3,Brooklyn,30555001014,357,181,176,2.3
2020,CB2020,047,3,Brooklyn,30555001015,0,0,0,0.88
2020,CB2020,047,3,Brooklyn,30555001016,27,5,22,1.39
2020,CB2020,047,3,Brooklyn,30555001017,0,0,0,3.02
2020,CB2020,047,3,Brooklyn,30555001018,267,127,140,2.64
2020,CB2020,047,3,Brooklyn,30555001019,398,196,202,3.25
2020,CB2020,047,3,Brooklyn,30555001020,252,135,117,3.48
2020,CB2020,047,3,Brooklyn,30555001021,109,65,44,2.93
2020,CB2020,047,3,Brooklyn,30555001022,102,73,29,2.14
2020,CB2020,047,3,Brooklyn,30556001000,297,177,120,5.13
2020,CB2020,047,3,Brooklyn,30556001001,705,327,378,5.1
2020,CB2020,047,3,Brooklyn,30556001002,236,107,129,5.24
2020,CB2020,047,3,Brooklyn,30556001003,274,125,149,5.24
2020,CB2020,047,3,Brooklyn,30556002000,1144,532,612,7.08
2020,CB2020,047,3,Brooklyn,30556002001,221,120,101,5.27
2020,CB2020,047,3,Brooklyn,30556003000,239,111,128,2.5
2020,CB2020,047,3,Brooklyn,30556003001,368,203,165,3.01
2020,CB2020,047,3,Brooklyn,30556003002,203,126,77,3.82
2020,CB2020,047,3,Brooklyn,30556003003,117,57,60,1.85
2020,CB2020,047,3,Brooklyn,30556003004,76,44,32,3.49
2020,CB2020,047,3,Brooklyn,30557001000,4,2,2,5.15
2020,CB2020,047,3,Brooklyn,30557001001,292,151,141,2.75
2020,CB2020,047,3,Brooklyn,30557001002,352,168,184,3.05
2020,CB2020,047,3,Brooklyn,30557002000,14,4,10,6.26
2020,CB2020,047,3,Brooklyn,30557002001,0,0,0,17.59
2020,CB2020,047,3,Brooklyn,30557002002,16,12,4,2.75
2020,CB2020,047,3,Brooklyn,30557002003,0,0,0,2.76
2020,CB2020,047,3,Brooklyn,30557002004,0,0,0,2.76
2020,CB2020,047,3,Brooklyn,30557002005,16,8,8,2.88
2020,CB2020,047,3,Brooklyn,30557002006,11,5,6,3.14
2020,CB2020,047,3,Brooklyn,30557002007,10,5,5,3.04
2020,CB2020,047,3,Brooklyn,30557002008,269,133,136,3.04
2020,CB2020,047,3,Brooklyn,30557002009,79,45,34,3.05
2020,CB2020,047,3,Brooklyn,30557002010,194,75,119,3.05
2020,CB2020,047,3,Brooklyn,30557002011,6,1,5,2.75
2020,CB2020,047,3,Brooklyn,30557002012,270,151,119,2.75
2020,CB2020,047,3,Brooklyn,30557002013,315,149,166,3.05
2020,CB2020,047,3,Brooklyn,30558001000,294,145,149,5.22
2020,CB2020,047,3,Brooklyn,30558001001,258,129,129,5.34
2020,CB2020,047,3,Brooklyn,30558001002,737,361,376,5.45
2020,CB2020,047,3,Brooklyn,30558002000,559,255,304,10.61
2020,CB2020,047,3,Brooklyn,30558002001,193,103,90,2.21
2020,CB2020,047,3,Brooklyn,30558002002,57,14,43,2.89
2020,CB2020,047,3,Brooklyn,30558002003,277,116,161,3.09
2020,CB2020,047,3,Brooklyn,30558002004,137,61,76,2.15
2020,CB2020,047,3,Brooklyn,30558002005,224,137,87,5.44
2020,CB2020,047,3,Brooklyn,30560001000,251,139,112,5.11
2020,CB2020,047,3,Brooklyn,30560001001,233,120,113,5.25
2020,CB2020,047,3,Brooklyn,30560001002,181,98,83,5.25
2020,CB2020,047,3,Brooklyn,30560001003,712,318,394,5.88
2020,CB2020,047,3,Brooklyn,30560002000,931,425,506,6.58
2020,CB2020,047,3,Brooklyn,30560002001,579,282,297,6.78
2020,CB2020,047,3,Brooklyn,30560003000,193,97,96,5.1
2020,CB2020,047,3,Brooklyn,30560003001,802,353,449,5.71
2020,CB2020,047,3,Brooklyn,30561001000,89,22,67,2.4
2020,CB2020,047,3,Brooklyn,30561001001,256,131,125,2.35
2020,CB2020,047,3,Brooklyn,30561001002,338,187,151,2.63
2020,CB2020,047,3,Brooklyn,30561001003,0,0,0,2.87
2020,CB2020,047,3,Brooklyn,30561001004,261,118,143,2.77
2020,CB2020,047,3,Brooklyn,30561001005,0,0,0,2.73
2020,CB2020,047,3,Brooklyn,30561001006,0,0,0,13.28
2020,CB2020,047,3,Brooklyn,30561001007,13,4,9,7.94
2020,CB2020,047,3,Brooklyn,30561001008,28,11,17,2.44
2020,CB2020,047,3,Brooklyn,30561002000,106,54,52,1.84
2020,CB2020,047,3,Brooklyn,30561002001,464,262,202,5.42
2020,CB2020,047,3,Brooklyn,30561002002,246,91,155,3.05
2020,CB2020,047,3,Brooklyn,30561003000,135,40,95,2.46
2020,CB2020,047,3,Brooklyn,30561003001,81,59,22,2.46
2020,CB2020,047,3,Brooklyn,30561003002,287,147,140,3.94
2020,CB2020,047,3,Brooklyn,30561003003,277,141,136,3.95
2020,CB2020,047,3,Brooklyn,30561004000,409,202,207,3.87
2020,CB2020,047,3,Brooklyn,30561004001,301,147,154,3.79
2020,CB2020,047,3,Brooklyn,30561004002,139,74,65,3.93
2020,CB2020,047,3,Brooklyn,30561004003,0,0,0,4.08
2020,CB2020,047,3,Brooklyn,30561004004,8,4,4,1.89
2020,CB2020,047,3,Brooklyn,30561004005,22,14,8,3.56
2020,CB2020,047,3,Brooklyn,30562001000,210,96,114,5.11
2020,CB2020,047,3,Brooklyn,30562001001,201,120,81,5.3
2020,CB2020,047,3,Brooklyn,30562001002,206,101,105,5.46
2020,CB2020,047,3,Brooklyn,30562001003,223,107,116,5.25
2020,CB2020,047,3,Brooklyn,30562002000,164,76,88,5.3
2020,CB2020,047,3,Brooklyn,30562002001,257,118,139,5.1
2020,CB2020,047,3,Brooklyn,30562002002,194,102,92,5.25
2020,CB2020,047,3,Brooklyn,30562002003,240,149,91,5.45
2020,CB2020,047,3,Brooklyn,30563011000,158,90,68,2.71
2020,CB2020,047,3,Brooklyn,30563011001,167,91,76,2.75
2020,CB2020,047,3,Brooklyn,30563011002,358,179,179,2.77
2020,CB2020,047,3,Brooklyn,30563011003,789,413,376,2.75
2020,CB2020,047,3,Brooklyn,30563012000,370,190,180,5.58
2020,CB2020,047,3,Brooklyn,30563012001,669,314,355,5.56
2020,CB2020,047,3,Brooklyn,30563013000,618,317,301,5.57
2020,CB2020,047,3,Brooklyn,30563013001,453,252,201,5.56
2020,CB2020,047,3,Brooklyn,30563014000,730,390,340,5.56
2020,CB2020,047,3,Brooklyn,30563014001,611,226,385,5.55
2020,CB2020,047,3,Brooklyn,30563020001,0,0,0,0
2020,CB2020,047,3,Brooklyn,30563021000,28,8,20,8.36
2020,CB2020,047,3,Brooklyn,30563021001,284,127,157,3.97
2020,CB2020,047,3,Brooklyn,30563022000,780,357,423,25.85
2020,CB2020,047,3,Brooklyn,30563022001,25,8,17,1.23
2020,CB2020,047,3,Brooklyn,30563022002,284,143,141,2.67
2020,CB2020,047,3,Brooklyn,30563022003,0,0,0,1.15
2020,CB2020,047,3,Brooklyn,30563022004,601,314,287,3.92
2020,CB2020,047,3,Brooklyn,30564001000,357,195,162,5.11
2020,CB2020,047,3,Brooklyn,30564001001,562,248,314,5.5
2020,CB2020,047,3,Brooklyn,30564001002,157,70,87,3.09
2020,CB2020,047,3,Brooklyn,30564001003,18,12,6,0.68
2020,CB2020,047,3,Brooklyn,30564002000,463,200,263,5.49
2020,CB2020,047,3,Brooklyn,30564002001,245,159,86,5.1
2020,CB2020,047,3,Brooklyn,30564002002,222,95,127,5.1
2020,CB2020,047,3,Brooklyn,30564003000,234,131,103,5.93
2020,CB2020,047,3,Brooklyn,30564003001,186,84,102,5.4
2020,CB2020,047,3,Brooklyn,30564003002,159,68,91,3.28
2020,CB2020,047,3,Brooklyn,30564003003,23,11,12,0.6
2020,CB2020,047,3,Brooklyn,30565001000,251,110,141,2.76
2020,CB2020,047,3,Brooklyn,30565001001,306,144,162,2.75
2020,CB2020,047,3,Brooklyn,30565001002,28,11,17,2.76
2020,CB2020,047,3,Brooklyn,30565001003,89,58,31,16.56
2020,CB2020,047,3,Brooklyn,30565001004,0,0,0,2.74
2020,CB2020,047,3,Brooklyn,30565001005,280,165,115,2.76
2020,CB2020,047,3,Brooklyn,30565001006,480,230,250,6.01
2020,CB2020,047,3,Brooklyn,30565002000,622,290,332,5.57
2020,CB2020,047,3,Brooklyn,30565002001,459,235,224,5.55
2020,CB2020,047,3,Brooklyn,30565003000,716,369,347,5.59
2020,CB2020,047,3,Brooklyn,30565003001,507,245,262,5.74
2020,CB2020,047,3,Brooklyn,30566001000,93,37,56,5.25
2020,CB2020,047,3,Brooklyn,30566001001,218,120,98,5.25
2020,CB2020,047,3,Brooklyn,30566001002,455,193,262,5.66
2020,CB2020,047,3,Brooklyn,30566001003,664,311,353,5.65
2020,CB2020,047,3,Brooklyn,30566002000,223,100,123,4.95
2020,CB2020,047,3,Brooklyn,30566002001,263,114,149,4.94
2020,CB2020,047,3,Brooklyn,30566002002,335,166,169,5.35
2020,CB2020,047,3,Brooklyn,30566002003,297,148,149,5.34
2020,CB2020,047,3,Brooklyn,30568001000,373,188,185,5.18
2020,CB2020,047,3,Brooklyn,30568001001,289,140,149,5.14
2020,CB2020,047,3,Brooklyn,30568001002,110,40,70,3.07
2020,CB2020,047,3,Brooklyn,30568001003,0,0,0,0.44
2020,CB2020,047,3,Brooklyn,30568001004,0,0,0,0.68
2020,CB2020,047,3,Brooklyn,30568002000,197,92,105,5.26
2020,CB2020,047,3,Brooklyn,30568002001,107,48,59,3.52
2020,CB2020,047,3,Brooklyn,30568002002,23,13,10,0.86
2020,CB2020,047,3,Brooklyn,30568002003,211,95,116,4.96
2020,CB2020,047,3,Brooklyn,30569001000,395,182,213,3.96
2020,CB2020,047,3,Brooklyn,30569001001,278,126,152,3.64
2020,CB2020,047,3,Brooklyn,30569001002,270,145,125,4.05
2020,CB2020,047,3,Brooklyn,30569002000,307,149,158,3.55
2020,CB2020,047,3,Brooklyn,30569002001,308,147,161,3.89
2020,CB2020,047,3,Brooklyn,30569002002,40,25,15,3.8
2020,CB2020,047,3,Brooklyn,30569002003,7,2,5,3.99
2020,CB2020,047,3,Brooklyn,30569002004,0,0,0,1.03
2020,CB2020,047,3,Brooklyn,30569002005,0,0,0,3.33
2020,CB2020,047,3,Brooklyn,30569002006,19,9,10,0.39
2020,CB2020,047,3,Brooklyn,30570001000,0,0,0,1.36
2020,CB2020,047,3,Brooklyn,30570001001,578,274,304,5.93
2020,CB2020,047,3,Brooklyn,30570001002,214,104,110,3.17
2020,CB2020,047,3,Brooklyn,30570002000,0,0,0,6.26
2020,CB2020,047,3,Brooklyn,30570002001,586,263,323,5.39
2020,CB2020,047,3,Brooklyn,30570003000,344,168,176,4.27
2020,CB2020,047,3,Brooklyn,30570003001,351,160,191,4.7
2020,CB2020,047,3,Brooklyn,30570004000,0,0,0,4.82
2020,CB2020,047,3,Brooklyn,30570004001,140,73,67,4.84
2020,CB2020,047,3,Brooklyn,30570004002,333,156,177,4.69
2020,CB2020,047,3,Brooklyn,30570004003,288,155,133,4.67
2020,CB2020,047,3,Brooklyn,30570004004,254,108,146,4.67
2020,CB2020,047,3,Brooklyn,30570004005,289,121,168,4.82
2020,CB2020,047,3,Brooklyn,30570004006,0,0,0,1.09
2020,CB2020,047,3,Brooklyn,30570004007,157,74,83,4.14
2020,CB2020,047,3,Brooklyn,30571001000,300,136,164,2.93
2020,CB2020,047,3,Brooklyn,30571001001,423,209,214,3.78
2020,CB2020,047,3,Brooklyn,30571001002,431,226,205,3.8
2020,CB2020,047,3,Brooklyn,30571002000,418,199,219,4.51
2020,CB2020,047,3,Brooklyn,30571002001,583,272,311,4.8
2020,CB2020,047,3,Brooklyn,30571003000,480,250,230,3.56
2020,CB2020,047,3,Brooklyn,30571003001,0,0,0,0.8
2020,CB2020,047,3,Brooklyn,30571003002,293,144,149,3.83
2020,CB2020,047,3,Brooklyn,30571003003,387,191,196,3.66
2020,CB2020,047,3,Brooklyn,30571003004,43,21,22,0.33
2020,CB2020,047,3,Brooklyn,30571004000,255,110,145,3.02
2020,CB2020,047,3,Brooklyn,30571004001,0,0,0,0.76
2020,CB2020,047,3,Brooklyn,30571004002,363,162,201,3.82
2020,CB2020,047,3,Brooklyn,30571004003,291,145,146,3.87
2020,CB2020,047,3,Brooklyn,30572001000,1207,458,749,15.94
2020,CB2020,047,3,Brooklyn,30572001001,845,341,504,8.18
2020,CB2020,047,3,Brooklyn,30572001002,550,234,316,5.93
2020,CB2020,047,3,Brooklyn,30572002000,1286,512,774,16
2020,CB2020,047,3,Brooklyn,30572002001,1080,486,594,11.09
2020,CB2020,047,3,Brooklyn,30572002002,253,105,148,3.05
2020,CB2020,047,3,Brooklyn,30573001000,0,0,0,2.89
2020,CB2020,047,3,Brooklyn,30573001001,0,0,0,2.35
2020,CB2020,047,3,Brooklyn,30573001002,0,0,0,2.36
2020,CB2020,047,3,Brooklyn,30573001003,74,36,38,2.35
2020,CB2020,047,3,Brooklyn,30573001004,368,190,178,3.8
2020,CB2020,047,3,Brooklyn,30573001005,278,121,157,3.81
2020,CB2020,047,3,Brooklyn,30573001006,0,0,0,2.1
2020,CB2020,047,3,Brooklyn,30573002000,398,174,224,3.79
2020,CB2020,047,3,Brooklyn,30573002001,258,137,121,3.03
2020,CB2020,047,3,Brooklyn,30573002002,0,0,0,0.74
2020,CB2020,047,3,Brooklyn,30573002003,324,170,154,3.83
2020,CB2020,047,3,Brooklyn,30573003000,59,33,26,1.9
2020,CB2020,047,3,Brooklyn,30573003001,0,0,0,0.45
2020,CB2020,047,3,Brooklyn,30573003002,228,142,86,2.37
2020,CB2020,047,3,Brooklyn,30573003003,263,105,158,2.4
2020,CB2020,047,3,Brooklyn,30573003004,340,157,183,3.87
2020,CB2020,047,3,Brooklyn,30574001000,393,188,205,5.24
2020,CB2020,047,3,Brooklyn,30574001001,341,172,169,5.25
2020,CB2020,047,3,Brooklyn,30574001002,341,153,188,4.96
2020,CB2020,047,3,Brooklyn,30574001003,346,167,179,4.96
2020,CB2020,047,3,Brooklyn,30574002000,283,119,164,4.96
2020,CB2020,047,3,Brooklyn,30574002001,240,117,123,2.48
2020,CB2020,047,3,Brooklyn,30574002002,93,53,40,1.95
2020,CB2020,047,3,Brooklyn,30574002003,40,26,14,1.42
2020,CB2020,047,3,Brooklyn,30574002004,205,106,99,3.24
2020,CB2020,047,3,Brooklyn,30574002005,153,57,96,2.7
2020,CB2020,047,3,Brooklyn,30574002006,125,74,51,2.17
2020,CB2020,047,3,Brooklyn,30575001000,399,198,201,3.7
2020,CB2020,047,3,Brooklyn,30575001001,424,206,218,4
2020,CB2020,047,3,Brooklyn,30575001002,480,230,250,4.09
2020,CB2020,047,3,Brooklyn,30575002000,469,218,251,4.18
2020,CB2020,047,3,Brooklyn,30575002001,599,303,296,4.18
2020,CB2020,047,3,Brooklyn,30575003000,478,226,252,4.2
2020,CB2020,047,3,Brooklyn,30575003001,381,173,208,4.19
2020,CB2020,047,3,Brooklyn,30575003002,407,189,218,4.33
2020,CB2020,047,3,Brooklyn,30575004000,510,253,257,3.57
2020,CB2020,047,3,Brooklyn,30575004001,481,255,226,4.11
2020,CB2020,047,3,Brooklyn,30575004002,274,150,124,4.3
2020,CB2020,047,3,Brooklyn,30576001000,439,222,217,5.15
2020,CB2020,047,3,Brooklyn,30576001001,342,167,175,5.15
2020,CB2020,047,3,Brooklyn,30576001002,402,209,193,3.72
2020,CB2020,047,3,Brooklyn,30576001003,159,69,90,3.14
2020,CB2020,047,3,Brooklyn,30576001004,91,38,53,1.7
2020,CB2020,047,3,Brooklyn,30576001005,16,15,1,1.12
2020,CB2020,047,3,Brooklyn,30576002000,430,235,195,4.96
2020,CB2020,047,3,Brooklyn,30576002001,274,145,129,4.95
2020,CB2020,047,3,Brooklyn,30576002002,437,221,216,4.66
2020,CB2020,047,3,Brooklyn,30576002003,298,126,172,4.12
2020,CB2020,047,3,Brooklyn,30576002004,24,9,15,0.53
2020,CB2020,047,3,Brooklyn,30578001000,294,141,153,4.95
2020,CB2020,047,3,Brooklyn,30578001001,464,230,234,5.52
2020,CB2020,047,3,Brooklyn,30578001002,327,148,179,5.19
2020,CB2020,047,3,Brooklyn,30578001003,524,245,279,4.65
2020,CB2020,047,3,Brooklyn,30578002000,339,194,145,6.43
2020,CB2020,047,3,Brooklyn,30578002001,478,222,256,5.04
2020,CB2020,047,3,Brooklyn,30578002002,410,204,206,4.75
2020,CB2020,047,3,Brooklyn,30578002003,496,250,246,6.03
2020,CB2020,047,3,Brooklyn,30579011000,0,0,0,0
2020,CB2020,047,3,Brooklyn,30579011001,19,14,5,5.34
2020,CB2020,047,3,Brooklyn,30579011002,44,22,22,4.03
2020,CB2020,047,3,Brooklyn,30579011003,409,231,178,3.69
2020,CB2020,047,3,Brooklyn,30579011004,0,0,0,0.28
2020,CB2020,047,3,Brooklyn,30579012000,87,79,8,3.67
2020,CB2020,047,3,Brooklyn,30579012001,0,0,0,1.26
2020,CB2020,047,3,Brooklyn,30579012002,0,0,0,0.45
2020,CB2020,047,3,Brooklyn,30579012003,0,0,0,0.46
2020,CB2020,047,3,Brooklyn,30579012004,0,0,0,0.28
2020,CB2020,047,3,Brooklyn,30579012005,467,226,241,3.7
2020,CB2020,047,3,Brooklyn,30579012006,33,11,22,3.98
2020,CB2020,047,3,Brooklyn,30579012007,52,23,29,4.08
2020,CB2020,047,3,Brooklyn,30579012008,0,0,0,0.45
2020,CB2020,047,3,Brooklyn,30579012009,0,0,0,0.29
2020,CB2020,047,3,Brooklyn,30579012010,0,0,0,0.29
2020,CB2020,047,3,Brooklyn,30579012011,0,0,0,0.33
2020,CB2020,047,3,Brooklyn,30579012012,90,35,55,4
2020,CB2020,047,3,Brooklyn,30579012013,56,26,30,3.96
2020,CB2020,047,3,Brooklyn,30579012014,0,0,0,0.29
2020,CB2020,047,3,Brooklyn,30579012015,0,0,0,0.29
2020,CB2020,047,3,Brooklyn,30579012016,64,36,28,3.92
2020,CB2020,047,3,Brooklyn,30579012017,71,25,46,3.93
2020,CB2020,047,3,Brooklyn,30579012018,0,0,0,0.29
2020,CB2020,047,3,Brooklyn,30579012019,0,0,0,0.28
2020,CB2020,047,3,Brooklyn,30579012020,14,10,4,3.94
2020,CB2020,047,3,Brooklyn,30579012021,10,2,8,3.83
2020,CB2020,047,3,Brooklyn,30579012022,0,0,0,0.25
2020,CB2020,047,3,Brooklyn,30579012023,0,0,0,0.66
2020,CB2020,047,3,Brooklyn,30579012024,0,0,0,2.51
2020,CB2020,047,3,Brooklyn,30579021000,0,0,0,0
2020,CB2020,047,3,Brooklyn,30579021001,0,0,0,0.21
2020,CB2020,047,3,Brooklyn,30579021002,0,0,0,68.85
2020,CB2020,047,3,Brooklyn,30579021003,0,0,0,0.41
2020,CB2020,047,3,Brooklyn,30579021004,0,0,0,26.55
2020,CB2020,047,3,Brooklyn,30579021005,0,0,0,7.67
2020,CB2020,047,3,Brooklyn,30579021006,0,0,0,2.28
2020,CB2020,047,3,Brooklyn,30579021007,0,0,0,5.53
2020,CB2020,047,3,Brooklyn,30579021008,0,0,0,2.72
2020,CB2020,047,3,Brooklyn,30579021009,0,0,0,1.98
2020,CB2020,047,3,Brooklyn,30579021010,0,0,0,3.08
2020,CB2020,047,3,Brooklyn,30579021011,0,0,0,5.09
2020,CB2020,047,3,Brooklyn,30580001000,551,264,287,5.15
2020,CB2020,047,3,Brooklyn,30580001001,617,295,322,5.16
2020,CB2020,047,3,Brooklyn,30580001002,352,185,167,4.84
2020,CB2020,047,3,Brooklyn,30580001003,333,145,188,4.82
2020,CB2020,047,3,Brooklyn,30580002000,108,55,53,2.16
2020,CB2020,047,3,Brooklyn,30580002001,216,108,108,2.78
2020,CB2020,047,3,Brooklyn,30580002002,432,224,208,4.96
2020,CB2020,047,3,Brooklyn,30580002003,601,274,327,4.67
2020,CB2020,047,3,Brooklyn,30580002004,202,90,112,2.43
2020,CB2020,047,3,Brooklyn,30580002005,90,46,44,2.23
2020,CB2020,047,3,Brooklyn,30582001000,271,169,102,4.95
2020,CB2020,047,3,Brooklyn,30582001001,369,177,192,4.65
2020,CB2020,047,3,Brooklyn,30582001002,349,138,211,4.66
2020,CB2020,047,3,Brooklyn,30582002000,471,238,233,5
2020,CB2020,047,3,Brooklyn,30582002001,106,56,50,3.29
2020,CB2020,047,3,Brooklyn,30582002002,116,55,61,2.39
2020,CB2020,047,3,Brooklyn,30582003000,424,234,190,4.96
2020,CB2020,047,3,Brooklyn,30582003001,432,198,234,4.66
2020,CB2020,047,3,Brooklyn,30582003002,506,232,274,5.35
2020,CB2020,047,3,Brooklyn,30584001000,254,137,117,4.43
2020,CB2020,047,3,Brooklyn,30584001001,451,231,220,4.67
2020,CB2020,047,3,Brooklyn,30584001002,679,304,375,5.47
2020,CB2020,047,3,Brooklyn,30584002000,265,153,112,5.07
2020,CB2020,047,3,Brooklyn,30584002001,98,44,54,1.46
2020,CB2020,047,3,Brooklyn,30584002002,33,27,6,4.1
2020,CB2020,047,3,Brooklyn,30584002003,87,48,39,2.16
2020,CB2020,047,3,Brooklyn,30584002004,10,6,4,0.44
2020,CB2020,047,3,Brooklyn,30584002005,585,285,300,4.92
2020,CB2020,047,3,Brooklyn,30584002006,599,288,311,4.85
2020,CB2020,047,3,Brooklyn,30584002007,286,120,166,1.07
2020,CB2020,047,3,Brooklyn,30584002008,30,12,18,0.95
2020,CB2020,047,3,Brooklyn,30584002009,68,30,38,1.86
2020,CB2020,047,3,Brooklyn,30584002010,161,69,92,2.13
2020,CB2020,047,3,Brooklyn,30584002011,113,52,61,2.21
2020,CB2020,047,3,Brooklyn,30584002012,44,5,39,0.34
2020,CB2020,047,3,Brooklyn,30584002013,34,5,29,0.38
2020,CB2020,047,3,Brooklyn,30586001000,296,143,153,3.24
2020,CB2020,047,3,Brooklyn,30586001001,152,66,86,3.84
2020,CB2020,047,3,Brooklyn,30586001002,62,27,35,1.87
2020,CB2020,047,3,Brooklyn,30586001003,181,79,102,2.17
2020,CB2020,047,3,Brooklyn,30586001004,384,179,205,4.21
2020,CB2020,047,3,Brooklyn,30586001005,59,35,24,1.62
2020,CB2020,047,3,Brooklyn,30586001006,96,48,48,2.19
2020,CB2020,047,3,Brooklyn,30586002000,255,111,144,4.82
2020,CB2020,047,3,Brooklyn,30586002001,291,141,150,4.83
2020,CB2020,047,3,Brooklyn,30586002002,156,86,70,2.66
2020,CB2020,047,3,Brooklyn,30586002003,214,97,117,3.21
2020,CB2020,047,3,Brooklyn,30586002004,509,251,258,5.71
2020,CB2020,047,3,Brooklyn,30588001000,67,23,44,1.5
2020,CB2020,047,3,Brooklyn,30588001001,560,271,289,4.99
2020,CB2020,047,3,Brooklyn,30588001002,91,55,36,1.69
2020,CB2020,047,3,Brooklyn,30588001003,330,149,181,4.01
2020,CB2020,047,3,Brooklyn,30588001004,181,114,67,5.04
2020,CB2020,047,3,Brooklyn,30588001005,160,71,89,5.04
2020,CB2020,047,3,Brooklyn,30588001006,308,149,159,5.21
2020,CB2020,047,3,Brooklyn,30588001007,128,40,88,1.82
2020,CB2020,047,3,Brooklyn,30588002000,1707,804,903,10.14
2020,CB2020,047,3,Brooklyn,30589011000,19,11,8,4.1
2020,CB2020,047,3,Brooklyn,30589011001,0,0,0,4.11
2020,CB2020,047,3,Brooklyn,30589011002,405,196,209,4.16
2020,CB2020,047,3,Brooklyn,30589011003,478,219,259,4.09
2020,CB2020,047,3,Brooklyn,30589012000,17,7,10,10.81
2020,CB2020,047,3,Brooklyn,30589012001,0,0,0,10.1
2020,CB2020,047,3,Brooklyn,30589012002,391,204,187,4.09
2020,CB2020,047,3,Brooklyn,30589012003,337,178,159,4.18
2020,CB2020,047,3,Brooklyn,30589012004,134,55,79,4.17
2020,CB2020,047,3,Brooklyn,30589021000,0,0,0,0
2020,CB2020,047,3,Brooklyn,30589021001,0,0,0,39.21
2020,CB2020,047,3,Brooklyn,30589021002,0,0,0,15.75
2020,CB2020,047,3,Brooklyn,30590001000,182,93,89,4.85
2020,CB2020,047,3,Brooklyn,30590001001,61,20,41,2.15
2020,CB2020,047,3,Brooklyn,30590001002,187,100,87,2.51
2020,CB2020,047,3,Brooklyn,30590001003,376,208,168,4.67
2020,CB2020,047,3,Brooklyn,30590001004,288,119,169,4.67
2020,CB2020,047,3,Brooklyn,30590001005,342,158,184,4.58
2020,CB2020,047,3,Brooklyn,30590001006,257,125,132,4.66
2020,CB2020,047,3,Brooklyn,30590001007,80,33,47,4.62
2020,CB2020,047,3,Brooklyn,30590001008,241,111,130,4.85
2020,CB2020,047,3,Brooklyn,30590001009,0,0,0,1.59
2020,CB2020,047,3,Brooklyn,30591001000,696,353,343,5.63
2020,CB2020,047,3,Brooklyn,30591001001,291,137,154,1.82
2020,CB2020,047,3,Brooklyn,30591002000,599,280,319,5.63
2020,CB2020,047,3,Brooklyn,30591002001,237,127,110,3.01
2020,CB2020,047,3,Brooklyn,30591003000,316,164,152,2.9
2020,CB2020,047,3,Brooklyn,30591003001,285,134,151,2.91
2020,CB2020,047,3,Brooklyn,30591003002,182,79,103,1.99
2020,CB2020,047,3,Brooklyn,30591003003,145,58,87,1.11
2020,CB2020,047,3,Brooklyn,30591003004,208,110,98,2.99
2020,CB2020,047,3,Brooklyn,30591004000,0,0,0,11.05
2020,CB2020,047,3,Brooklyn,30591004001,597,293,304,5.53
2020,CB2020,047,3,Brooklyn,30591004002,300,135,165,2.91
2020,CB2020,047,3,Brooklyn,30592001000,256,119,137,2.31
2020,CB2020,047,3,Brooklyn,30592001001,196,83,113,2.52
2020,CB2020,047,3,Brooklyn,30592001002,142,74,68,2.85
2020,CB2020,047,3,Brooklyn,30592001003,678,318,360,4.5
2020,CB2020,047,3,Brooklyn,30592002000,719,371,348,6.02
2020,CB2020,047,3,Brooklyn,30592002001,255,145,110,4.76
2020,CB2020,047,3,Brooklyn,30592002002,123,57,66,4.76
2020,CB2020,047,3,Brooklyn,30592002003,444,177,267,6.02
2020,CB2020,047,3,Brooklyn,30592002004,191,79,112,4.82
2020,CB2020,047,3,Brooklyn,30592003000,757,369,388,6.01
2020,CB2020,047,3,Brooklyn,30592003001,507,249,258,4.78
2020,CB2020,047,3,Brooklyn,30592003002,0,0,0,4.84
2020,CB2020,047,3,Brooklyn,30593001000,25,12,13,3.94
2020,CB2020,047,3,Brooklyn,30593001001,0,0,0,2.84
2020,CB2020,047,3,Brooklyn,30593001002,14,4,10,3.56
2020,CB2020,047,3,Brooklyn,30593001003,16,13,3,4.21
2020,CB2020,047,3,Brooklyn,30593001004,0,0,0,4.09
2020,CB2020,047,3,Brooklyn,30593001005,593,277,316,5.45
2020,CB2020,047,3,Brooklyn,30593001006,446,221,225,4.63
2020,CB2020,047,3,Brooklyn,30593001007,188,90,98,3.86
2020,CB2020,047,3,Brooklyn,30593001008,28,19,9,3.27
2020,CB2020,047,3,Brooklyn,30593002000,107,65,42,4.09
2020,CB2020,047,3,Brooklyn,30593002001,735,374,361,5.51
2020,CB2020,047,3,Brooklyn,30593002002,122,41,81,0.98
2020,CB2020,047,3,Brooklyn,30594021000,176,70,106,5.71
2020,CB2020,047,3,Brooklyn,30594021001,162,82,80,5.11
2020,CB2020,047,3,Brooklyn,30594021002,357,180,177,5.16
2020,CB2020,047,3,Brooklyn,30594021003,313,137,176,4.88
2020,CB2020,047,3,Brooklyn,30594022000,504,236,268,4.64
2020,CB2020,047,3,Brooklyn,30594022001,290,123,167,4.66
2020,CB2020,047,3,Brooklyn,30594022002,310,136,174,4.65
2020,CB2020,047,3,Brooklyn,30594022003,296,160,136,4.84
2020,CB2020,047,3,Brooklyn,30594023000,359,158,201,4.66
2020,CB2020,047,3,Brooklyn,30594023001,399,179,220,4.65
2020,CB2020,047,3,Brooklyn,30594023002,273,125,148,3.83
2020,CB2020,047,3,Brooklyn,30594023003,288,151,137,4.84
2020,CB2020,047,3,Brooklyn,30594023004,53,29,24,0.83
2020,CB2020,047,3,Brooklyn,30594024000,341,163,178,5.26
2020,CB2020,047,3,Brooklyn,30594024001,352,155,197,5.25
2020,CB2020,047,3,Brooklyn,30594024002,346,169,177,5.26
2020,CB2020,047,3,Brooklyn,30594024003,286,136,150,5.46
2020,CB2020,047,3,Brooklyn,30594031000,317,141,176,5.46
2020,CB2020,047,3,Brooklyn,30594031001,379,182,197,5.26
2020,CB2020,047,3,Brooklyn,30594031002,266,130,136,5.26
2020,CB2020,047,3,Brooklyn,30594032000,384,194,190,4.83
2020,CB2020,047,3,Brooklyn,30594032001,319,116,203,4.65
2020,CB2020,047,3,Brooklyn,30594032002,396,196,200,4.66
2020,CB2020,047,3,Brooklyn,30594032003,241,117,124,4.66
2020,CB2020,047,3,Brooklyn,30594033000,0,0,0,0.55
2020,CB2020,047,3,Brooklyn,30594033001,121,43,78,1.26
2020,CB2020,047,3,Brooklyn,30594033002,554,256,298,4.6
2020,CB2020,047,3,Brooklyn,30594033003,318,168,150,4.7
2020,CB2020,047,3,Brooklyn,30594033004,484,211,273,5.2
2020,CB2020,047,3,Brooklyn,30594041000,0,0,0,4.84
2020,CB2020,047,3,Brooklyn,30594041001,497,253,244,4.66
2020,CB2020,047,3,Brooklyn,30594041002,351,175,176,4.66
2020,CB2020,047,3,Brooklyn,30594041003,351,178,173,4.84
2020,CB2020,047,3,Brooklyn,30594041004,288,129,159,4.83
2020,CB2020,047,3,Brooklyn,30594042000,390,182,208,4.65
2020,CB2020,047,3,Brooklyn,30594042001,462,251,211,4.66
2020,CB2020,047,3,Brooklyn,30594042002,322,147,175,4.68
2020,CB2020,047,3,Brooklyn,30594042003,403,196,207,4.64
2020,CB2020,047,3,Brooklyn,30594043000,764,357,407,5.2
2020,CB2020,047,3,Brooklyn,30594043001,598,270,328,5.19
2020,CB2020,047,3,Brooklyn,30596001000,0,0,0,3.4
2020,CB2020,047,3,Brooklyn,30596001001,440,202,238,4.68
2020,CB2020,047,3,Brooklyn,30596001002,116,59,57,1.34
2020,CB2020,047,3,Brooklyn,30596002000,993,437,556,9.35
2020,CB2020,047,3,Brooklyn,30596003000,0,0,0,4.83
2020,CB2020,047,3,Brooklyn,30596003001,134,53,81,5.21
2020,CB2020,047,3,Brooklyn,30596003002,294,159,135,4.64
2020,CB2020,047,3,Brooklyn,30596003003,287,146,141,4.65
2020,CB2020,047,3,Brooklyn,30596003004,305,142,163,4.66
2020,CB2020,047,3,Brooklyn,30598001000,118,57,61,5.14
2020,CB2020,047,3,Brooklyn,30598001001,383,201,182,4.94
2020,CB2020,047,3,Brooklyn,30598001002,499,245,254,4.95
2020,CB2020,047,3,Brooklyn,30598001003,485,259,226,4.95
2020,CB2020,047,3,Brooklyn,30598001004,662,287,375,5.13
2020,CB2020,047,3,Brooklyn,30598002000,0,0,0,3.22
2020,CB2020,047,3,Brooklyn,30598002001,601,291,310,4.57
2020,CB2020,047,3,Brooklyn,30598002002,6,5,1,2.93
2020,CB2020,047,3,Brooklyn,30598002003,152,63,89,2.62
2020,CB2020,047,3,Brooklyn,30598002004,208,106,102,2.5
2020,CB2020,047,3,Brooklyn,30598002005,182,82,100,2.57
2020,CB2020,047,3,Brooklyn,30598002006,168,86,82,2.73
2020,CB2020,047,3,Brooklyn,30598002007,153,64,89,2.98
2020,CB2020,047,3,Brooklyn,30600001000,0,0,0,5.55
2020,CB2020,047,3,Brooklyn,30600001001,317,154,163,4.93
2020,CB2020,047,3,Brooklyn,30600001002,721,335,386,6.38
2020,CB2020,047,3,Brooklyn,30600002000,285,145,140,4.95
2020,CB2020,047,3,Brooklyn,30600002001,251,142,109,4.96
2020,CB2020,047,3,Brooklyn,30600002002,355,184,171,5.14
2020,CB2020,047,3,Brooklyn,30600002003,235,110,125,3.38
2020,CB2020,047,3,Brooklyn,30600002004,183,71,112,3.38
2020,CB2020,047,3,Brooklyn,30600002005,148,82,66,3.09
2020,CB2020,047,3,Brooklyn,30600003000,353,177,176,5.14
2020,CB2020,047,3,Brooklyn,30600003001,340,169,171,6.92
2020,CB2020,047,3,Brooklyn,30600003002,0,0,0,0.25
2020,CB2020,047,3,Brooklyn,30600003003,0,0,0,0.63
2020,CB2020,047,3,Brooklyn,30600003004,216,99,117,4.32
2020,CB2020,047,3,Brooklyn,30600003005,159,73,86,2.72
2020,CB2020,047,3,Brooklyn,30600003006,656,325,331,5.04
2020,CB2020,047,3,Brooklyn,30600003007,158,65,93,2.07
2020,CB2020,047,3,Brooklyn,30600003008,158,79,79,2.67
2020,CB2020,047,3,Brooklyn,30600003009,91,45,46,1.94
2020,CB2020,047,3,Brooklyn,30600003010,94,50,44,1.13
2020,CB2020,047,3,Brooklyn,30600004000,0,0,0,1.02
2020,CB2020,047,3,Brooklyn,30600004001,603,265,338,4.5
2020,CB2020,047,3,Brooklyn,30600004002,183,91,92,3.35
2020,CB2020,047,3,Brooklyn,30600004003,0,0,0,3.71
2020,CB2020,047,3,Brooklyn,30600004004,201,112,89,4.25
2020,CB2020,047,3,Brooklyn,30600005000,6,6,0,1.6
2020,CB2020,047,3,Brooklyn,30600005001,0,0,0,1.62
2020,CB2020,047,3,Brooklyn,30600005002,92,51,41,1.91
2020,CB2020,047,3,Brooklyn,30600005003,175,86,89,3.89
2020,CB2020,047,3,Brooklyn,30600005004,278,114,164,3.53
2020,CB2020,047,3,Brooklyn,30600005005,586,261,325,4.73
2020,CB2020,047,3,Brooklyn,30606001000,31,18,13,2.16
2020,CB2020,047,3,Brooklyn,30606001001,487,265,222,6.16
2020,CB2020,047,3,Brooklyn,30606001002,47,21,26,3.59
2020,CB2020,047,3,Brooklyn,30606001003,32,14,18,0.84
2020,CB2020,047,3,Brooklyn,30606001004,540,247,293,4.8
2020,CB2020,047,3,Brooklyn,30606001005,846,374,472,5.11
2020,CB2020,047,3,Brooklyn,30606001006,17,9,8,2.52
2020,CB2020,047,3,Brooklyn,30606001007,187,104,83,0.93
2020,CB2020,047,3,Brooklyn,30606002000,300,137,163,1.96
2020,CB2020,047,3,Brooklyn,30606002001,134,65,69,2.27
2020,CB2020,047,3,Brooklyn,30606002002,193,101,92,5.49
2020,CB2020,047,3,Brooklyn,30606002003,139,43,96,2.17
2020,CB2020,047,3,Brooklyn,30606002004,0,0,0,3.52
2020,CB2020,047,3,Brooklyn,30606002005,225,126,99,2.77
2020,CB2020,047,3,Brooklyn,30608001000,0,0,0,0.97
2020,CB2020,047,3,Brooklyn,30608001001,0,0,0,0.55
2020,CB2020,047,3,Brooklyn,30608001002,0,0,0,0.6
2020,CB2020,047,3,Brooklyn,30608001003,155,68,87,3.49
2020,CB2020,047,3,Brooklyn,30608001004,188,85,103,2.84
2020,CB2020,047,3,Brooklyn,30608001005,0,0,0,0.57
2020,CB2020,047,3,Brooklyn,30608001006,0,0,0,1.79
2020,CB2020,047,3,Brooklyn,30608001007,0,0,0,0.71
2020,CB2020,047,3,Brooklyn,30608001008,0,0,0,1.44
2020,CB2020,047,3,Brooklyn,30608001009,0,0,0,2.68
2020,CB2020,047,3,Brooklyn,30608001010,0,0,0,1.34
2020,CB2020,047,3,Brooklyn,30608001011,0,0,0,3.62
2020,CB2020,047,3,Brooklyn,30608001012,0,0,0,0.98
2020,CB2020,047,3,Brooklyn,30608001013,0,0,0,0.7
2020,CB2020,047,3,Brooklyn,30608001014,0,0,0,0.66
2020,CB2020,047,3,Brooklyn,30608001015,0,0,0,0.34
2020,CB2020,047,3,Brooklyn,30608001016,0,0,0,0.55
2020,CB2020,047,3,Brooklyn,30608001017,0,0,0,0.57
2020,CB2020,047,3,Brooklyn,30608001018,0,0,0,1.54
2020,CB2020,047,3,Brooklyn,30608001019,0,0,0,2.18
2020,CB2020,047,3,Brooklyn,30608001020,0,0,0,0.7
2020,CB2020,047,3,Brooklyn,30608001021,0,0,0,0.54
2020,CB2020,047,3,Brooklyn,30608001022,0,0,0,0.33
2020,CB2020,047,3,Brooklyn,30608001023,230,101,129,2.87
2020,CB2020,047,3,Brooklyn,30608001024,49,29,20,2.22
2020,CB2020,047,3,Brooklyn,30608001025,0,0,0,2.68
2020,CB2020,047,3,Brooklyn,30608001026,0,0,0,1.29
2020,CB2020,047,3,Brooklyn,30608001027,0,0,0,0.71
2020,CB2020,047,3,Brooklyn,30608001028,0,0,0,1.22
2020,CB2020,047,3,Brooklyn,30608001029,0,0,0,1.94
2020,CB2020,047,3,Brooklyn,30608001030,0,0,0,1.64
2020,CB2020,047,3,Brooklyn,30608001031,116,36,80,3.31
2020,CB2020,047,3,Brooklyn,30608001032,4,2,2,1.15
2020,CB2020,047,3,Brooklyn,30608001033,41,31,10,1.72
2020,CB2020,047,3,Brooklyn,30608001034,115,71,44,1.38
2020,CB2020,047,3,Brooklyn,30608001035,80,26,54,2.47
2020,CB2020,047,3,Brooklyn,30608001036,0,0,0,4.1
2020,CB2020,047,3,Brooklyn,30608001037,0,0,0,0.53
2020,CB2020,047,3,Brooklyn,30608001038,0,0,0,0
2020,CB2020,047,3,Brooklyn,30608002000,939,466,473,3.76
2020,CB2020,047,3,Brooklyn,30608002001,0,0,0,0.6
2020,CB2020,047,3,Brooklyn,30608002002,55,27,28,1.33
2020,CB2020,047,3,Brooklyn,30608002003,92,48,44,2.56
2020,CB2020,047,3,Brooklyn,30608002004,270,132,138,2.74
2020,CB2020,047,3,Brooklyn,30608002005,71,44,27,1.27
2020,CB2020,047,3,Brooklyn,30608002006,191,75,116,1.68
2020,CB2020,047,3,Brooklyn,30608002007,24,10,14,1.18
2020,CB2020,047,3,Brooklyn,30608003000,171,90,81,1.85
2020,CB2020,047,3,Brooklyn,30608003001,645,280,365,4.28
2020,CB2020,047,3,Brooklyn,30608003002,0,0,0,0.73
2020,CB2020,047,3,Brooklyn,30608003003,328,151,177,3.05
2020,CB2020,047,3,Brooklyn,30608003004,17,5,12,3.83
2020,CB2020,047,3,Brooklyn,30608003005,0,0,0,3.96
2020,CB2020,047,3,Brooklyn,30608003006,234,121,113,3.06
2020,CB2020,047,3,Brooklyn,30608003007,0,0,0,1.91
2020,CB2020,047,3,Brooklyn,30608003008,0,0,0,2.46
2020,CB2020,047,3,Brooklyn,30608003009,0,0,0,0
2020,CB2020,047,3,Brooklyn,30610020001,0,0,0,0
2020,CB2020,047,3,Brooklyn,30610021000,290,124,166,0.56
2020,CB2020,047,3,Brooklyn,30610021001,63,38,25,0.65
2020,CB2020,047,3,Brooklyn,30610021002,614,266,348,3.6
2020,CB2020,047,3,Brooklyn,30610021003,188,91,97,5.3
2020,CB2020,047,3,Brooklyn,30610021004,119,74,45,19.92
2020,CB2020,047,3,Brooklyn,30610021005,0,0,0,0.3
2020,CB2020,047,3,Brooklyn,30610021006,0,0,0,0.57
2020,CB2020,047,3,Brooklyn,30610022000,466,214,252,4.45
2020,CB2020,047,3,Brooklyn,30610022001,450,223,227,4.13
2020,CB2020,047,3,Brooklyn,30610022002,1120,504,616,8.65
2020,CB2020,047,3,Brooklyn,30610023000,468,189,279,2.74
2020,CB2020,047,3,Brooklyn,30610023001,309,128,181,1.17
2020,CB2020,047,3,Brooklyn,30610023002,977,435,542,4.11
2020,CB2020,047,3,Brooklyn,30610031000,218,137,81,3.82
2020,CB2020,047,3,Brooklyn,30610031001,378,215,163,1.47
2020,CB2020,047,3,Brooklyn,30610031002,105,48,57,1.23
2020,CB2020,047,3,Brooklyn,30610031003,76,27,49,1.13
2020,CB2020,047,3,Brooklyn,30610031004,194,108,86,1.32
2020,CB2020,047,3,Brooklyn,30610032000,0,0,0,0.42
2020,CB2020,047,3,Brooklyn,30610032001,343,187,156,2.57
2020,CB2020,047,3,Brooklyn,30610032002,79,32,47,2.27
2020,CB2020,047,3,Brooklyn,30610032003,326,156,170,1.67
2020,CB2020,047,3,Brooklyn,30610032004,297,143,154,2.23
2020,CB2020,047,3,Brooklyn,30610032005,402,225,177,1.67
2020,CB2020,047,3,Brooklyn,30610041000,930,429,501,5.8
2020,CB2020,047,3,Brooklyn,30610041001,89,49,40,4.39
2020,CB2020,047,3,Brooklyn,30610041002,434,198,236,2.6
2020,CB2020,047,3,Brooklyn,30610041003,0,0,0,0.46
2020,CB2020,047,3,Brooklyn,30610042000,273,115,158,8.36
2020,CB2020,047,3,Brooklyn,30610042001,874,399,475,4.61
2020,CB2020,047,3,Brooklyn,30610043000,691,293,398,3.74
2020,CB2020,047,3,Brooklyn,30610043001,467,217,250,1.82
2020,CB2020,047,3,Brooklyn,30610044000,597,250,347,3.55
2020,CB2020,047,3,Brooklyn,30610044001,715,370,345,3.84
2020,CB2020,047,3,Brooklyn,30610045000,414,205,209,4.12
2020,CB2020,047,3,Brooklyn,30610045001,557,267,290,6.93
2020,CB2020,047,3,Brooklyn,30610045002,628,280,348,5.25
2020,CB2020,047,3,Brooklyn,30612001000,0,0,0,0
2020,CB2020,047,3,Brooklyn,30612001001,0,0,0,5.93
2020,CB2020,047,3,Brooklyn,30612001002,121,55,66,3.18
2020,CB2020,047,3,Brooklyn,30612001003,62,19,43,4.04
2020,CB2020,047,3,Brooklyn,30612001004,95,53,42,4.74
2020,CB2020,047,3,Brooklyn,30612001005,119,58,61,5
2020,CB2020,047,3,Brooklyn,30612001006,92,50,42,5.26
2020,CB2020,047,3,Brooklyn,30612001007,115,55,60,5.27
2020,CB2020,047,3,Brooklyn,30612001008,106,55,51,5.33
2020,CB2020,047,3,Brooklyn,30612001009,278,140,138,5.72
2020,CB2020,047,3,Brooklyn,30612001010,34,1,33,1.94
2020,CB2020,047,3,Brooklyn,30612001011,41,24,17,2.56
2020,CB2020,047,3,Brooklyn,30616000001,0,0,0,0
2020,CB2020,047,3,Brooklyn,30616000002,0,0,0,0
2020,CB2020,047,3,Brooklyn,30616001000,0,0,0,0
2020,CB2020,047,3,Brooklyn,30616001001,388,111,277,69.7
2020,CB2020,047,3,Brooklyn,30616001002,181,89,92,6.4
2020,CB2020,047,3,Brooklyn,30616001003,0,0,0,13.68
2020,CB2020,047,3,Brooklyn,30616001004,130,90,40,5.29
2020,CB2020,047,3,Brooklyn,30616001005,246,125,121,5.42
2020,CB2020,047,3,Brooklyn,30616001006,0,0,0,30.3
2020,CB2020,047,3,Brooklyn,30616001007,155,65,90,14.97
2020,CB2020,047,3,Brooklyn,30616001008,120,70,50,8.1
2020,CB2020,047,3,Brooklyn,30616001009,110,67,43,5.07
2020,CB2020,047,3,Brooklyn,30616001010,98,37,61,5.08
2020,CB2020,047,3,Brooklyn,30616001011,112,38,74,5.07
2020,CB2020,047,3,Brooklyn,30616001012,159,85,74,5.07
2020,CB2020,047,3,Brooklyn,30616001013,155,61,94,5.26
2020,CB2020,047,3,Brooklyn,30620001000,91,48,43,5.5
2020,CB2020,047,3,Brooklyn,30620001001,87,41,46,5.51
2020,CB2020,047,3,Brooklyn,30620001002,88,40,48,5.22
2020,CB2020,047,3,Brooklyn,30620001003,91,44,47,5.2
2020,CB2020,047,3,Brooklyn,30620001004,182,90,92,5.2
2020,CB2020,047,3,Brooklyn,30620001005,182,80,102,5.21
2020,CB2020,047,3,Brooklyn,30620001006,201,108,93,5.5
2020,CB2020,047,3,Brooklyn,30620002000,0,0,0,0
2020,CB2020,047,3,Brooklyn,30620002001,0,0,0,1.83
2020,CB2020,047,3,Brooklyn,30620002002,109,49,60,6.13
2020,CB2020,047,3,Brooklyn,30620002003,65,37,28,6.7
2020,CB2020,047,3,Brooklyn,30620002004,77,40,37,5.2
2020,CB2020,047,3,Brooklyn,30620002005,92,40,52,5.2
2020,CB2020,047,3,Brooklyn,30620002006,121,71,50,5.19
2020,CB2020,047,3,Brooklyn,30620002007,185,81,104,5.68
2020,CB2020,047,3,Brooklyn,30620002008,196,101,95,5.71
2020,CB2020,047,3,Brooklyn,30622001000,0,0,0,1.77
2020,CB2020,047,3,Brooklyn,30622001001,0,0,0,2.57
2020,CB2020,047,3,Brooklyn,30622001002,0,0,0,1.36
2020,CB2020,047,3,Brooklyn,30622001003,0,0,0,0.87
2020,CB2020,047,3,Brooklyn,30622001004,0,0,0,1.57
2020,CB2020,047,3,Brooklyn,30622001005,0,0,0,2.42
2020,CB2020,047,3,Brooklyn,30622001006,476,231,245,4.55
2020,CB2020,047,3,Brooklyn,30622001007,474,217,257,4.4
2020,CB2020,047,3,Brooklyn,30622001008,420,209,211,3.72
2020,CB2020,047,3,Brooklyn,30622001009,388,160,228,2.99
2020,CB2020,047,3,Brooklyn,30622001010,82,36,46,1.9
2020,CB2020,047,3,Brooklyn,30622002000,266,129,137,4.29
2020,CB2020,047,3,Brooklyn,30622002001,152,71,81,4.13
2020,CB2020,047,3,Brooklyn,30622002002,798,343,455,14.71
2020,CB2020,047,3,Brooklyn,30622002003,0,0,0,2.55
2020,CB2020,047,3,Brooklyn,30622002004,0,0,0,0
2020,CB2020,047,3,Brooklyn,30622002005,153,73,80,3.86
2020,CB2020,047,3,Brooklyn,30622002006,116,45,71,2.53
2020,CB2020,047,3,Brooklyn,30622002007,0,0,0,0.97
2020,CB2020,047,3,Brooklyn,30626001000,88,52,36,1.46
2020,CB2020,047,3,Brooklyn,30626001001,160,83,77,3.96
2020,CB2020,047,3,Brooklyn,30626001002,336,162,174,5.01
2020,CB2020,047,3,Brooklyn,30626001003,379,161,218,4.77
2020,CB2020,047,3,Brooklyn,30626002000,250,134,116,4.99
2020,CB2020,047,3,Brooklyn,30626002001,494,247,247,4.69
2020,CB2020,047,3,Brooklyn,30626002002,521,244,277,4.82
2020,CB2020,047,3,Brooklyn,30626002003,0,0,0,9.47
2020,CB2020,047,3,Brooklyn,30626002004,924,427,497,9.51
2020,CB2020,047,3,Brooklyn,30626002005,0,0,0,29.92
2020,CB2020,047,3,Brooklyn,30628001000,39,26,13,1.78
2020,CB2020,047,3,Brooklyn,30628001001,50,17,33,1.42
2020,CB2020,047,3,Brooklyn,30628001002,50,12,38,1.42
2020,CB2020,047,3,Brooklyn,30628001003,33,10,23,1.43
2020,CB2020,047,3,Brooklyn,30628001004,49,36,13,1.42
2020,CB2020,047,3,Brooklyn,30628001005,40,11,29,1.42
2020,CB2020,047,3,Brooklyn,30628001006,49,27,22,1.42
2020,CB2020,047,3,Brooklyn,30628001007,37,26,11,1.42
2020,CB2020,047,3,Brooklyn,30628001008,44,14,30,1.41
2020,CB2020,047,3,Brooklyn,30628001009,37,9,28,1.38
2020,CB2020,047,3,Brooklyn,30628001010,41,23,18,2.6
2020,CB2020,047,3,Brooklyn,30628001011,0,0,0,0
2020,CB2020,047,3,Brooklyn,30628001012,80,50,30,4.01
2020,CB2020,047,3,Brooklyn,30628001013,42,8,34,1.37
2020,CB2020,047,3,Brooklyn,30628001014,88,61,27,2.92
2020,CB2020,047,3,Brooklyn,30628001015,37,17,20,1.79
2020,CB2020,047,3,Brooklyn,30628001016,48,14,34,1.42
2020,CB2020,047,3,Brooklyn,30628001017,67,27,40,1.42
2020,CB2020,047,3,Brooklyn,30628001018,56,4,52,1.42
2020,CB2020,047,3,Brooklyn,30628001019,66,31,35,1.41
2020,CB2020,047,3,Brooklyn,30628001020,45,34,11,1.43
2020,CB2020,047,3,Brooklyn,30628001021,49,26,23,1.4
2020,CB2020,047,3,Brooklyn,30628001022,40,35,5,1.42
2020,CB2020,047,3,Brooklyn,30628001023,44,35,9,1.42
2020,CB2020,047,3,Brooklyn,30628001024,39,17,22,1.41
2020,CB2020,047,3,Brooklyn,30628001025,42,13,29,1.44
2020,CB2020,047,3,Brooklyn,30628001026,0,0,0,0
2020,CB2020,047,3,Brooklyn,30628001027,59,37,22,2.22
2020,CB2020,047,3,Brooklyn,30628001028,57,32,25,1.57
2020,CB2020,047,3,Brooklyn,30628002000,108,53,55,3.26
2020,CB2020,047,3,Brooklyn,30628002001,78,42,36,2.36
2020,CB2020,047,3,Brooklyn,30628002002,119,46,73,2.66
2020,CB2020,047,3,Brooklyn,30628002003,96,65,31,2.36
2020,CB2020,047,3,Brooklyn,30628002004,55,29,26,1.77
2020,CB2020,047,3,Brooklyn,30628002005,49,17,32,1.42
2020,CB2020,047,3,Brooklyn,30628002006,93,37,56,1.42
2020,CB2020,047,3,Brooklyn,30628002007,51,11,40,1.43
2020,CB2020,047,3,Brooklyn,30628002008,75,39,36,1.43
2020,CB2020,047,3,Brooklyn,30628002009,52,9,43,1.4
2020,CB2020,047,3,Brooklyn,30628002010,39,27,12,1.04
2020,CB2020,047,3,Brooklyn,30628002011,51,43,8,1.43
2020,CB2020,047,3,Brooklyn,30628002012,55,37,18,1.42
2020,CB2020,047,3,Brooklyn,30628002013,94,48,46,1.78
2020,CB2020,047,3,Brooklyn,30628002014,42,7,35,1.79
2020,CB2020,047,3,Brooklyn,30628002015,45,22,23,1.41
2020,CB2020,047,3,Brooklyn,30628002016,53,29,24,1.43
2020,CB2020,047,3,Brooklyn,30628002017,35,7,28,1.42
2020,CB2020,047,3,Brooklyn,30628002018,58,24,34,1.41
2020,CB2020,047,3,Brooklyn,30628002019,28,12,16,1.43
2020,CB2020,047,3,Brooklyn,30628002020,0,0,0,0.5
2020,CB2020,047,3,Brooklyn,30628002021,22,10,12,1.43
2020,CB2020,047,3,Brooklyn,30628002022,0,0,0,0
2020,CB2020,047,3,Brooklyn,30628002023,0,0,0,1.6
2020,CB2020,047,3,Brooklyn,30628002024,11,0,11,1.14
2020,CB2020,047,3,Brooklyn,30628002025,0,0,0,4.72
2020,CB2020,047,3,Brooklyn,30628002026,0,0,0,5.75
2020,CB2020,047,3,Brooklyn,30628002027,28,17,11,0.99
2020,CB2020,047,3,Brooklyn,30628002028,22,10,12,1.26
2020,CB2020,047,3,Brooklyn,30628002029,13,7,6,3.42
2020,CB2020,047,3,Brooklyn,30628002030,42,22,20,1.4
2020,CB2020,047,3,Brooklyn,30628002031,11,7,4,10.89
2020,CB2020,047,3,Brooklyn,30628002032,0,0,0,3.1
2020,CB2020,047,3,Brooklyn,30628002033,0,0,0,2.48
2020,CB2020,047,3,Brooklyn,30628003000,49,21,28,1.81
2020,CB2020,047,3,Brooklyn,30628003001,54,24,30,1.35
2020,CB2020,047,3,Brooklyn,30628003002,43,24,19,1.34
2020,CB2020,047,3,Brooklyn,30628003003,49,17,32,1.34
2020,CB2020,047,3,Brooklyn,30628003004,50,19,31,1.34
2020,CB2020,047,3,Brooklyn,30628003005,55,37,18,1.34
2020,CB2020,047,3,Brooklyn,30628003006,58,27,31,1.52
2020,CB2020,047,3,Brooklyn,30628003007,29,23,6,1.51
2020,CB2020,047,3,Brooklyn,30628003008,38,18,20,1.35
2020,CB2020,047,3,Brooklyn,30628003009,48,10,38,3.07
2020,CB2020,047,3,Brooklyn,30628003010,11,2,9,0.43
2020,CB2020,047,3,Brooklyn,30628003011,24,8,16,0.85
2020,CB2020,047,3,Brooklyn,30628003012,0,0,0,0.04
2020,CB2020,047,3,Brooklyn,30628003013,14,11,3,0.58
2020,CB2020,047,3,Brooklyn,30628003014,2,1,1,0.61
2020,CB2020,047,3,Brooklyn,30628003015,15,4,11,0.26
2020,CB2020,047,3,Brooklyn,30628003016,54,27,27,2.56
2020,CB2020,047,3,Brooklyn,30628003017,66,25,41,1.65
2020,CB2020,047,3,Brooklyn,30628003018,71,26,45,1.57
2020,CB2020,047,3,Brooklyn,30628003019,31,14,17,1.37
2020,CB2020,047,3,Brooklyn,30628003020,47,28,19,1.17
2020,CB2020,047,3,Brooklyn,30628003021,41,25,16,1.01
2020,CB2020,047,3,Brooklyn,30628003022,42,33,9,1.03
2020,CB2020,047,3,Brooklyn,30628003023,12,7,5,0.42
2020,CB2020,047,3,Brooklyn,30628003024,21,12,9,0.69
2020,CB2020,047,3,Brooklyn,30628004000,15,7,8,1.18
2020,CB2020,047,3,Brooklyn,30628004001,64,32,32,1.49
2020,CB2020,047,3,Brooklyn,30628004002,49,32,17,1.1
2020,CB2020,047,3,Brooklyn,30628004003,41,16,25,1.1
2020,CB2020,047,3,Brooklyn,30628004004,49,32,17,1.1
2020,CB2020,047,3,Brooklyn,30628004005,44,17,27,1.1
2020,CB2020,047,3,Brooklyn,30628004006,63,24,39,1.36
2020,CB2020,047,3,Brooklyn,30628004007,0,0,0,0
2020,CB2020,047,3,Brooklyn,30628004008,59,15,44,1.1
2020,CB2020,047,3,Brooklyn,30628004009,55,31,24,1.09
2020,CB2020,047,3,Brooklyn,30628004010,39,27,12,1.1
2020,CB2020,047,3,Brooklyn,30628004011,47,27,20,1.1
2020,CB2020,047,3,Brooklyn,30628004012,39,15,24,1.1
2020,CB2020,047,3,Brooklyn,30628004013,51,35,16,1.47
2020,CB2020,047,3,Brooklyn,30628004014,42,28,14,1.47
2020,CB2020,047,3,Brooklyn,30628004015,64,45,19,1.47
2020,CB2020,047,3,Brooklyn,30628004016,59,16,43,1.45
2020,CB2020,047,3,Brooklyn,30628004017,68,30,38,1.49
2020,CB2020,047,3,Brooklyn,30628004018,67,33,34,1.98
2020,CB2020,047,3,Brooklyn,30628004019,55,20,35,1.72
2020,CB2020,047,3,Brooklyn,30628004020,70,27,43,1.66
2020,CB2020,047,3,Brooklyn,30628004021,40,21,19,1.1
2020,CB2020,047,3,Brooklyn,30628004022,34,14,20,0.83
2020,CB2020,047,3,Brooklyn,30628004023,75,29,46,1.52
2020,CB2020,047,3,Brooklyn,30628004024,57,35,22,1.54
2020,CB2020,047,3,Brooklyn,30628004025,130,38,92,4.96
2020,CB2020,047,3,Brooklyn,30628004026,0,0,0,0
2020,CB2020,047,3,Brooklyn,30628004027,53,33,20,1.77
2020,CB2020,047,3,Brooklyn,30628004028,57,43,14,1.54
2020,CB2020,047,3,Brooklyn,30628004029,59,20,39,1.75
2020,CB2020,047,3,Brooklyn,30632001000,408,185,223,4.61
2020,CB2020,047,3,Brooklyn,30632001001,264,112,152,5.01
2020,CB2020,047,3,Brooklyn,30632001002,135,64,71,5.08
2020,CB2020,047,3,Brooklyn,30632002000,220,122,98,4.63
2020,CB2020,047,3,Brooklyn,30632002001,222,110,112,4.58
2020,CB2020,047,3,Brooklyn,30632002002,227,108,119,5.11
2020,CB2020,047,3,Brooklyn,30636001000,243,140,103,4.66
2020,CB2020,047,3,Brooklyn,30636001001,235,102,133,4.65
2020,CB2020,047,3,Brooklyn,30636001002,213,102,111,4.64
2020,CB2020,047,3,Brooklyn,30636001003,198,108,90,5.03
2020,CB2020,047,3,Brooklyn,30636001004,195,88,107,4.61
2020,CB2020,047,3,Brooklyn,30636001005,233,142,91,4.66
2020,CB2020,047,3,Brooklyn,30638001000,117,61,56,3.22
2020,CB2020,047,3,Brooklyn,30638001001,55,37,18,1.76
2020,CB2020,047,3,Brooklyn,30638001002,229,89,140,4.65
2020,CB2020,047,3,Brooklyn,30638001003,274,137,137,4.68
2020,CB2020,047,3,Brooklyn,30638002000,237,133,104,5
2020,CB2020,047,3,Brooklyn,30638002001,285,120,165,5.05
2020,CB2020,047,3,Brooklyn,30638002002,219,95,124,5.03
2020,CB2020,047,3,Brooklyn,30638002003,201,103,98,5.01
2020,CB2020,047,3,Brooklyn,30640001000,240,124,116,4.66
2020,CB2020,047,3,Brooklyn,30640001001,273,161,112,4.65
2020,CB2020,047,3,Brooklyn,30640001002,246,111,135,4.66
2020,CB2020,047,3,Brooklyn,30640001003,175,85,90,5
2020,CB2020,047,3,Brooklyn,30640002000,85,46,39,2.81
2020,CB2020,047,3,Brooklyn,30640002001,42,38,4,2.19
2020,CB2020,047,3,Brooklyn,30640002002,178,97,81,4.67
2020,CB2020,047,3,Brooklyn,30640002003,205,120,85,4.65
2020,CB2020,047,3,Brooklyn,30640002004,176,56,120,4.61
2020,CB2020,047,3,Brooklyn,30642001000,458,221,237,9.22
2020,CB2020,047,3,Brooklyn,30642001001,489,268,221,7.11
2020,CB2020,047,3,Brooklyn,30642001002,111,46,65,4.7
2020,CB2020,047,3,Brooklyn,30642001003,348,176,172,5.22
2020,CB2020,047,3,Brooklyn,30642001004,100,52,48,4.72
2020,CB2020,047,3,Brooklyn,30642001005,0,0,0,9.61
2020,CB2020,047,3,Brooklyn,30642002000,419,214,205,6.26
2020,CB2020,047,3,Brooklyn,30642002001,416,193,223,4.93
2020,CB2020,047,3,Brooklyn,30642002002,285,138,147,2.2
2020,CB2020,047,3,Brooklyn,30642002003,239,120,119,4.11
2020,CB2020,047,3,Brooklyn,30644001000,530,271,259,7.06
2020,CB2020,047,3,Brooklyn,30644001001,476,226,250,6.46
2020,CB2020,047,3,Brooklyn,30644001002,277,130,147,6
2020,CB2020,047,3,Brooklyn,30644001003,59,23,36,1.25
2020,CB2020,047,3,Brooklyn,30644001004,42,15,27,1.65
2020,CB2020,047,3,Brooklyn,30644001005,0,0,0,0.38
2020,CB2020,047,3,Brooklyn,30644002000,61,32,29,2.45
2020,CB2020,047,3,Brooklyn,30644003000,298,143,155,4.64
2020,CB2020,047,3,Brooklyn,30644003001,344,158,186,4.66
2020,CB2020,047,3,Brooklyn,30644003002,187,86,101,4.98
2020,CB2020,047,3,Brooklyn,30644003003,98,53,45,3.22
2020,CB2020,047,3,Brooklyn,30644003004,50,25,25,1.79
2020,CB2020,047,3,Brooklyn,30644003005,280,155,125,4.7
2020,CB2020,047,3,Brooklyn,30646001000,321,147,174,4.9
2020,CB2020,047,3,Brooklyn,30646001001,265,113,152,5.01
2020,CB2020,047,3,Brooklyn,30646001002,212,109,103,4.82
2020,CB2020,047,3,Brooklyn,30646001003,179,104,75,4.86
2020,CB2020,047,3,Brooklyn,30646002000,306,159,147,5.57
2020,CB2020,047,3,Brooklyn,30646002001,528,275,253,6.45
2020,CB2020,047,3,Brooklyn,30646002002,142,74,68,4.67
2020,CB2020,047,3,Brooklyn,30646002003,273,120,153,4.65
2020,CB2020,047,3,Brooklyn,30648001000,94,65,29,3.12
2020,CB2020,047,3,Brooklyn,30648001001,108,39,69,1.59
2020,CB2020,047,3,Brooklyn,30648001002,319,151,168,4.73
2020,CB2020,047,3,Brooklyn,30648001003,337,179,158,4.7
2020,CB2020,047,3,Brooklyn,30648001004,335,136,199,4.7
2020,CB2020,047,3,Brooklyn,30648002000,203,107,96,4.65
2020,CB2020,047,3,Brooklyn,30648002001,203,105,98,4.66
2020,CB2020,047,3,Brooklyn,30648002002,178,94,84,4.66
2020,CB2020,047,3,Brooklyn,30648002003,216,98,118,4.64
2020,CB2020,047,3,Brooklyn,30650001000,53,29,24,5.04
2020,CB2020,047,3,Brooklyn,30650001001,58,31,27,4.74
2020,CB2020,047,3,Brooklyn,30650001002,151,74,77,4.67
2020,CB2020,047,3,Brooklyn,30650001003,193,86,107,5.02
2020,CB2020,047,3,Brooklyn,30650002000,151,99,52,4.4
2020,CB2020,047,3,Brooklyn,30650002001,194,87,107,3.22
2020,CB2020,047,3,Brooklyn,30650002002,97,32,65,1.16
2020,CB2020,047,3,Brooklyn,30650002003,83,37,46,1.32
2020,CB2020,047,3,Brooklyn,30650002004,113,46,67,3.18
2020,CB2020,047,3,Brooklyn,30650002005,281,121,160,5.45
2020,CB2020,047,3,Brooklyn,30650002006,65,32,33,2.15
2020,CB2020,047,3,Brooklyn,30650002007,0,0,0,0.73
2020,CB2020,047,3,Brooklyn,30652001000,72,30,42,4.99
2020,CB2020,047,3,Brooklyn,30652001001,170,84,86,4.66
2020,CB2020,047,3,Brooklyn,30652001002,167,88,79,4.66
2020,CB2020,047,3,Brooklyn,30652001003,68,24,44,4.66
2020,CB2020,047,3,Brooklyn,30652001004,186,71,115,4.66
2020,CB2020,047,3,Brooklyn,30652001005,134,74,60,4.99
2020,CB2020,047,3,Brooklyn,30652001006,107,45,62,5.25
2020,CB2020,047,3,Brooklyn,30652001007,144,51,93,4.66
2020,CB2020,047,3,Brooklyn,30652001008,149,106,43,4.65
2020,CB2020,047,3,Brooklyn,30654001000,163,76,87,4.65
2020,CB2020,047,3,Brooklyn,30654001001,210,98,112,4.67
2020,CB2020,047,3,Brooklyn,30654001002,241,112,129,4.65
2020,CB2020,047,3,Brooklyn,30654001003,195,104,91,4.66
2020,CB2020,047,3,Brooklyn,30654002000,218,110,108,4.67
2020,CB2020,047,3,Brooklyn,30654002001,183,70,113,4.66
2020,CB2020,047,3,Brooklyn,30654002002,239,114,125,4.66
2020,CB2020,047,3,Brooklyn,30654002003,232,123,109,4.83
2020,CB2020,047,3,Brooklyn,30656001000,247,129,118,4.62
2020,CB2020,047,3,Brooklyn,30656001001,210,123,87,4.85
2020,CB2020,047,3,Brooklyn,30656001002,211,94,117,4.84
2020,CB2020,047,3,Brooklyn,30656001003,220,80,140,4.65
2020,CB2020,047,3,Brooklyn,30656002000,245,122,123,4.64
2020,CB2020,047,3,Brooklyn,30656002001,216,115,101,4.85
2020,CB2020,047,3,Brooklyn,30656002002,224,76,148,4.85
2020,CB2020,047,3,Brooklyn,30656002003,222,114,108,4.65
2020,CB2020,047,3,Brooklyn,30658001000,175,85,90,4.84
2020,CB2020,047,3,Brooklyn,30658001001,234,125,109,4.67
2020,CB2020,047,3,Brooklyn,30658001002,253,107,146,4.65
2020,CB2020,047,3,Brooklyn,30658001003,216,97,119,4.85
2020,CB2020,047,3,Brooklyn,30658002000,243,109,134,4.88
2020,CB2020,047,3,Brooklyn,30658002001,246,144,102,4.68
2020,CB2020,047,3,Brooklyn,30658002002,233,106,127,4.67
2020,CB2020,047,3,Brooklyn,30658002003,244,112,132,4.65
2020,CB2020,047,3,Brooklyn,30660001000,167,80,87,4.66
2020,CB2020,047,3,Brooklyn,30660001001,241,112,129,4.65
2020,CB2020,047,3,Brooklyn,30660001002,218,96,122,4.65
2020,CB2020,047,3,Brooklyn,30660001003,233,123,110,4.84
2020,CB2020,047,3,Brooklyn,30660002000,242,109,133,4.67
2020,CB2020,047,3,Brooklyn,30660002001,259,123,136,4.68
2020,CB2020,047,3,Brooklyn,30660002002,203,111,92,4.64
2020,CB2020,047,3,Brooklyn,30660002003,199,87,112,4.83
2020,CB2020,047,3,Brooklyn,30662001000,98,41,57,5.51
2020,CB2020,047,3,Brooklyn,30662001001,202,82,120,4.65
2020,CB2020,047,3,Brooklyn,30662001002,193,94,99,4.66
2020,CB2020,047,3,Brooklyn,30662001003,166,78,88,4.66
2020,CB2020,047,3,Brooklyn,30662001004,208,125,83,4.69
2020,CB2020,047,3,Brooklyn,30662001005,74,17,57,5.74
2020,CB2020,047,3,Brooklyn,30662001006,0,0,0,5.59
2020,CB2020,047,3,Brooklyn,30662001007,106,55,51,4.65
2020,CB2020,047,3,Brooklyn,30662001008,16,9,7,4.63
2020,CB2020,047,3,Brooklyn,30662001009,180,83,97,4.64
2020,CB2020,047,3,Brooklyn,30662001010,254,115,139,4.62
2020,CB2020,047,3,Brooklyn,30662001011,0,0,0,3.16
2020,CB2020,047,3,Brooklyn,30666000001,0,0,0,0
2020,CB2020,047,3,Brooklyn,30666000002,0,0,0,0
2020,CB2020,047,3,Brooklyn,30666001000,0,0,0,491.62
2020,CB2020,047,3,Brooklyn,30666001001,1,0,1,81.58
2020,CB2020,047,3,Brooklyn,30666001002,0,0,0,8.57
2020,CB2020,047,3,Brooklyn,30666001003,0,0,0,228.81
2020,CB2020,047,3,Brooklyn,30666001004,0,0,0,0
2020,CB2020,047,3,Brooklyn,30666001005,0,0,0,80.95
2020,CB2020,047,3,Brooklyn,30666001006,0,0,0,9.99
2020,CB2020,047,3,Brooklyn,30666001007,0,0,0,26.79
2020,CB2020,047,3,Brooklyn,30666001008,0,0,0,2.46
2020,CB2020,047,3,Brooklyn,30666001009,0,0,0,1.01
2020,CB2020,047,3,Brooklyn,30666001010,0,0,0,4.05
2020,CB2020,047,3,Brooklyn,30666001011,0,0,0,59.96
2020,CB2020,047,3,Brooklyn,30666001012,0,0,0,2.9
2020,CB2020,047,3,Brooklyn,30666001013,0,0,0,1.33
2020,CB2020,047,3,Brooklyn,30670001000,157,56,101,3.22
2020,CB2020,047,3,Brooklyn,30670001001,256,111,145,3.09
2020,CB2020,047,3,Brooklyn,30670001002,112,44,68,3.38
2020,CB2020,047,3,Brooklyn,30670001003,0,0,0,1.02
2020,CB2020,047,3,Brooklyn,30670001004,137,53,84,3.09
2020,CB2020,047,3,Brooklyn,30670001005,154,90,64,2.96
2020,CB2020,047,3,Brooklyn,30670002000,159,73,86,2.63
2020,CB2020,047,3,Brooklyn,30670002001,96,47,49,3.11
2020,CB2020,047,3,Brooklyn,30670002002,149,75,74,3.22
2020,CB2020,047,3,Brooklyn,30670002003,77,43,34,1.79
2020,CB2020,047,3,Brooklyn,30670002004,0,0,0,0.53
2020,CB2020,047,3,Brooklyn,30670002005,439,188,251,4.81
2020,CB2020,047,3,Brooklyn,30670002006,312,131,181,4.76
2020,CB2020,047,3,Brooklyn,30670002007,455,222,233,4.65
2020,CB2020,047,3,Brooklyn,30670002008,239,111,128,4.28
2020,CB2020,047,3,Brooklyn,30670002009,0,0,0,0.46
2020,CB2020,047,3,Brooklyn,30670002010,65,34,31,2.47
2020,CB2020,047,3,Brooklyn,30670002011,69,34,35,1.98
2020,CB2020,047,3,Brooklyn,30672001000,204,109,95,5.19
2020,CB2020,047,3,Brooklyn,30672001001,292,136,156,4.81
2020,CB2020,047,3,Brooklyn,30672001002,279,116,163,5.26
2020,CB2020,047,3,Brooklyn,30672001003,240,126,114,5.66
2020,CB2020,047,3,Brooklyn,30672001004,0,0,0,5.48
2020,CB2020,047,3,Brooklyn,30672001005,273,122,151,5.11
2020,CB2020,047,3,Brooklyn,30672001006,147,61,86,4.42
2020,CB2020,047,3,Brooklyn,30672001007,0,0,0,5.01
2020,CB2020,047,3,Brooklyn,30672001008,0,0,0,2.12
2020,CB2020,047,3,Brooklyn,30674001000,257,102,155,4.99
2020,CB2020,047,3,Brooklyn,30674001001,230,110,120,5.46
2020,CB2020,047,3,Brooklyn,30674001002,314,148,166,5.24
2020,CB2020,047,3,Brooklyn,30674001003,223,86,137,5.19
2020,CB2020,047,3,Brooklyn,30674001004,0,0,0,0.27
2020,CB2020,047,3,Brooklyn,30674001005,51,28,23,2.19
2020,CB2020,047,3,Brooklyn,30674002000,188,73,115,4.99
2020,CB2020,047,3,Brooklyn,30674002001,221,110,111,4.85
2020,CB2020,047,3,Brooklyn,30674002002,225,113,112,5.25
2020,CB2020,047,3,Brooklyn,30674002003,228,124,104,5.46
2020,CB2020,047,3,Brooklyn,30674002004,55,14,41,2.87
2020,CB2020,047,3,Brooklyn,30676001000,225,105,120,3.84
2020,CB2020,047,3,Brooklyn,30676001001,148,56,92,2.59
2020,CB2020,047,3,Brooklyn,30676001002,274,111,163,4.96
2020,CB2020,047,3,Brooklyn,30676001003,245,120,125,5.1
2020,CB2020,047,3,Brooklyn,30676002000,40,17,23,1.55
2020,CB2020,047,3,Brooklyn,30676002001,0,0,0,0.32
2020,CB2020,047,3,Brooklyn,30676002002,90,39,51,5.28
2020,CB2020,047,3,Brooklyn,30676002003,131,48,83,5.32
2020,CB2020,047,3,Brooklyn,30676002004,228,99,129,4.03
2020,CB2020,047,3,Brooklyn,30676002005,131,60,71,3
2020,CB2020,047,3,Brooklyn,30676002006,84,54,30,1.8
2020,CB2020,047,3,Brooklyn,30676002007,26,10,16,0.58
2020,CB2020,047,3,Brooklyn,30678001000,441,177,264,5.28
2020,CB2020,047,3,Brooklyn,30678001001,447,215,232,5.29
2020,CB2020,047,3,Brooklyn,30678001002,391,178,213,5.1
2020,CB2020,047,3,Brooklyn,30678001003,354,175,179,5.01
2020,CB2020,047,3,Brooklyn,30678002000,412,191,221,5.14
2020,CB2020,047,3,Brooklyn,30678002001,268,124,144,5.15
2020,CB2020,047,3,Brooklyn,30678002002,286,133,153,4.96
2020,CB2020,047,3,Brooklyn,30678002003,275,106,169,5.15
2020,CB2020,047,3,Brooklyn,30680001000,270,119,151,4.99
2020,CB2020,047,3,Brooklyn,30680001001,276,119,157,4.95
2020,CB2020,047,3,Brooklyn,30680001002,141,73,68,4.82
2020,CB2020,047,3,Brooklyn,30680001003,175,76,99,5.17
2020,CB2020,047,3,Brooklyn,30680002000,260,93,167,5.45
2020,CB2020,047,3,Brooklyn,30680002001,283,162,121,5.44
2020,CB2020,047,3,Brooklyn,30680002002,286,140,146,5.26
2020,CB2020,047,3,Brooklyn,30680002003,196,103,93,5.65
2020,CB2020,047,3,Brooklyn,30682001000,271,118,153,5.29
2020,CB2020,047,3,Brooklyn,30682001001,222,105,117,5.3
2020,CB2020,047,3,Brooklyn,30682001002,237,112,125,5.09
2020,CB2020,047,3,Brooklyn,30682001003,195,96,99,5.48
2020,CB2020,047,3,Brooklyn,30682001004,295,155,140,5.01
2020,CB2020,047,3,Brooklyn,30682002000,263,97,166,4.84
2020,CB2020,047,3,Brooklyn,30682002001,287,110,177,4.66
2020,CB2020,047,3,Brooklyn,30682002002,204,100,104,4.84
2020,CB2020,047,3,Brooklyn,30682002003,267,132,135,4.84
2020,CB2020,047,3,Brooklyn,30682002004,248,123,125,4.63
2020,CB2020,047,3,Brooklyn,30686001000,100,45,55,2.84
2020,CB2020,047,3,Brooklyn,30686001001,0,0,0,0.34
2020,CB2020,047,3,Brooklyn,30686001002,286,137,149,4.65
2020,CB2020,047,3,Brooklyn,30686001003,178,91,87,5.16
2020,CB2020,047,3,Brooklyn,30686001004,200,68,132,4.55
2020,CB2020,047,3,Brooklyn,30686002000,112,61,51,4.74
2020,CB2020,047,3,Brooklyn,30686002001,252,116,136,4.86
2020,CB2020,047,3,Brooklyn,30686002002,292,135,157,4.78
2020,CB2020,047,3,Brooklyn,30686002003,329,133,196,4.65
2020,CB2020,047,3,Brooklyn,30688001000,66,20,46,2.11
2020,CB2020,047,3,Brooklyn,30688001001,246,117,129,5.11
2020,CB2020,047,3,Brooklyn,30688001002,198,104,94,5.1
2020,CB2020,047,3,Brooklyn,30688001003,221,115,106,5.28
2020,CB2020,047,3,Brooklyn,30688001004,138,71,67,3.39
2020,CB2020,047,3,Brooklyn,30688002000,105,47,58,2.9
2020,CB2020,047,3,Brooklyn,30688002001,188,89,99,3.71
2020,CB2020,047,3,Brooklyn,30688002002,276,120,156,4.61
2020,CB2020,047,3,Brooklyn,30688002003,225,93,132,4.83
2020,CB2020,047,3,Brooklyn,30688002004,43,18,25,1.44
2020,CB2020,047,3,Brooklyn,30688002005,0,0,0,0.31
2020,CB2020,047,3,Brooklyn,30690001000,166,90,76,5.63
2020,CB2020,047,3,Brooklyn,30690001001,267,112,155,5.26
2020,CB2020,047,3,Brooklyn,30690001002,272,113,159,5.25
2020,CB2020,047,3,Brooklyn,30690001003,131,58,73,5.45
2020,CB2020,047,3,Brooklyn,30690002000,277,130,147,5.46
2020,CB2020,047,3,Brooklyn,30690002001,265,127,138,5.26
2020,CB2020,047,3,Brooklyn,30690002002,273,126,147,5.1
2020,CB2020,047,3,Brooklyn,30690002003,62,26,36,2.33
2020,CB2020,047,3,Brooklyn,30690002004,167,66,101,2.98
2020,CB2020,047,3,Brooklyn,30692001000,251,114,137,5.59
2020,CB2020,047,3,Brooklyn,30692001001,51,21,30,4.96
2020,CB2020,047,3,Brooklyn,30692001002,420,196,224,4.95
2020,CB2020,047,3,Brooklyn,30692001003,241,113,128,4.81
2020,CB2020,047,3,Brooklyn,30692001004,237,91,146,4.8
2020,CB2020,047,3,Brooklyn,30692001005,409,207,202,5.14
2020,CB2020,047,3,Brooklyn,30692002000,385,171,214,4.99
2020,CB2020,047,3,Brooklyn,30692002001,262,127,135,4.99
2020,CB2020,047,3,Brooklyn,30692002002,256,90,166,4.8
2020,CB2020,047,3,Brooklyn,30696011000,0,0,0,2.55
2020,CB2020,047,3,Brooklyn,30696011001,107,49,58,13.39
2020,CB2020,047,3,Brooklyn,30696011002,240,111,129,5.89
2020,CB2020,047,3,Brooklyn,30696011003,354,160,194,6.35
2020,CB2020,047,3,Brooklyn,30696011004,438,190,248,6.36
2020,CB2020,047,3,Brooklyn,30696011005,382,184,198,6.35
2020,CB2020,047,3,Brooklyn,30696011006,25,4,21,3.55
2020,CB2020,047,3,Brooklyn,30696012000,0,0,0,0
2020,CB2020,047,3,Brooklyn,30696012001,74,43,31,41.43
2020,CB2020,047,3,Brooklyn,30696012002,348,146,202,4.81
2020,CB2020,047,3,Brooklyn,30696012003,355,135,220,4.28
2020,CB2020,047,3,Brooklyn,30696012004,493,263,230,5.29
2020,CB2020,047,3,Brooklyn,30696012005,526,274,252,5.39
2020,CB2020,047,3,Brooklyn,30696012006,364,175,189,4.22
2020,CB2020,047,3,Brooklyn,30696012007,226,77,149,3.06
2020,CB2020,047,3,Brooklyn,30696021000,95,25,70,4.04
2020,CB2020,047,3,Brooklyn,30696021001,273,147,126,4.49
2020,CB2020,047,3,Brooklyn,30696021002,24,9,15,0.59
2020,CB2020,047,3,Brooklyn,30696021003,74,46,28,1.77
2020,CB2020,047,3,Brooklyn,30696021004,124,70,54,2.9
2020,CB2020,047,3,Brooklyn,30696021005,218,98,120,4.7
2020,CB2020,047,3,Brooklyn,30696021006,215,113,102,4.61
2020,CB2020,047,3,Brooklyn,30696022000,321,149,172,9.06
2020,CB2020,047,3,Brooklyn,30696022001,181,78,103,5.19
2020,CB2020,047,3,Brooklyn,30696022002,186,75,111,4.69
2020,CB2020,047,3,Brooklyn,30696022003,215,115,100,3.95
2020,CB2020,047,3,Brooklyn,30696022004,229,108,121,4.72
2020,CB2020,047,3,Brooklyn,30696022005,265,121,144,5.3
2020,CB2020,047,3,Brooklyn,30696022006,157,81,76,4.74
2020,CB2020,047,3,Brooklyn,30696022007,196,72,124,4.62
2020,CB2020,047,3,Brooklyn,30696022008,225,124,101,4.66
2020,CB2020,047,3,Brooklyn,30696022009,89,55,34,2.41
2020,CB2020,047,3,Brooklyn,30696022010,0,0,0,6.09
2020,CB2020,047,3,Brooklyn,30696022011,268,142,126,5.21
2020,CB2020,047,3,Brooklyn,30696022012,0,0,0,0.63
2020,CB2020,047,3,Brooklyn,30696022013,35,6,29,0.84
2020,CB2020,047,3,Brooklyn,30696022014,23,9,14,2.47
2020,CB2020,047,3,Brooklyn,30696023000,0,0,0,0
2020,CB2020,047,3,Brooklyn,30696023001,0,0,0,12.7
2020,CB2020,047,3,Brooklyn,30696023002,332,129,203,4.01
2020,CB2020,047,3,Brooklyn,30696023003,431,222,209,4.19
2020,CB2020,047,3,Brooklyn,30696023004,884,416,468,11.17
2020,CB2020,047,3,Brooklyn,30696023005,341,158,183,5.52
2020,CB2020,047,3,Brooklyn,30696023006,0,0,0,18.53
2020,CB2020,047,3,Brooklyn,30696023007,145,84,61,4.92
2020,CB2020,047,3,Brooklyn,30696023008,193,103,90,10.78
2020,CB2020,047,3,Brooklyn,30696023009,162,80,82,2.31
2020,CB2020,047,3,Brooklyn,30696023010,243,100,143,4.07
2020,CB2020,047,3,Brooklyn,30696023011,131,58,73,4.18
2020,CB2020,047,3,Brooklyn,30698001000,161,88,73,3.79
2020,CB2020,047,3,Brooklyn,30698001001,29,13,16,1.64
2020,CB2020,047,3,Brooklyn,30698001002,0,0,0,1.24
2020,CB2020,047,3,Brooklyn,30698001003,125,67,58,4.35
2020,CB2020,047,3,Brooklyn,30698001004,130,44,86,3.29
2020,CB2020,047,3,Brooklyn,30698001005,222,123,99,4.65
2020,CB2020,047,3,Brooklyn,30698002000,109,56,53,4.65
2020,CB2020,047,3,Brooklyn,30698002001,186,98,88,5
2020,CB2020,047,3,Brooklyn,30698002002,33,20,13,5.05
2020,CB2020,047,3,Brooklyn,30698002003,13,5,8,4.58
2020,CB2020,047,3,Brooklyn,30698002004,160,72,88,4.59
2020,CB2020,047,3,Brooklyn,30698002005,49,24,25,63.23
2020,CB2020,047,3,Brooklyn,30698002006,0,0,0,0
2020,CB2020,047,3,Brooklyn,30698002007,175,69,106,16.69
2020,CB2020,047,3,Brooklyn,30698002008,25,9,16,0.87
2020,CB2020,047,3,Brooklyn,30700001000,116,69,47,4.84
2020,CB2020,047,3,Brooklyn,30700001001,129,45,84,4.66
2020,CB2020,047,3,Brooklyn,30700001002,150,72,78,4.24
2020,CB2020,047,3,Brooklyn,30700001003,161,77,84,4.26
2020,CB2020,047,3,Brooklyn,30700001004,120,55,65,4.65
2020,CB2020,047,3,Brooklyn,30700002000,163,84,79,3.94
2020,CB2020,047,3,Brooklyn,30700002001,67,36,31,2.82
2020,CB2020,047,3,Brooklyn,30700002002,50,15,35,1.79
2020,CB2020,047,3,Brooklyn,30700002003,4,1,3,2.76
2020,CB2020,047,3,Brooklyn,30700002004,0,0,0,1.44
2020,CB2020,047,3,Brooklyn,30700002005,0,0,0,0.29
2020,CB2020,047,3,Brooklyn,30700002006,101,49,52,4.65
2020,CB2020,047,3,Brooklyn,30700002007,186,83,103,4.65
2020,CB2020,047,3,Brooklyn,30700002008,403,184,219,4.9
2020,CB2020,047,3,Brooklyn,30702011000,0,0,0,4.81
2020,CB2020,047,3,Brooklyn,30702011001,126,70,56,4.73
2020,CB2020,047,3,Brooklyn,30702011002,94,53,41,4.94
2020,CB2020,047,3,Brooklyn,30702011003,102,26,76,16.51
2020,CB2020,047,3,Brooklyn,30702011004,76,34,42,4.45
2020,CB2020,047,3,Brooklyn,30702011005,68,35,33,4.45
2020,CB2020,047,3,Brooklyn,30702011006,78,26,52,4.01
2020,CB2020,047,3,Brooklyn,30702011007,54,25,29,3.89
2020,CB2020,047,3,Brooklyn,30702011008,0,0,0,8.56
2020,CB2020,047,3,Brooklyn,30702011009,56,24,32,2.32
2020,CB2020,047,3,Brooklyn,30702011010,39,23,16,2.96
2020,CB2020,047,3,Brooklyn,30702011011,80,42,38,3.67
2020,CB2020,047,3,Brooklyn,30702012000,56,10,46,3.91
2020,CB2020,047,3,Brooklyn,30702012001,84,54,30,5.31
2020,CB2020,047,3,Brooklyn,30702012002,73,28,45,5.34
2020,CB2020,047,3,Brooklyn,30702012003,64,17,47,3.77
2020,CB2020,047,3,Brooklyn,30702012004,70,32,38,4.43
2020,CB2020,047,3,Brooklyn,30702012005,121,78,43,3.76
2020,CB2020,047,3,Brooklyn,30702012006,138,51,87,3.19
2020,CB2020,047,3,Brooklyn,30702012007,132,73,59,2.62
2020,CB2020,047,3,Brooklyn,30702012008,47,33,14,3.84
2020,CB2020,047,3,Brooklyn,30702012009,47,24,23,2.35
2020,CB2020,047,3,Brooklyn,30702012010,32,19,13,2.41
2020,CB2020,047,3,Brooklyn,30702012011,32,22,10,2.19
2020,CB2020,047,3,Brooklyn,30702013000,113,66,47,8.89
2020,CB2020,047,3,Brooklyn,30702013001,42,14,28,1.78
2020,CB2020,047,3,Brooklyn,30702013002,40,10,30,2.09
2020,CB2020,047,3,Brooklyn,30702013003,75,45,30,3.49
2020,CB2020,047,3,Brooklyn,30702013004,139,50,89,6.39
2020,CB2020,047,3,Brooklyn,30702013005,110,53,57,5.04
2020,CB2020,047,3,Brooklyn,30702013006,74,38,36,3.61
2020,CB2020,047,3,Brooklyn,30702013007,44,4,40,2.2
2020,CB2020,047,3,Brooklyn,30702013008,38,9,29,2.22
2020,CB2020,047,3,Brooklyn,30702013009,39,20,19,2.61
2020,CB2020,047,3,Brooklyn,30702013010,88,51,37,4.02
2020,CB2020,047,3,Brooklyn,30702013011,114,77,37,5.99
2020,CB2020,047,3,Brooklyn,30702013012,0,0,0,0
2020,CB2020,047,3,Brooklyn,30702013013,19,1,18,1.4
2020,CB2020,047,3,Brooklyn,30702013014,61,42,19,3.12
2020,CB2020,047,3,Brooklyn,30702013015,34,18,16,3.71
2020,CB2020,047,3,Brooklyn,30702013016,8,6,2,1.22
2020,CB2020,047,3,Brooklyn,30702014000,118,57,61,4.47
2020,CB2020,047,3,Brooklyn,30702014001,97,38,59,3.84
2020,CB2020,047,3,Brooklyn,30702014002,96,19,77,3.34
2020,CB2020,047,3,Brooklyn,30702014003,158,83,75,2.87
2020,CB2020,047,3,Brooklyn,30702014004,167,72,95,4.17
2020,CB2020,047,3,Brooklyn,30702014005,202,116,86,4.03
2020,CB2020,047,3,Brooklyn,30702014006,181,84,97,3.35
2020,CB2020,047,3,Brooklyn,30702014007,101,47,54,2.97
2020,CB2020,047,3,Brooklyn,30702014008,244,128,116,4.46
2020,CB2020,047,3,Brooklyn,30702014009,202,97,105,4.73
2020,CB2020,047,3,Brooklyn,30702014010,220,127,93,5.08
2020,CB2020,047,3,Brooklyn,30702014011,152,80,72,5.53
2020,CB2020,047,3,Brooklyn,30702015000,363,188,175,5.5
2020,CB2020,047,3,Brooklyn,30702015001,270,120,150,10.51
2020,CB2020,047,3,Brooklyn,30702015002,115,52,63,5.25
2020,CB2020,047,3,Brooklyn,30702015003,216,91,125,5.76
2020,CB2020,047,3,Brooklyn,30702015004,19,11,8,1.52
2020,CB2020,047,3,Brooklyn,30702015005,92,47,45,4.11
2020,CB2020,047,3,Brooklyn,30702015006,358,169,189,5.57
2020,CB2020,047,3,Brooklyn,30702015007,257,144,113,5.53
2020,CB2020,047,3,Brooklyn,30702015008,361,172,189,5.55
2020,CB2020,047,3,Brooklyn,30702015009,0,0,0,0
2020,CB2020,047,3,Brooklyn,30702015010,23,9,14,1.07
2020,CB2020,047,3,Brooklyn,30702020001,0,0,0,0
2020,CB2020,047,3,Brooklyn,30702021000,21,7,14,1133.57
2020,CB2020,047,3,Brooklyn,30702021001,0,0,0,1.04
2020,CB2020,047,3,Brooklyn,30702021002,0,0,0,5.55
2020,CB2020,047,3,Brooklyn,30702021003,0,0,0,4.37
2020,CB2020,047,3,Brooklyn,30702021004,0,0,0,0
2020,CB2020,047,3,Brooklyn,30702021005,0,0,0,0
2020,CB2020,047,3,Brooklyn,30702021006,0,0,0,131.14
2020,CB2020,047,3,Brooklyn,30702030001,0,0,0,0
2020,CB2020,047,3,Brooklyn,30702031000,0,0,0,649.9
2020,CB2020,047,3,Brooklyn,30702031001,0,0,0,0
2020,CB2020,047,3,Brooklyn,30702031002,0,0,0,0
2020,CB2020,047,3,Brooklyn,30702031003,0,0,0,0
2020,CB2020,047,3,Brooklyn,30702031004,0,0,0,0
2020,CB2020,047,3,Brooklyn,30702031005,0,0,0,0.45
2020,CB2020,047,3,Brooklyn,30702031006,0,0,0,0
2020,CB2020,047,3,Brooklyn,30702031007,0,0,0,0
2020,CB2020,047,3,Brooklyn,30702031008,0,0,0,7.07
2020,CB2020,047,3,Brooklyn,30702031009,0,0,0,37.97
2020,CB2020,047,3,Brooklyn,30702031010,0,0,0,0
2020,CB2020,047,3,Brooklyn,30706011000,145,81,64,5.07
2020,CB2020,047,3,Brooklyn,30706011001,120,70,50,4.83
2020,CB2020,047,3,Brooklyn,30706011002,97,49,48,4.66
2020,CB2020,047,3,Brooklyn,30706011003,94,26,68,4.66
2020,CB2020,047,3,Brooklyn,30706011004,125,46,79,4.83
2020,CB2020,047,3,Brooklyn,30706011005,102,40,62,5.09
2020,CB2020,047,3,Brooklyn,30706011006,13,7,6,0.81
2020,CB2020,047,3,Brooklyn,30706011007,73,39,34,2.45
2020,CB2020,047,3,Brooklyn,30706011008,138,72,66,3.37
2020,CB2020,047,3,Brooklyn,30706012000,133,62,71,4.66
2020,CB2020,047,3,Brooklyn,30706012001,114,38,76,4.64
2020,CB2020,047,3,Brooklyn,30706012002,143,54,89,4.65
2020,CB2020,047,3,Brooklyn,30706012003,95,58,37,4.79
2020,CB2020,047,3,Brooklyn,30706012004,161,80,81,4.65
2020,CB2020,047,3,Brooklyn,30706012005,124,55,69,4.66
2020,CB2020,047,3,Brooklyn,30706012006,106,44,62,3.39
2020,CB2020,047,3,Brooklyn,30706012007,128,62,66,3.4
2020,CB2020,047,3,Brooklyn,30706012008,157,78,79,3.4
2020,CB2020,047,3,Brooklyn,30706012009,155,59,96,4.66
2020,CB2020,047,3,Brooklyn,30706012010,205,109,96,4.73
2020,CB2020,047,3,Brooklyn,30706012011,0,0,0,15.79
2020,CB2020,047,3,Brooklyn,30706012012,169,72,97,9.49
2020,CB2020,047,3,Brooklyn,30706012013,0,0,0,0
2020,CB2020,047,3,Brooklyn,30706012014,106,60,46,3.37
2020,CB2020,047,3,Brooklyn,30706020001,0,0,0,0
2020,CB2020,047,3,Brooklyn,30706020002,0,0,0,0
2020,CB2020,047,3,Brooklyn,30706020003,0,0,0,0
2020,CB2020,047,3,Brooklyn,30706021000,0,0,0,9.2
2020,CB2020,047,3,Brooklyn,30706021001,4,3,1,112.29
2020,CB2020,047,3,Brooklyn,30706021002,0,0,0,0
2020,CB2020,047,3,Brooklyn,30706021003,0,0,0,0
2020,CB2020,047,3,Brooklyn,30706021004,0,0,0,174.24
2020,CB2020,047,3,Brooklyn,30720001000,0,0,0,7.15
2020,CB2020,047,3,Brooklyn,30720001001,192,85,107,5.48
2020,CB2020,047,3,Brooklyn,30720001002,229,91,138,4.37
2020,CB2020,047,3,Brooklyn,30720001003,112,52,60,3.33
2020,CB2020,047,3,Brooklyn,30720001004,73,37,36,2.13
2020,CB2020,047,3,Brooklyn,30720001005,39,22,17,0.97
2020,CB2020,047,3,Brooklyn,30720001006,539,240,299,5.09
2020,CB2020,047,3,Brooklyn,30720001007,525,221,304,5.12
2020,CB2020,047,3,Brooklyn,30720001008,496,199,297,5.47
2020,CB2020,047,3,Brooklyn,30722001000,0,0,0,3.89
2020,CB2020,047,3,Brooklyn,30722001001,0,0,0,0.75
2020,CB2020,047,3,Brooklyn,30722001002,249,117,132,4.47
2020,CB2020,047,3,Brooklyn,30722001003,418,189,229,5.16
2020,CB2020,047,3,Brooklyn,30722001004,333,121,212,5.31
2020,CB2020,047,3,Brooklyn,30722001005,341,158,183,5.3
2020,CB2020,047,3,Brooklyn,30722001006,0,0,0,5.1
2020,CB2020,047,3,Brooklyn,30722001007,338,151,187,5.29
2020,CB2020,047,3,Brooklyn,30722001008,0,0,0,1.73
2020,CB2020,047,3,Brooklyn,30722002000,313,113,200,5.3
2020,CB2020,047,3,Brooklyn,30722002001,361,140,221,5.09
2020,CB2020,047,3,Brooklyn,30722002002,156,81,75,5.5
2020,CB2020,047,3,Brooklyn,30722002003,181,92,89,5.48
2020,CB2020,047,3,Brooklyn,30722002004,203,116,87,4.93
2020,CB2020,047,3,Brooklyn,30722002005,0,0,0,0.23
2020,CB2020,047,3,Brooklyn,30724001000,263,123,140,5.3
2020,CB2020,047,3,Brooklyn,30724001001,378,160,218,5.09
2020,CB2020,047,3,Brooklyn,30724001002,398,187,211,5.3
2020,CB2020,047,3,Brooklyn,30724002000,308,113,195,5.3
2020,CB2020,047,3,Brooklyn,30724002001,267,124,143,5.13
2020,CB2020,047,3,Brooklyn,30724002002,0,0,0,1.45
2020,CB2020,047,3,Brooklyn,30724002003,0,0,0,3.48
2020,CB2020,047,3,Brooklyn,30724002004,51,18,33,4.91
2020,CB2020,047,3,Brooklyn,30724002005,130,47,83,5.3
2020,CB2020,047,3,Brooklyn,30724002006,116,56,60,4.02
2020,CB2020,047,3,Brooklyn,30724002007,0,0,0,2.23
2020,CB2020,047,3,Brooklyn,30726001000,622,258,364,7.26
2020,CB2020,047,3,Brooklyn,30726001001,0,0,0,2.28
2020,CB2020,047,3,Brooklyn,30726001002,28,12,16,2.59
2020,CB2020,047,3,Brooklyn,30726001003,0,0,0,3.08
2020,CB2020,047,3,Brooklyn,30726001004,66,26,40,4.04
2020,CB2020,047,3,Brooklyn,30726001005,0,0,0,3.27
2020,CB2020,047,3,Brooklyn,30726001006,0,0,0,2.7
2020,CB2020,047,3,Brooklyn,30726001007,0,0,0,3
2020,CB2020,047,3,Brooklyn,30726001008,236,123,113,3.14
2020,CB2020,047,3,Brooklyn,30726001009,159,77,82,3.63
2020,CB2020,047,3,Brooklyn,30726001010,41,24,17,1.85
2020,CB2020,047,3,Brooklyn,30726001011,174,65,109,3.42
2020,CB2020,047,3,Brooklyn,30726001012,39,19,20,1.63
2020,CB2020,047,3,Brooklyn,30726001013,245,112,133,5.14
2020,CB2020,047,3,Brooklyn,30726001014,269,115,154,5.28
2020,CB2020,047,3,Brooklyn,30726001015,115,50,65,2.28
2020,CB2020,047,3,Brooklyn,30726001016,140,60,80,3.03
2020,CB2020,047,3,Brooklyn,30726001017,254,117,137,5.09
2020,CB2020,047,3,Brooklyn,30726001018,194,79,115,5.28
2020,CB2020,047,3,Brooklyn,30728001000,0,0,0,0.73
2020,CB2020,047,3,Brooklyn,30728001001,75,25,50,1.97
2020,CB2020,047,3,Brooklyn,30728001002,235,112,123,3.17
2020,CB2020,047,3,Brooklyn,30728001003,444,186,258,4.2
2020,CB2020,047,3,Brooklyn,30728001004,431,169,262,5.23
2020,CB2020,047,3,Brooklyn,30728001005,541,198,343,5.31
2020,CB2020,047,3,Brooklyn,30728001006,452,176,276,5.09
2020,CB2020,047,3,Brooklyn,30728001007,389,162,227,5.51
2020,CB2020,047,3,Brooklyn,30728002000,183,70,113,5.49
2020,CB2020,047,3,Brooklyn,30728002001,340,159,181,5.11
2020,CB2020,047,3,Brooklyn,30728002002,296,164,132,5.3
2020,CB2020,047,3,Brooklyn,30728002003,259,108,151,5.27
2020,CB2020,047,3,Brooklyn,30730001000,0,0,0,0.28
2020,CB2020,047,3,Brooklyn,30730001001,70,17,53,1.43
2020,CB2020,047,3,Brooklyn,30730001002,158,68,90,2.52
2020,CB2020,047,3,Brooklyn,30730001003,110,57,53,3.96
2020,CB2020,047,3,Brooklyn,30730001004,145,80,65,5.17
2020,CB2020,047,3,Brooklyn,30730001005,241,98,143,5.1
2020,CB2020,047,3,Brooklyn,30730001006,324,139,185,5.29
2020,CB2020,047,3,Brooklyn,30730001007,268,136,132,5.3
2020,CB2020,047,3,Brooklyn,30730002000,22,8,14,0.97
2020,CB2020,047,3,Brooklyn,30730002001,110,41,69,2.14
2020,CB2020,047,3,Brooklyn,30730002002,186,93,93,3.35
2020,CB2020,047,3,Brooklyn,30730002003,263,123,140,4.39
2020,CB2020,047,3,Brooklyn,30730002004,273,113,160,5.28
2020,CB2020,047,3,Brooklyn,30730002005,0,0,0,0.57
2020,CB2020,047,3,Brooklyn,30732001000,184,86,98,4.65
2020,CB2020,047,3,Brooklyn,30732001001,0,0,0,0.58
2020,CB2020,047,3,Brooklyn,30732001002,192,99,93,3.58
2020,CB2020,047,3,Brooklyn,30732001003,166,93,73,2.42
2020,CB2020,047,3,Brooklyn,30732001004,445,170,275,4.05
2020,CB2020,047,3,Brooklyn,30732001005,65,34,31,1.52
2020,CB2020,047,3,Brooklyn,30732001006,110,48,62,1.87
2020,CB2020,047,3,Brooklyn,30732002000,159,54,105,4.13
2020,CB2020,047,3,Brooklyn,30732002001,0,0,0,0.98
2020,CB2020,047,3,Brooklyn,30732002002,313,135,178,5.31
2020,CB2020,047,3,Brooklyn,30732002003,164,66,98,3.28
2020,CB2020,047,3,Brooklyn,30732002004,92,65,27,2.04
2020,CB2020,047,3,Brooklyn,30732002005,283,137,146,5.1
2020,CB2020,047,3,Brooklyn,30734001000,236,109,127,5.29
2020,CB2020,047,3,Brooklyn,30734001001,295,135,160,5.3
2020,CB2020,047,3,Brooklyn,30734001002,269,107,162,5.11
2020,CB2020,047,3,Brooklyn,30734001003,0,0,0,5.1
2020,CB2020,047,3,Brooklyn,30734002000,245,120,125,4.21
2020,CB2020,047,3,Brooklyn,30734002001,305,135,170,4.21
2020,CB2020,047,3,Brooklyn,30734002002,340,136,204,4.06
2020,CB2020,047,3,Brooklyn,30734002003,128,62,66,4.06
2020,CB2020,047,3,Brooklyn,30736001000,227,86,141,1.98
2020,CB2020,047,3,Brooklyn,30736001001,450,179,271,3.82
2020,CB2020,047,3,Brooklyn,30736001002,404,201,203,3.67
2020,CB2020,047,3,Brooklyn,30736001003,332,144,188,5.22
2020,CB2020,047,3,Brooklyn,30736002000,394,167,227,4.64
2020,CB2020,047,3,Brooklyn,30736002001,388,161,227,3.89
2020,CB2020,047,3,Brooklyn,30736002002,108,55,53,1.58
2020,CB2020,047,3,Brooklyn,30736002003,57,34,23,2.79
2020,CB2020,047,3,Brooklyn,30736003000,175,79,96,1.83
2020,CB2020,047,3,Brooklyn,30736003001,457,227,230,3.85
2020,CB2020,047,3,Brooklyn,30736003002,189,71,118,3.51
2020,CB2020,047,3,Brooklyn,30736003003,29,10,19,5.11
2020,CB2020,047,3,Brooklyn,30736003004,263,113,150,2.1
2020,CB2020,047,3,Brooklyn,30738001000,355,170,185,4.63
2020,CB2020,047,3,Brooklyn,30738001001,475,227,248,5.26
2020,CB2020,047,3,Brooklyn,30738001002,330,176,154,5.45
2020,CB2020,047,3,Brooklyn,30738001003,115,50,65,2.09
2020,CB2020,047,3,Brooklyn,30738002000,71,47,24,1.95
2020,CB2020,047,3,Brooklyn,30738002001,111,52,59,0.83
2020,CB2020,047,3,Brooklyn,30738002002,121,61,60,1.63
2020,CB2020,047,3,Brooklyn,30738002003,143,72,71,2.28
2020,CB2020,047,3,Brooklyn,30738002004,247,99,148,3.95
2020,CB2020,047,3,Brooklyn,30738002005,124,48,76,0.61
2020,CB2020,047,3,Brooklyn,30738002006,190,77,113,0.7
2020,CB2020,047,3,Brooklyn,30738003000,167,81,86,5.38
2020,CB2020,047,3,Brooklyn,30738003001,232,91,141,3.04
2020,CB2020,047,3,Brooklyn,30738003002,233,94,139,2.91
2020,CB2020,047,3,Brooklyn,30738003003,199,99,100,2.37
2020,CB2020,047,3,Brooklyn,30738003004,177,74,103,1.55
2020,CB2020,047,3,Brooklyn,30740001000,268,122,146,5.1
2020,CB2020,047,3,Brooklyn,30740001001,385,156,229,5.3
2020,CB2020,047,3,Brooklyn,30740001002,389,152,237,5.23
2020,CB2020,047,3,Brooklyn,30740001003,327,177,150,3
2020,CB2020,047,3,Brooklyn,30740001004,351,203,148,2.09
2020,CB2020,047,3,Brooklyn,30740002000,286,164,122,4.05
2020,CB2020,047,3,Brooklyn,30740002001,292,141,151,2.64
2020,CB2020,047,3,Brooklyn,30740002002,0,0,0,0.4
2020,CB2020,047,3,Brooklyn,30740002003,629,243,386,4.86
2020,CB2020,047,3,Brooklyn,30740002004,437,211,226,5.36
2020,CB2020,047,3,Brooklyn,30740002005,82,36,46,2.09
2020,CB2020,047,3,Brooklyn,30742001000,32,18,14,0.72
2020,CB2020,047,3,Brooklyn,30742001001,314,143,171,4.76
2020,CB2020,047,3,Brooklyn,30742001002,395,178,217,5.27
2020,CB2020,047,3,Brooklyn,30742001003,339,172,167,5.25
2020,CB2020,047,3,Brooklyn,30742001004,461,241,220,5.25
2020,CB2020,047,3,Brooklyn,30742001005,292,122,170,5.25
2020,CB2020,047,3,Brooklyn,30742002000,149,47,102,5.66
2020,CB2020,047,3,Brooklyn,30742002001,720,305,415,5.65
2020,CB2020,047,3,Brooklyn,30742002002,321,176,145,5.25
2020,CB2020,047,3,Brooklyn,30744001000,309,183,126,5.45
2020,CB2020,047,3,Brooklyn,30744001001,313,171,142,5.25
2020,CB2020,047,3,Brooklyn,30744001002,360,148,212,5.24
2020,CB2020,047,3,Brooklyn,30744001003,347,167,180,5.26
2020,CB2020,047,3,Brooklyn,30744002000,255,122,133,4.03
2020,CB2020,047,3,Brooklyn,30744002001,276,125,151,5.29
2020,CB2020,047,3,Brooklyn,30744002002,259,136,123,5.25
2020,CB2020,047,3,Brooklyn,30744002003,265,161,104,5.25
2020,CB2020,047,3,Brooklyn,30744002004,97,41,56,1.01
2020,CB2020,047,3,Brooklyn,30746001000,0,0,0,1.54
2020,CB2020,047,3,Brooklyn,30746001001,187,87,100,2.22
2020,CB2020,047,3,Brooklyn,30746001002,250,121,129,3.22
2020,CB2020,047,3,Brooklyn,30746001003,275,117,158,4.43
2020,CB2020,047,3,Brooklyn,30746001004,366,171,195,4.52
2020,CB2020,047,3,Brooklyn,30746001005,113,73,40,3.26
2020,CB2020,047,3,Brooklyn,30746001006,15,11,4,1.56
2020,CB2020,047,3,Brooklyn,30746002000,0,0,0,0.9
2020,CB2020,047,3,Brooklyn,30746002001,191,104,87,2.14
2020,CB2020,047,3,Brooklyn,30746002002,80,28,52,3.81
2020,CB2020,047,3,Brooklyn,30746002003,191,110,81,5.14
2020,CB2020,047,3,Brooklyn,30746002004,183,100,83,5.65
2020,CB2020,047,3,Brooklyn,30746002005,114,42,72,5.67
2020,CB2020,047,3,Brooklyn,30746002006,102,56,46,3.49
2020,CB2020,047,3,Brooklyn,30746002007,33,22,11,2.01
2020,CB2020,047,3,Brooklyn,30746002008,0,0,0,0.36
2020,CB2020,047,3,Brooklyn,30748001000,75,48,27,5.66
2020,CB2020,047,3,Brooklyn,30748001001,162,83,79,5.25
2020,CB2020,047,3,Brooklyn,30748001002,193,83,110,5.25
2020,CB2020,047,3,Brooklyn,30748001003,211,132,79,5.24
2020,CB2020,047,3,Brooklyn,30748001004,202,114,88,5.26
2020,CB2020,047,3,Brooklyn,30748001005,153,65,88,5.66
2020,CB2020,047,3,Brooklyn,30748002000,680,315,365,5.65
2020,CB2020,047,3,Brooklyn,30748002001,260,123,137,5.65
2020,CB2020,047,3,Brooklyn,30750001000,360,163,197,5.65
2020,CB2020,047,3,Brooklyn,30750001001,431,203,228,5.25
2020,CB2020,047,3,Brooklyn,30750001002,334,165,169,5.24
2020,CB2020,047,3,Brooklyn,30750001003,365,212,153,5.28
2020,CB2020,047,3,Brooklyn,30750002000,731,329,402,5.65
2020,CB2020,047,3,Brooklyn,30750002001,249,136,113,5.25
2020,CB2020,047,3,Brooklyn,30750002002,241,98,143,5.25
2020,CB2020,047,3,Brooklyn,30750002003,217,113,104,5.28
2020,CB2020,047,3,Brooklyn,30752001000,162,89,73,5.43
2020,CB2020,047,3,Brooklyn,30752001001,139,72,67,5.45
2020,CB2020,047,3,Brooklyn,30752001002,120,77,43,5.26
2020,CB2020,047,3,Brooklyn,30752001003,130,40,90,5.26
2020,CB2020,047,3,Brooklyn,30752001004,131,64,67,5.27
2020,CB2020,047,3,Brooklyn,30752001005,111,61,50,5.25
2020,CB2020,047,3,Brooklyn,30752001006,110,55,55,5.44
2020,CB2020,047,3,Brooklyn,30752001007,139,77,62,5.44
2020,CB2020,047,3,Brooklyn,30754001000,207,128,79,5.26
2020,CB2020,047,3,Brooklyn,30754001001,97,52,45,5.45
2020,CB2020,047,3,Brooklyn,30754001002,198,111,87,5.45
2020,CB2020,047,3,Brooklyn,30754001003,215,80,135,5.27
2020,CB2020,047,3,Brooklyn,30754002000,167,96,71,5.26
2020,CB2020,047,3,Brooklyn,30754002001,193,95,98,5.44
2020,CB2020,047,3,Brooklyn,30754002002,173,72,101,5.46
2020,CB2020,047,3,Brooklyn,30754002003,152,72,80,5.28
2020,CB2020,047,3,Brooklyn,30756001000,122,70,52,5.26
2020,CB2020,047,3,Brooklyn,30756001001,197,96,101,5.24
2020,CB2020,047,3,Brooklyn,30756001002,235,113,122,4.39
2020,CB2020,047,3,Brooklyn,30756001003,175,85,90,3.19
2020,CB2020,047,3,Brooklyn,30756001004,153,75,78,1.15
2020,CB2020,047,3,Brooklyn,30756001005,135,65,70,1.12
2020,CB2020,047,3,Brooklyn,30756002000,192,87,105,5.26
2020,CB2020,047,3,Brooklyn,30756002001,159,86,73,5.45
2020,CB2020,047,3,Brooklyn,30756002002,210,106,104,6.08
2020,CB2020,047,3,Brooklyn,30756002003,356,191,165,5.75
2020,CB2020,047,3,Brooklyn,30758001000,69,48,21,5.45
2020,CB2020,047,3,Brooklyn,30758001001,123,75,48,5.25
2020,CB2020,047,3,Brooklyn,30758001002,129,73,56,5.26
2020,CB2020,047,3,Brooklyn,30758001003,17,13,4,1.41
2020,CB2020,047,3,Brooklyn,30758001004,91,29,62,3.43
2020,CB2020,047,3,Brooklyn,30758001005,143,44,99,6.05
2020,CB2020,047,3,Brooklyn,30758001006,97,58,39,2.45
2020,CB2020,047,3,Brooklyn,30758001007,122,67,55,2.43
2020,CB2020,047,3,Brooklyn,30758001008,82,33,49,2.01
2020,CB2020,047,3,Brooklyn,30758002000,98,58,40,5.25
2020,CB2020,047,3,Brooklyn,30758002001,758,350,408,5.88
2020,CB2020,047,3,Brooklyn,30758002002,66,51,15,1.86
2020,CB2020,047,3,Brooklyn,30758002003,210,83,127,3.99
2020,CB2020,047,3,Brooklyn,30760001000,179,104,75,5.26
2020,CB2020,047,3,Brooklyn,30760001001,140,72,68,5.24
2020,CB2020,047,3,Brooklyn,30760001002,153,77,76,5.24
2020,CB2020,047,3,Brooklyn,30760001003,167,78,89,5.26
2020,CB2020,047,3,Brooklyn,30760002000,147,75,72,3.19
2020,CB2020,047,3,Brooklyn,30760002001,456,191,265,2.67
2020,CB2020,047,3,Brooklyn,30760002002,414,174,240,5.86
2020,CB2020,047,3,Brooklyn,30760003000,913,438,475,6.8
2020,CB2020,047,3,Brooklyn,30760003001,263,119,144,5.35
2020,CB2020,047,3,Brooklyn,30762001000,173,64,109,5.26
2020,CB2020,047,3,Brooklyn,30762001001,140,75,65,5.25
2020,CB2020,047,3,Brooklyn,30762001002,773,370,403,5.84
2020,CB2020,047,3,Brooklyn,30762002000,183,102,81,5.31
2020,CB2020,047,3,Brooklyn,30762002001,152,89,63,5.35
2020,CB2020,047,3,Brooklyn,30762002002,1206,583,623,6.81
2020,CB2020,047,3,Brooklyn,30762003000,742,340,402,5.85
2020,CB2020,047,3,Brooklyn,30762003001,1022,498,524,6.81
2020,CB2020,047,3,Brooklyn,30764001000,1275,564,711,9.19
2020,CB2020,047,3,Brooklyn,30764001001,118,52,66,6.39
2020,CB2020,047,3,Brooklyn,30764002000,1002,448,554,6.8
2020,CB2020,047,3,Brooklyn,30764002001,101,47,54,5.35
2020,CB2020,047,3,Brooklyn,30764003000,567,274,293,2.64
2020,CB2020,047,3,Brooklyn,30764003001,80,39,41,2.07
2020,CB2020,047,3,Brooklyn,30764003002,98,36,62,3.29
2020,CB2020,047,3,Brooklyn,30764003003,542,259,283,4.2
2020,CB2020,047,3,Brooklyn,30766001000,157,56,101,5.26
2020,CB2020,047,3,Brooklyn,30766001001,868,394,474,5.83
2020,CB2020,047,3,Brooklyn,30766001002,784,378,406,5.55
2020,CB2020,047,3,Brooklyn,30766001003,181,99,82,3.76
2020,CB2020,047,3,Brooklyn,30768001000,302,159,143,5.45
2020,CB2020,047,3,Brooklyn,30768001001,37,16,21,7.8
2020,CB2020,047,3,Brooklyn,30768001002,257,144,113,2.92
2020,CB2020,047,3,Brooklyn,30768001003,11,6,5,6.7
2020,CB2020,047,3,Brooklyn,30768001004,88,34,54,2.85
2020,CB2020,047,3,Brooklyn,30768001005,305,161,144,3.25
2020,CB2020,047,3,Brooklyn,30768001006,20,8,12,1.99
2020,CB2020,047,3,Brooklyn,30768001007,29,6,23,2.47
2020,CB2020,047,3,Brooklyn,30768001008,0,0,0,1.41
2020,CB2020,047,3,Brooklyn,30768001009,0,0,0,1.7
2020,CB2020,047,3,Brooklyn,30768001010,0,0,0,0.87
2020,CB2020,047,3,Brooklyn,30768002000,304,164,140,3.69
2020,CB2020,047,3,Brooklyn,30768002001,376,290,86,4.45
2020,CB2020,047,3,Brooklyn,30768002002,141,56,85,1.26
2020,CB2020,047,3,Brooklyn,30768002003,153,84,69,1.61
2020,CB2020,047,3,Brooklyn,30768002004,67,36,31,1.49
2020,CB2020,047,3,Brooklyn,30768002005,150,76,74,1.73
2020,CB2020,047,3,Brooklyn,30768002006,0,0,0,0.34
2020,CB2020,047,3,Brooklyn,30768002007,59,28,31,3.54
2020,CB2020,047,3,Brooklyn,30768003000,114,66,48,2.33
2020,CB2020,047,3,Brooklyn,30768003001,69,29,40,0.9
2020,CB2020,047,3,Brooklyn,30768003002,75,37,38,1.1
2020,CB2020,047,3,Brooklyn,30768003003,351,191,160,4.14
2020,CB2020,047,3,Brooklyn,30768003004,624,305,319,4.58
2020,CB2020,047,3,Brooklyn,30768003005,131,60,71,2.69
2020,CB2020,047,3,Brooklyn,30768003006,386,181,205,3.72
2020,CB2020,047,3,Brooklyn,30770001000,389,180,209,5.21
2020,CB2020,047,3,Brooklyn,30770001001,440,200,240,3.2
2020,CB2020,047,3,Brooklyn,30770001002,478,199,279,2.91
2020,CB2020,047,3,Brooklyn,30770002000,525,232,293,5.31
2020,CB2020,047,3,Brooklyn,30770002001,165,79,86,5.68
2020,CB2020,047,3,Brooklyn,30770002002,142,58,84,4.77
2020,CB2020,047,3,Brooklyn,30770002003,88,52,36,4.08
2020,CB2020,047,3,Brooklyn,30770002004,103,54,49,3.39
2020,CB2020,047,3,Brooklyn,30770002005,104,60,44,2.97
2020,CB2020,047,3,Brooklyn,30770002006,342,151,191,2.82
2020,CB2020,047,3,Brooklyn,30772001000,396,177,219,5.45
2020,CB2020,047,3,Brooklyn,30772001001,282,145,137,5.45
2020,CB2020,047,3,Brooklyn,30772001002,162,74,88,5.25
2020,CB2020,047,3,Brooklyn,30772001003,181,81,100,5.26
2020,CB2020,047,3,Brooklyn,30772001004,297,114,183,3.68
2020,CB2020,047,3,Brooklyn,30772001005,164,61,103,5.72
2020,CB2020,047,3,Brooklyn,30772002000,535,228,307,2.83
2020,CB2020,047,3,Brooklyn,30772002001,0,0,0,2.92
2020,CB2020,047,3,Brooklyn,30772002002,0,0,0,19.64
2020,CB2020,047,3,Brooklyn,30772002003,0,0,0,1.96
2020,CB2020,047,3,Brooklyn,30772002004,110,58,52,3.09
2020,CB2020,047,3,Brooklyn,30772002005,127,70,57,3.22
2020,CB2020,047,3,Brooklyn,30772002006,117,60,57,3.23
2020,CB2020,047,3,Brooklyn,30772002007,31,14,17,19.24
2020,CB2020,047,3,Brooklyn,30772002008,101,60,41,3.15
2020,CB2020,047,3,Brooklyn,30772002009,131,52,79,3.13
2020,CB2020,047,3,Brooklyn,30772002010,365,172,193,3.55
2020,CB2020,047,3,Brooklyn,30772002011,71,31,40,3.15
2020,CB2020,047,3,Brooklyn,30774001000,320,141,179,5.04
2020,CB2020,047,3,Brooklyn,30774001001,500,202,298,4.68
2020,CB2020,047,3,Brooklyn,30774001002,192,83,109,1.36
2020,CB2020,047,3,Brooklyn,30774001003,21,16,5,2.05
2020,CB2020,047,3,Brooklyn,30774001004,13,11,2,1.62
2020,CB2020,047,3,Brooklyn,30774002000,5,3,2,3.51
2020,CB2020,047,3,Brooklyn,30774002001,296,147,149,2.36
2020,CB2020,047,3,Brooklyn,30774002002,367,155,212,3.14
2020,CB2020,047,3,Brooklyn,30774002003,137,49,88,3.56
2020,CB2020,047,3,Brooklyn,30774002004,493,237,256,6.19
2020,CB2020,047,3,Brooklyn,30774002005,345,177,168,1.54
2020,CB2020,047,3,Brooklyn,30774002006,340,128,212,1.46
2020,CB2020,047,3,Brooklyn,30776001000,89,36,53,3.12
2020,CB2020,047,3,Brooklyn,30776001001,100,45,55,1.7
2020,CB2020,047,3,Brooklyn,30776001002,740,339,401,5.7
2020,CB2020,047,3,Brooklyn,30776001003,288,140,148,2.02
2020,CB2020,047,3,Brooklyn,30776001004,18,6,12,0.99
2020,CB2020,047,3,Brooklyn,30776002000,135,82,53,3.41
2020,CB2020,047,3,Brooklyn,30776002001,198,100,98,3.18
2020,CB2020,047,3,Brooklyn,30776002002,1178,431,747,4.88
2020,CB2020,047,3,Brooklyn,30776003000,233,78,155,4.9
2020,CB2020,047,3,Brooklyn,30776003001,179,88,91,4.78
2020,CB2020,047,3,Brooklyn,30776003002,240,117,123,4.13
2020,CB2020,047,3,Brooklyn,30776003003,198,86,112,3.75
2020,CB2020,047,3,Brooklyn,30776003004,188,110,78,3.53
2020,CB2020,047,3,Brooklyn,30780001000,294,138,156,5.14
2020,CB2020,047,3,Brooklyn,30780001001,258,111,147,4.96
2020,CB2020,047,3,Brooklyn,30780001002,228,91,137,4.97
2020,CB2020,047,3,Brooklyn,30780001003,250,117,133,4.95
2020,CB2020,047,3,Brooklyn,30780002000,263,121,142,5.36
2020,CB2020,047,3,Brooklyn,30780002001,252,110,142,5.09
2020,CB2020,047,3,Brooklyn,30780002002,337,145,192,5.1
2020,CB2020,047,3,Brooklyn,30780002003,315,144,171,5.1
2020,CB2020,047,3,Brooklyn,30782001000,17,13,4,5.29
2020,CB2020,047,3,Brooklyn,30782001001,285,128,157,5.1
2020,CB2020,047,3,Brooklyn,30782001002,327,157,170,5.11
2020,CB2020,047,3,Brooklyn,30782001003,279,110,169,5.11
2020,CB2020,047,3,Brooklyn,30782001004,584,258,326,5.29
2020,CB2020,047,3,Brooklyn,30782002000,2495,1105,1390,13.38
2020,CB2020,047,3,Brooklyn,30782002001,94,60,34,2.31
2020,CB2020,047,3,Brooklyn,30784001000,275,140,135,5.14
2020,CB2020,047,3,Brooklyn,30784001001,284,108,176,5.15
2020,CB2020,047,3,Brooklyn,30784001002,258,117,141,4.96
2020,CB2020,047,3,Brooklyn,30784001003,312,136,176,5.14
2020,CB2020,047,3,Brooklyn,30784002000,289,116,173,5.3
2020,CB2020,047,3,Brooklyn,30784002001,267,122,145,5.3
2020,CB2020,047,3,Brooklyn,30784002002,480,202,278,5.1
2020,CB2020,047,3,Brooklyn,30784002003,276,136,140,5.29
2020,CB2020,047,3,Brooklyn,30786011000,632,274,358,5.38
2020,CB2020,047,3,Brooklyn,30786011001,341,159,182,3.85
2020,CB2020,047,3,Brooklyn,30786011002,211,97,114,1.85
2020,CB2020,047,3,Brooklyn,30786012000,893,384,509,5.13
2020,CB2020,047,3,Brooklyn,30786012001,224,103,121,3.96
2020,CB2020,047,3,Brooklyn,30786012002,73,52,21,1.36
2020,CB2020,047,3,Brooklyn,30786021000,603,260,343,5.4
2020,CB2020,047,3,Brooklyn,30786022000,574,238,336,5.4
2020,CB2020,047,3,Brooklyn,30786022001,398,199,199,4.8
2020,CB2020,047,3,Brooklyn,30786022002,498,241,257,5.14
2020,CB2020,047,3,Brooklyn,30788011000,670,307,363,5.29
2020,CB2020,047,3,Brooklyn,30788011001,416,202,214,5.11
2020,CB2020,047,3,Brooklyn,30788012000,406,200,206,5.41
2020,CB2020,047,3,Brooklyn,30788012001,385,198,187,4.59
2020,CB2020,047,3,Brooklyn,30788012002,163,59,104,2.63
2020,CB2020,047,3,Brooklyn,30788021000,1149,511,638,5.7
2020,CB2020,047,3,Brooklyn,30788021001,82,42,40,7.9
2020,CB2020,047,3,Brooklyn,30788021002,97,57,40,2.21
2020,CB2020,047,3,Brooklyn,30790011000,556,262,294,5.2
2020,CB2020,047,3,Brooklyn,30790011001,220,98,122,3.46
2020,CB2020,047,3,Brooklyn,30790011002,305,107,198,3.67
2020,CB2020,047,3,Brooklyn,30790011003,244,106,138,2.13
2020,CB2020,047,3,Brooklyn,30790011004,22,14,8,0.49
2020,CB2020,047,3,Brooklyn,30790021000,597,270,327,5.21
2020,CB2020,047,3,Brooklyn,30790021001,354,161,193,2.17
2020,CB2020,047,3,Brooklyn,30790021002,314,141,173,3.07
2020,CB2020,047,3,Brooklyn,30790022000,374,181,193,5.01
2020,CB2020,047,3,Brooklyn,30790022001,639,260,379,5.21
2020,CB2020,047,3,Brooklyn,30790023000,439,172,267,2.08
2020,CB2020,047,3,Brooklyn,30790023001,443,225,218,2.17
2020,CB2020,047,3,Brooklyn,30790023002,305,147,158,2.53
2020,CB2020,047,3,Brooklyn,30790023003,304,129,175,2.82
2020,CB2020,047,3,Brooklyn,30792011000,45,15,30,10.53
2020,CB2020,047,3,Brooklyn,30792011001,173,71,102,2.27
2020,CB2020,047,3,Brooklyn,30792011002,216,118,98,1.57
2020,CB2020,047,3,Brooklyn,30792011003,256,125,131,1.24
2020,CB2020,047,3,Brooklyn,30792011004,166,99,67,1.3
2020,CB2020,047,3,Brooklyn,30792011005,258,95,163,2.98
2020,CB2020,047,3,Brooklyn,30792011006,291,117,174,2.87
2020,CB2020,047,3,Brooklyn,30792011007,338,161,177,4.13
2020,CB2020,047,3,Brooklyn,30792021000,139,54,85,2.84
2020,CB2020,047,3,Brooklyn,30792021001,1302,538,764,6.21
2020,CB2020,047,3,Brooklyn,30792021002,261,116,145,4.95
2020,CB2020,047,3,Brooklyn,30792021003,134,68,66,0.98
2020,CB2020,047,3,Brooklyn,30792021004,119,60,59,2.07
2020,CB2020,047,3,Brooklyn,30792021005,141,53,88,1.06
2020,CB2020,047,3,Brooklyn,30792022000,257,115,142,2.83
2020,CB2020,047,3,Brooklyn,30792022001,485,212,273,2.78
2020,CB2020,047,3,Brooklyn,30792022002,333,154,179,2.94
2020,CB2020,047,3,Brooklyn,30794001000,156,79,77,1.17
2020,CB2020,047,3,Brooklyn,30794001001,67,27,40,4.3
2020,CB2020,047,3,Brooklyn,30794001002,0,0,0,2.46
2020,CB2020,047,3,Brooklyn,30794001003,13,6,7,1.09
2020,CB2020,047,3,Brooklyn,30794001004,221,97,124,2.59
2020,CB2020,047,3,Brooklyn,30794001005,81,41,40,1.39
2020,CB2020,047,3,Brooklyn,30794001006,134,74,60,1.97
2020,CB2020,047,3,Brooklyn,30794001007,147,73,74,5.33
2020,CB2020,047,3,Brooklyn,30794001008,126,41,85,1.02
2020,CB2020,047,3,Brooklyn,30794002000,91,36,55,1.76
2020,CB2020,047,3,Brooklyn,30794002001,766,355,411,4.2
2020,CB2020,047,3,Brooklyn,30794002002,330,205,125,2.13
2020,CB2020,047,3,Brooklyn,30794002003,264,120,144,2.28
2020,CB2020,047,3,Brooklyn,30794002004,274,118,156,7.04
2020,CB2020,047,3,Brooklyn,30794003000,34,15,19,11.75
2020,CB2020,047,3,Brooklyn,30794003001,38,22,16,4.4
2020,CB2020,047,3,Brooklyn,30796011000,617,258,359,4.47
2020,CB2020,047,3,Brooklyn,30796011001,476,224,252,2.53
2020,CB2020,047,3,Brooklyn,30796011002,904,414,490,6.53
2020,CB2020,047,3,Brooklyn,30796012000,1260,569,691,7.4
2020,CB2020,047,3,Brooklyn,30796012001,868,386,482,6.35
2020,CB2020,047,3,Brooklyn,30796021000,1345,554,791,9.92
2020,CB2020,047,3,Brooklyn,30796021001,886,395,491,6.17
2020,CB2020,047,3,Brooklyn,30796022000,896,389,507,4.74
2020,CB2020,047,3,Brooklyn,30796022001,1044,434,610,6.77
2020,CB2020,047,3,Brooklyn,30796022002,318,164,154,5.76
2020,CB2020,047,3,Brooklyn,30798011000,1306,569,737,6.83
2020,CB2020,047,3,Brooklyn,30798011001,392,195,197,6.41
2020,CB2020,047,3,Brooklyn,30798012000,409,182,227,6.22
2020,CB2020,047,3,Brooklyn,30798012001,435,183,252,6.3
2020,CB2020,047,3,Brooklyn,30798012002,415,210,205,6.29
2020,CB2020,047,3,Brooklyn,30798021000,1909,819,1090,7.65
2020,CB2020,047,3,Brooklyn,30798022000,673,279,394,2.57
2020,CB2020,047,3,Brooklyn,30798022001,1333,618,715,5.18
2020,CB2020,047,3,Brooklyn,30798023000,944,436,508,5.67
2020,CB2020,047,3,Brooklyn,30798023001,384,148,236,1.95
2020,CB2020,047,3,Brooklyn,30798023002,404,194,210,3.26
2020,CB2020,047,3,Brooklyn,30800001000,603,270,333,5.3
2020,CB2020,047,3,Brooklyn,30800001001,514,218,296,6.14
2020,CB2020,047,3,Brooklyn,30800002000,602,267,335,5.01
2020,CB2020,047,3,Brooklyn,30800002001,284,137,147,5.76
2020,CB2020,047,3,Brooklyn,30800002002,216,115,101,5.55
2020,CB2020,047,3,Brooklyn,30800003000,636,295,341,4.8
2020,CB2020,047,3,Brooklyn,30800003001,400,141,259,4.8
2020,CB2020,047,3,Brooklyn,30800003002,307,146,161,5.55
2020,CB2020,047,3,Brooklyn,30802001000,479,217,262,4.81
2020,CB2020,047,3,Brooklyn,30802001001,282,119,163,5.56
2020,CB2020,047,3,Brooklyn,30802001002,1025,445,580,5.77
2020,CB2020,047,3,Brooklyn,30802002000,586,226,360,5.03
2020,CB2020,047,3,Brooklyn,30802002001,235,99,136,5.63
2020,CB2020,047,3,Brooklyn,30802002002,240,115,125,3.4
2020,CB2020,047,3,Brooklyn,30802002003,242,120,122,3.12
2020,CB2020,047,3,Brooklyn,30802003000,639,260,379,6.65
2020,CB2020,047,3,Brooklyn,30802003001,793,346,447,5.81
2020,CB2020,047,3,Brooklyn,30804001000,559,253,306,5.31
2020,CB2020,047,3,Brooklyn,30804001001,194,73,121,5
2020,CB2020,047,3,Brooklyn,30804001002,539,243,296,4.8
2020,CB2020,047,3,Brooklyn,30804002000,577,259,318,4.81
2020,CB2020,047,3,Brooklyn,30804002001,476,227,249,4.81
2020,CB2020,047,3,Brooklyn,30804003000,345,170,175,5.75
2020,CB2020,047,3,Brooklyn,30804003001,467,215,252,5.05
2020,CB2020,047,3,Brooklyn,30804003002,69,33,36,5.67
2020,CB2020,047,3,Brooklyn,30804003003,101,57,44,5.7
2020,CB2020,047,3,Brooklyn,30806001000,604,259,345,5.14
2020,CB2020,047,3,Brooklyn,30806001001,686,312,374,5.15
2020,CB2020,047,3,Brooklyn,30806001002,105,45,60,4.21
2020,CB2020,047,3,Brooklyn,30806001003,332,177,155,3.89
2020,CB2020,047,3,Brooklyn,30806001004,94,58,36,1.01
2020,CB2020,047,3,Brooklyn,30806001005,94,49,45,0.94
2020,CB2020,047,3,Brooklyn,30806001006,88,39,49,1.12
2020,CB2020,047,3,Brooklyn,30806001007,40,19,21,0.69
2020,CB2020,047,3,Brooklyn,30806002000,198,97,101,4.83
2020,CB2020,047,3,Brooklyn,30806002001,468,250,218,4.81
2020,CB2020,047,3,Brooklyn,30806002002,399,203,196,4.66
2020,CB2020,047,3,Brooklyn,30806002003,673,304,369,4.65
2020,CB2020,047,3,Brooklyn,30808001000,218,164,54,34.08
2020,CB2020,047,3,Brooklyn,30808001001,888,407,481,30.47
2020,CB2020,047,3,Brooklyn,30808001002,834,413,421,14.98
2020,CB2020,047,3,Brooklyn,30810001000,628,275,353,4.68
2020,CB2020,047,3,Brooklyn,30810001001,342,175,167,2.89
2020,CB2020,047,3,Brooklyn,30810001002,272,120,152,1.79
2020,CB2020,047,3,Brooklyn,30810001003,150,49,101,1.7
2020,CB2020,047,3,Brooklyn,30810001004,107,34,73,2.09
2020,CB2020,047,3,Brooklyn,30810002000,85,43,42,14.85
2020,CB2020,047,3,Brooklyn,30810002001,156,77,79,3.75
2020,CB2020,047,3,Brooklyn,30810002002,520,211,309,4.41
2020,CB2020,047,3,Brooklyn,30810002003,647,310,337,3.98
2020,CB2020,047,3,Brooklyn,30814001000,182,81,101,2.86
2020,CB2020,047,3,Brooklyn,30814001001,243,106,137,2.87
2020,CB2020,047,3,Brooklyn,30814001002,313,169,144,3.48
2020,CB2020,047,3,Brooklyn,30814001003,251,97,154,3.47
2020,CB2020,047,3,Brooklyn,30814001004,360,163,197,4.41
2020,CB2020,047,3,Brooklyn,30814001005,188,87,101,4.39
2020,CB2020,047,3,Brooklyn,30814002000,0,0,0,2.74
2020,CB2020,047,3,Brooklyn,30814002001,212,90,122,2.76
2020,CB2020,047,3,Brooklyn,30814002002,293,107,186,3.34
2020,CB2020,047,3,Brooklyn,30814002003,371,169,202,3.34
2020,CB2020,047,3,Brooklyn,30814002004,379,186,193,4.19
2020,CB2020,047,3,Brooklyn,30814002005,329,153,176,4.19
2020,CB2020,047,3,Brooklyn,30816001000,129,75,54,2.79
2020,CB2020,047,3,Brooklyn,30816001001,0,0,0,11.09
2020,CB2020,047,3,Brooklyn,30816001002,168,58,110,3.39
2020,CB2020,047,3,Brooklyn,30816001003,276,102,174,3.53
2020,CB2020,047,3,Brooklyn,30816001004,262,124,138,3.48
2020,CB2020,047,3,Brooklyn,30816001005,178,66,112,3.37
2020,CB2020,047,3,Brooklyn,30816002000,341,145,196,4.19
2020,CB2020,047,3,Brooklyn,30816002001,277,114,163,4.3
2020,CB2020,047,3,Brooklyn,30816002002,414,210,204,4.2
2020,CB2020,047,3,Brooklyn,30816002003,535,226,309,4.04
2020,CB2020,047,3,Brooklyn,30818001000,807,339,468,8.57
2020,CB2020,047,3,Brooklyn,30818001001,1841,738,1103,10.32
2020,CB2020,047,3,Brooklyn,30818002000,295,137,158,3.5
2020,CB2020,047,3,Brooklyn,30818002001,491,200,291,4.19
2020,CB2020,047,3,Brooklyn,30818002002,65,37,28,0.69
2020,CB2020,047,3,Brooklyn,30818002003,148,76,72,1.36
2020,CB2020,047,3,Brooklyn,30818002004,169,82,87,1.95
2020,CB2020,047,3,Brooklyn,30818003000,832,354,478,6.38
2020,CB2020,047,3,Brooklyn,30818003001,182,97,85,2.06
2020,CB2020,047,3,Brooklyn,30820001000,448,203,245,5.63
2020,CB2020,047,3,Brooklyn,30820001001,1456,614,842,8.6
2020,CB2020,047,3,Brooklyn,30820002000,1998,862,1136,10.12
2020,CB2020,047,3,Brooklyn,30820003000,1192,551,641,6.38
2020,CB2020,047,3,Brooklyn,30820003001,401,208,193,5.99
2020,CB2020,047,3,Brooklyn,30822001000,1218,510,708,6.46
2020,CB2020,047,3,Brooklyn,30822002000,1837,793,1044,9.93
2020,CB2020,047,3,Brooklyn,30822003000,2295,983,1312,11.51
2020,CB2020,047,3,Brooklyn,30822004000,773,336,437,7.37
2020,CB2020,047,3,Brooklyn,30822004001,1078,469,609,6.69
2020,CB2020,047,3,Brooklyn,30824001000,365,161,204,2.76
2020,CB2020,047,3,Brooklyn,30824001001,167,67,100,1.5
2020,CB2020,047,3,Brooklyn,30824001002,429,220,209,4.07
2020,CB2020,047,3,Brooklyn,30824001003,269,111,158,2.43
2020,CB2020,047,3,Brooklyn,30824001004,285,131,154,2.36
2020,CB2020,047,3,Brooklyn,30824002000,482,187,295,4.51
2020,CB2020,047,3,Brooklyn,30824002001,674,302,372,4.64
2020,CB2020,047,3,Brooklyn,30824003000,365,189,176,5.87
2020,CB2020,047,3,Brooklyn,30824003001,208,77,131,5.24
2020,CB2020,047,3,Brooklyn,30824003002,228,85,143,2.85
2020,CB2020,047,3,Brooklyn,30824003003,374,155,219,2.74
2020,CB2020,047,3,Brooklyn,30824003004,198,84,114,2.91
2020,CB2020,047,3,Brooklyn,30824004000,465,197,268,4.28
2020,CB2020,047,3,Brooklyn,30824004001,342,152,190,4.29
2020,CB2020,047,3,Brooklyn,30824004002,112,59,53,2.52
2020,CB2020,047,3,Brooklyn,30826001000,597,282,315,3.91
2020,CB2020,047,3,Brooklyn,30826001001,311,130,181,3.76
2020,CB2020,047,3,Brooklyn,30826001002,401,174,227,3.96
2020,CB2020,047,3,Brooklyn,30826002000,146,67,79,1.77
2020,CB2020,047,3,Brooklyn,30826002001,138,64,74,1.62
2020,CB2020,047,3,Brooklyn,30826002002,154,70,84,1.63
2020,CB2020,047,3,Brooklyn,30826002003,252,127,125,2.66
2020,CB2020,047,3,Brooklyn,30826002004,171,89,82,2.5
2020,CB2020,047,3,Brooklyn,30826002005,164,63,101,1.73
2020,CB2020,047,3,Brooklyn,30826002006,64,26,38,0.85
2020,CB2020,047,3,Brooklyn,30826003000,132,52,80,1.57
2020,CB2020,047,3,Brooklyn,30826003001,79,44,35,1.48
2020,CB2020,047,3,Brooklyn,30826003002,109,60,49,1.52
2020,CB2020,047,3,Brooklyn,30826003003,332,133,199,2.83
2020,CB2020,047,3,Brooklyn,30826003004,397,200,197,2.65
2020,CB2020,047,3,Brooklyn,30826003005,505,215,290,2.7
2020,CB2020,047,3,Brooklyn,30826004000,408,172,236,4
2020,CB2020,047,3,Brooklyn,30826004001,436,205,231,3.89
2020,CB2020,047,3,Brooklyn,30826004002,369,162,207,4.17
2020,CB2020,047,3,Brooklyn,30828001000,711,318,393,5.21
2020,CB2020,047,3,Brooklyn,30828001001,165,70,95,2.17
2020,CB2020,047,3,Brooklyn,30828001002,189,92,97,2.17
2020,CB2020,047,3,Brooklyn,30828002000,161,86,75,2.09
2020,CB2020,047,3,Brooklyn,30828002001,278,114,164,2.21
2020,CB2020,047,3,Brooklyn,30828002002,231,114,117,3.19
2020,CB2020,047,3,Brooklyn,30828002003,227,92,135,2.75
2020,CB2020,047,3,Brooklyn,30828002004,327,174,153,2.66
2020,CB2020,047,3,Brooklyn,30828002005,139,67,72,0.47
2020,CB2020,047,3,Brooklyn,30828002006,119,50,69,0.27
2020,CB2020,047,3,Brooklyn,30828003000,592,262,330,5.2
2020,CB2020,047,3,Brooklyn,30828003001,647,306,341,5.02
2020,CB2020,047,3,Brooklyn,30828003002,420,187,233,5.3
2020,CB2020,047,3,Brooklyn,30830001000,129,59,70,2.37
2020,CB2020,047,3,Brooklyn,30830001001,298,147,151,2.93
2020,CB2020,047,3,Brooklyn,30830001002,472,192,280,5.02
2020,CB2020,047,3,Brooklyn,30830001003,12,4,8,2.09
2020,CB2020,047,3,Brooklyn,30830001004,146,87,59,1.4
2020,CB2020,047,3,Brooklyn,30830001005,153,50,103,0.82
2020,CB2020,047,3,Brooklyn,30830002000,373,165,208,5.02
2020,CB2020,047,3,Brooklyn,30830002001,430,203,227,5.21
2020,CB2020,047,3,Brooklyn,30830002002,209,86,123,2.18
2020,CB2020,047,3,Brooklyn,30830002003,190,86,104,2.09
2020,CB2020,047,3,Brooklyn,30830002004,158,72,86,2.17
2020,CB2020,047,3,Brooklyn,30830003000,1537,722,815,7.74
2020,CB2020,047,3,Brooklyn,30830003001,381,144,237,1.52
2020,CB2020,047,3,Brooklyn,30830004000,1679,735,944,9.32
2020,CB2020,047,3,Brooklyn,30832001000,333,136,197,5.01
2020,CB2020,047,3,Brooklyn,30832001001,295,128,167,5.02
2020,CB2020,047,3,Brooklyn,30832001002,331,116,215,5.11
2020,CB2020,047,3,Brooklyn,30832001003,367,172,195,5.1
2020,CB2020,047,3,Brooklyn,30832002000,540,240,300,5.2
2020,CB2020,047,3,Brooklyn,30832002001,311,137,174,5.21
2020,CB2020,047,3,Brooklyn,30832002002,185,80,105,5.3
2020,CB2020,047,3,Brooklyn,30834001000,196,100,96,5.21
2020,CB2020,047,3,Brooklyn,30834001001,358,134,224,5.21
2020,CB2020,047,3,Brooklyn,30834001002,290,141,149,5.01
2020,CB2020,047,3,Brooklyn,30834002000,288,150,138,5.31
2020,CB2020,047,3,Brooklyn,30834002001,322,125,197,5.3
2020,CB2020,047,3,Brooklyn,30834002002,279,107,172,5.1
2020,CB2020,047,3,Brooklyn,30836001000,365,195,170,5.1
2020,CB2020,047,3,Brooklyn,30836001001,483,190,293,5.3
2020,CB2020,047,3,Brooklyn,30836001002,16,7,9,5.14
2020,CB2020,047,3,Brooklyn,30836001003,29,15,14,4.94
2020,CB2020,047,3,Brooklyn,30836002000,553,269,284,5.3
2020,CB2020,047,3,Brooklyn,30836002001,482,216,266,5.11
2020,CB2020,047,3,Brooklyn,30836002002,232,84,148,5.3
2020,CB2020,047,3,Brooklyn,30836002003,0,0,0,5.15
2020,CB2020,047,3,Brooklyn,30836002004,0,0,0,4.96
2020,CB2020,047,3,Brooklyn,30836002005,0,0,0,5.13
2020,CB2020,047,3,Brooklyn,30838001000,389,200,189,5.01
2020,CB2020,047,3,Brooklyn,30838001001,300,112,188,5.2
2020,CB2020,047,3,Brooklyn,30838001002,263,117,146,5.19
2020,CB2020,047,3,Brooklyn,30838001003,242,120,122,5.02
2020,CB2020,047,3,Brooklyn,30838002000,314,135,179,5.11
2020,CB2020,047,3,Brooklyn,30838002001,171,64,107,5.31
2020,CB2020,047,3,Brooklyn,30838002002,297,133,164,5.3
2020,CB2020,047,3,Brooklyn,30838002003,250,119,131,5.11
2020,CB2020,047,3,Brooklyn,30840001000,103,57,46,5.4
2020,CB2020,047,3,Brooklyn,30840001001,141,64,77,5.01
2020,CB2020,047,3,Brooklyn,30840001002,350,159,191,5.22
2020,CB2020,047,3,Brooklyn,30840001003,527,218,309,5.21
2020,CB2020,047,3,Brooklyn,30840002000,178,80,98,5.49
2020,CB2020,047,3,Brooklyn,30840002001,266,133,133,5.09
2020,CB2020,047,3,Brooklyn,30840002002,494,211,283,5.3
2020,CB2020,047,3,Brooklyn,30840002003,265,92,173,5.3
2020,CB2020,047,3,Brooklyn,30846001000,296,157,139,5.45
2020,CB2020,047,3,Brooklyn,30846001001,330,150,180,5.21
2020,CB2020,047,3,Brooklyn,30846001002,273,115,158,5.01
2020,CB2020,047,3,Brooklyn,30846001003,183,70,113,5.4
2020,CB2020,047,3,Brooklyn,30846002000,109,44,65,4.18
2020,CB2020,047,3,Brooklyn,30846002001,342,148,194,5.29
2020,CB2020,047,3,Brooklyn,30846002002,284,135,149,5.1
2020,CB2020,047,3,Brooklyn,30846002003,169,79,90,5.51
2020,CB2020,047,3,Brooklyn,30848001000,236,121,115,4.22
2020,CB2020,047,3,Brooklyn,30848001001,285,150,135,4.22
2020,CB2020,047,3,Brooklyn,30848001002,220,95,125,4.06
2020,CB2020,047,3,Brooklyn,30848001003,172,68,104,4.37
2020,CB2020,047,3,Brooklyn,30848002000,232,111,121,4.27
2020,CB2020,047,3,Brooklyn,30848002001,225,77,148,4.28
2020,CB2020,047,3,Brooklyn,30848002002,249,107,142,4.12
2020,CB2020,047,3,Brooklyn,30848002003,109,56,53,4.44
2020,CB2020,047,3,Brooklyn,30850001000,118,70,48,4.37
2020,CB2020,047,3,Brooklyn,30850001001,102,36,66,4.07
2020,CB2020,047,3,Brooklyn,30850001002,230,111,119,4.23
2020,CB2020,047,3,Brooklyn,30850001003,134,78,56,1.95
2020,CB2020,047,3,Brooklyn,30850001004,165,81,84,4.12
2020,CB2020,047,3,Brooklyn,30850001005,108,60,48,4.42
2020,CB2020,047,3,Brooklyn,30850001006,108,22,86,2.32
2020,CB2020,047,3,Brooklyn,30850001007,91,44,47,2.14
2020,CB2020,047,3,Brooklyn,30850001008,121,74,47,1.95
2020,CB2020,047,3,Brooklyn,30850001009,106,34,72,2.06
2020,CB2020,047,3,Brooklyn,30850001010,121,50,71,2.09
2020,CB2020,047,3,Brooklyn,30850001011,105,40,65,2.04
2020,CB2020,047,3,Brooklyn,30852001000,32,14,18,97.78
2020,CB2020,047,3,Brooklyn,30854001000,251,128,123,3.71
2020,CB2020,047,3,Brooklyn,30854001001,38,22,16,1.22
2020,CB2020,047,3,Brooklyn,30854001002,77,26,51,1.01
2020,CB2020,047,3,Brooklyn,30854001003,150,67,83,1.91
2020,CB2020,047,3,Brooklyn,30854001004,158,72,86,1.79
2020,CB2020,047,3,Brooklyn,30854001005,192,76,116,1.79
2020,CB2020,047,3,Brooklyn,30854002000,102,30,72,2.17
2020,CB2020,047,3,Brooklyn,30854002001,66,36,30,2.19
2020,CB2020,047,3,Brooklyn,30854002002,106,49,57,2.15
2020,CB2020,047,3,Brooklyn,30854002003,134,69,65,2.16
2020,CB2020,047,3,Brooklyn,30854002004,106,58,48,2.21
2020,CB2020,047,3,Brooklyn,30854002005,137,62,75,2.32
2020,CB2020,047,3,Brooklyn,30854002006,124,53,71,2.36
2020,CB2020,047,3,Brooklyn,30854002007,171,80,91,2.33
2020,CB2020,047,3,Brooklyn,30854002008,150,54,96,2.48
2020,CB2020,047,3,Brooklyn,30856001000,299,147,152,4.08
2020,CB2020,047,3,Brooklyn,30856001001,279,137,142,4.16
2020,CB2020,047,3,Brooklyn,30856001002,463,189,274,4.02
2020,CB2020,047,3,Brooklyn,30856002000,0,0,0,1
2020,CB2020,047,3,Brooklyn,30856002001,423,178,245,4.88
2020,CB2020,047,3,Brooklyn,30856002002,686,289,397,4.66
2020,CB2020,047,3,Brooklyn,30856003000,463,251,212,4.18
2020,CB2020,047,3,Brooklyn,30856003001,206,76,130,4.79
2020,CB2020,047,3,Brooklyn,30856003002,528,229,299,3.81
2020,CB2020,047,3,Brooklyn,30856003003,221,80,141,3.62
2020,CB2020,047,3,Brooklyn,30858001000,240,125,115,3.9
2020,CB2020,047,3,Brooklyn,30858001001,351,165,186,3.79
2020,CB2020,047,3,Brooklyn,30858001002,203,93,110,4.03
2020,CB2020,047,3,Brooklyn,30858001003,64,23,41,2.21
2020,CB2020,047,3,Brooklyn,30858001004,137,69,68,2.31
2020,CB2020,047,3,Brooklyn,30858001005,163,67,96,2.48
2020,CB2020,047,3,Brooklyn,30858002000,293,123,170,3.93
2020,CB2020,047,3,Brooklyn,30858002001,222,126,96,3.85
2020,CB2020,047,3,Brooklyn,30858002002,323,154,169,3.88
2020,CB2020,047,3,Brooklyn,30858002003,478,194,284,3.86
2020,CB2020,047,3,Brooklyn,30860001000,226,83,143,3.85
2020,CB2020,047,3,Brooklyn,30860001001,280,114,166,3.59
2020,CB2020,047,3,Brooklyn,30860001002,345,173,172,4.2
2020,CB2020,047,3,Brooklyn,30860001003,341,157,184,4.54
2020,CB2020,047,3,Brooklyn,30860002000,407,184,223,3.77
2020,CB2020,047,3,Brooklyn,30860002001,327,137,190,3.82
2020,CB2020,047,3,Brooklyn,30860002002,202,81,121,2.62
2020,CB2020,047,3,Brooklyn,30860002003,354,155,199,4.4
2020,CB2020,047,3,Brooklyn,30860003000,537,238,299,3.71
2020,CB2020,047,3,Brooklyn,30860003001,367,171,196,3.87
2020,CB2020,047,3,Brooklyn,30860003002,147,48,99,2.49
2020,CB2020,047,3,Brooklyn,30860003003,276,116,160,2.47
2020,CB2020,047,3,Brooklyn,30862001000,493,228,265,4.61
2020,CB2020,047,3,Brooklyn,30862001001,354,157,197,4.37
2020,CB2020,047,3,Brooklyn,30862002000,510,226,284,4.37
2020,CB2020,047,3,Brooklyn,30862002001,334,161,173,4.2
2020,CB2020,047,3,Brooklyn,30862002002,418,179,239,4.53
2020,CB2020,047,3,Brooklyn,30862003000,564,254,310,4.51
2020,CB2020,047,3,Brooklyn,30862003001,281,140,141,4.06
2020,CB2020,047,3,Brooklyn,30862003002,473,196,277,3.99
2020,CB2020,047,3,Brooklyn,30864001000,182,76,106,2.18
2020,CB2020,047,3,Brooklyn,30864001001,57,29,28,0.46
2020,CB2020,047,3,Brooklyn,30864001002,328,134,194,2.89
2020,CB2020,047,3,Brooklyn,30864001003,0,0,0,0.6
2020,CB2020,047,3,Brooklyn,30864001004,215,115,100,3.51
2020,CB2020,047,3,Brooklyn,30864001005,356,152,204,3.47
2020,CB2020,047,3,Brooklyn,30864001006,57,25,32,1.49
2020,CB2020,047,3,Brooklyn,30864001007,0,0,0,0.12
2020,CB2020,047,3,Brooklyn,30864002000,85,40,45,3.96
2020,CB2020,047,3,Brooklyn,30864002001,46,9,37,2.32
2020,CB2020,047,3,Brooklyn,30864002002,45,28,17,1.42
2020,CB2020,047,3,Brooklyn,30864002003,256,129,127,3.84
2020,CB2020,047,3,Brooklyn,30864002004,318,153,165,3.8
2020,CB2020,047,3,Brooklyn,30864002005,286,99,187,3.76
2020,CB2020,047,3,Brooklyn,30864002006,268,108,160,3.46
2020,CB2020,047,3,Brooklyn,30866001000,442,200,242,5.05
2020,CB2020,047,3,Brooklyn,30866001001,25,7,18,0.74
2020,CB2020,047,3,Brooklyn,30866001002,142,69,73,2.22
2020,CB2020,047,3,Brooklyn,30866001003,251,106,145,3.64
2020,CB2020,047,3,Brooklyn,30866001004,182,94,88,3.8
2020,CB2020,047,3,Brooklyn,30866001005,122,46,76,2.4
2020,CB2020,047,3,Brooklyn,30866001006,70,35,35,0.63
2020,CB2020,047,3,Brooklyn,30866001007,0,0,0,0.29
2020,CB2020,047,3,Brooklyn,30866002000,342,156,186,2.81
2020,CB2020,047,3,Brooklyn,30866002001,396,165,231,3.34
2020,CB2020,047,3,Brooklyn,30866002002,277,107,170,3.61
2020,CB2020,047,3,Brooklyn,30866003000,378,150,228,2.91
2020,CB2020,047,3,Brooklyn,30866003001,428,186,242,3.47
2020,CB2020,047,3,Brooklyn,30866003002,330,152,178,3.76
2020,CB2020,047,3,Brooklyn,30868001000,311,114,197,2.91
2020,CB2020,047,3,Brooklyn,30868001001,312,123,189,2.81
2020,CB2020,047,3,Brooklyn,30868001002,268,125,143,3.01
2020,CB2020,047,3,Brooklyn,30868001003,124,63,61,2.98
2020,CB2020,047,3,Brooklyn,30868002000,304,119,185,3.47
2020,CB2020,047,3,Brooklyn,30868002001,201,100,101,3.35
2020,CB2020,047,3,Brooklyn,30868002002,264,121,143,3.61
2020,CB2020,047,3,Brooklyn,30868002003,168,76,92,3.59
2020,CB2020,047,3,Brooklyn,30868003000,348,144,204,3.86
2020,CB2020,047,3,Brooklyn,30868003001,364,140,224,4
2020,CB2020,047,3,Brooklyn,30868003002,275,128,147,4.7
2020,CB2020,047,3,Brooklyn,30868003003,474,209,265,4.85
2020,CB2020,047,3,Brooklyn,30870001000,179,103,76,2.76
2020,CB2020,047,3,Brooklyn,30870001001,220,112,108,3.34
2020,CB2020,047,3,Brooklyn,30870001002,661,269,392,4.45
2020,CB2020,047,3,Brooklyn,30870002000,355,162,193,3.47
2020,CB2020,047,3,Brooklyn,30870002001,274,138,136,3.47
2020,CB2020,047,3,Brooklyn,30870002002,507,203,304,4.55
2020,CB2020,047,3,Brooklyn,30870002003,212,88,124,4.6
2020,CB2020,047,3,Brooklyn,30870003000,168,61,107,2.85
2020,CB2020,047,3,Brooklyn,30870003001,403,163,240,2.87
2020,CB2020,047,3,Brooklyn,30870003002,304,148,156,2.76
2020,CB2020,047,3,Brooklyn,30870003003,287,149,138,3.34
2020,CB2020,047,3,Brooklyn,30872001000,160,88,72,2.86
2020,CB2020,047,3,Brooklyn,30872001001,226,86,140,2.88
2020,CB2020,047,3,Brooklyn,30872001002,265,103,162,2.77
2020,CB2020,047,3,Brooklyn,30872002000,458,212,246,3.47
2020,CB2020,047,3,Brooklyn,30872002001,314,137,177,3.47
2020,CB2020,047,3,Brooklyn,30872002002,273,103,170,3.34
2020,CB2020,047,3,Brooklyn,30872003000,266,106,160,4.35
2020,CB2020,047,3,Brooklyn,30872003001,558,257,301,4.49
2020,CB2020,047,3,Brooklyn,30872003002,353,160,193,4.46
2020,CB2020,047,3,Brooklyn,30872003003,255,97,158,4.27
2020,CB2020,047,3,Brooklyn,30874011000,437,203,234,4.85
2020,CB2020,047,3,Brooklyn,30874011001,564,237,327,4.49
2020,CB2020,047,3,Brooklyn,30874011002,364,182,182,4.4
2020,CB2020,047,3,Brooklyn,30874011003,262,144,118,4.36
2020,CB2020,047,3,Brooklyn,30874012000,1000,443,557,4.35
2020,CB2020,047,3,Brooklyn,30874012001,556,242,314,5.09
2020,CB2020,047,3,Brooklyn,30874012002,557,258,299,4.74
2020,CB2020,047,3,Brooklyn,30876001000,988,445,543,5.23
2020,CB2020,047,3,Brooklyn,30876001001,203,98,105,4.82
2020,CB2020,047,3,Brooklyn,30876001002,0,0,0,9.68
2020,CB2020,047,3,Brooklyn,30876002000,310,156,154,5.19
2020,CB2020,047,3,Brooklyn,30876002001,341,159,182,5
2020,CB2020,047,3,Brooklyn,30876002002,256,130,126,5.21
2020,CB2020,047,3,Brooklyn,30878001000,630,284,346,5.01
2020,CB2020,047,3,Brooklyn,30878001001,353,189,164,5.4
2020,CB2020,047,3,Brooklyn,30878002000,128,61,67,5.42
2020,CB2020,047,3,Brooklyn,30878002001,103,45,58,10.19
2020,CB2020,047,3,Brooklyn,30878003000,562,243,319,3.8
2020,CB2020,047,3,Brooklyn,30878003001,643,270,373,3.65
2020,CB2020,047,3,Brooklyn,30878003002,311,149,162,3.95
2020,CB2020,047,3,Brooklyn,30880011000,273,110,163,4.71
2020,CB2020,047,3,Brooklyn,30880011001,0,0,0,0.73
2020,CB2020,047,3,Brooklyn,30880011002,538,239,299,4.82
2020,CB2020,047,3,Brooklyn,30880011003,520,249,271,1.61
2020,CB2020,047,3,Brooklyn,30880011004,230,97,133,3.24
2020,CB2020,047,3,Brooklyn,30880012000,566,230,336,5.01
2020,CB2020,047,3,Brooklyn,30880021000,407,179,228,7.09
2020,CB2020,047,3,Brooklyn,30880021001,0,0,0,0.35
2020,CB2020,047,3,Brooklyn,30880021002,155,83,72,4.77
2020,CB2020,047,3,Brooklyn,30880021003,252,113,139,2.72
2020,CB2020,047,3,Brooklyn,30880021004,155,88,67,5.05
2020,CB2020,047,3,Brooklyn,30880021005,405,194,211,4.98
2020,CB2020,047,3,Brooklyn,30882001000,1504,669,835,11.25
2020,CB2020,047,3,Brooklyn,30882001001,645,277,368,6.04
2020,CB2020,047,3,Brooklyn,30882002000,737,331,406,4.65
2020,CB2020,047,3,Brooklyn,30882002001,801,320,481,4.66
2020,CB2020,047,3,Brooklyn,30882003000,654,296,358,4.64
2020,CB2020,047,3,Brooklyn,30882003001,626,256,370,4.66
2020,CB2020,047,3,Brooklyn,30882004000,796,368,428,4.64
2020,CB2020,047,3,Brooklyn,30882004001,551,241,310,4.66
2020,CB2020,047,3,Brooklyn,30882004002,490,195,295,5
2020,CB2020,047,3,Brooklyn,30884001000,1030,440,590,5.99
2020,CB2020,047,3,Brooklyn,30884001001,725,318,407,5.24
2020,CB2020,047,3,Brooklyn,30884002000,560,238,322,5.72
2020,CB2020,047,3,Brooklyn,30884002001,558,241,317,4.64
2020,CB2020,047,3,Brooklyn,30884002002,591,309,282,4.66
2020,CB2020,047,3,Brooklyn,30884003000,717,304,413,5.73
2020,CB2020,047,3,Brooklyn,30884003001,725,349,376,4.64
2020,CB2020,047,3,Brooklyn,30884003002,607,283,324,4.67
2020,CB2020,047,3,Brooklyn,30886001000,233,127,106,3.39
2020,CB2020,047,3,Brooklyn,30886001001,708,295,413,3.93
2020,CB2020,047,3,Brooklyn,30886001002,294,146,148,4.62
2020,CB2020,047,3,Brooklyn,30886002000,369,163,206,2.34
2020,CB2020,047,3,Brooklyn,30886002001,837,406,431,5.72
2020,CB2020,047,3,Brooklyn,30886002002,266,125,141,4.66
2020,CB2020,047,3,Brooklyn,30886002003,0,0,0,0.75
2020,CB2020,047,3,Brooklyn,30886003000,660,302,358,4.32
2020,CB2020,047,3,Brooklyn,30886003001,0,0,0,0.36
2020,CB2020,047,3,Brooklyn,30886003002,174,77,97,1.39
2020,CB2020,047,3,Brooklyn,30886003003,148,59,89,2.44
2020,CB2020,047,3,Brooklyn,30886003004,217,97,120,2.22
2020,CB2020,047,3,Brooklyn,30886003005,335,148,187,3.27
2020,CB2020,047,3,Brooklyn,30886003006,43,25,18,1.2
2020,CB2020,047,3,Brooklyn,30886003007,263,132,131,3.8
2020,CB2020,047,3,Brooklyn,30888001000,622,251,371,4.63
2020,CB2020,047,3,Brooklyn,30888001001,640,307,333,4.6
2020,CB2020,047,3,Brooklyn,30888001002,8,4,4,0.44
2020,CB2020,047,3,Brooklyn,30888001003,50,26,24,1.35
2020,CB2020,047,3,Brooklyn,30888001004,0,0,0,0.52
2020,CB2020,047,3,Brooklyn,30888002000,0,0,0,1.09
2020,CB2020,047,3,Brooklyn,30888002001,0,0,0,0.45
2020,CB2020,047,3,Brooklyn,30888002002,356,129,227,3.75
2020,CB2020,047,3,Brooklyn,30888002003,221,101,120,2.29
2020,CB2020,047,3,Brooklyn,30888002004,50,16,34,0.83
2020,CB2020,047,3,Brooklyn,30888002005,311,151,160,4.68
2020,CB2020,047,3,Brooklyn,30888002006,359,177,182,4.64
2020,CB2020,047,3,Brooklyn,30888003000,546,240,306,3.15
2020,CB2020,047,3,Brooklyn,30888003001,154,64,90,1.7
2020,CB2020,047,3,Brooklyn,30888003002,0,0,0,0.34
2020,CB2020,047,3,Brooklyn,30888003003,0,0,0,0.53
2020,CB2020,047,3,Brooklyn,30888003004,0,0,0,0.49
2020,CB2020,047,3,Brooklyn,30888003005,0,0,0,0.5
2020,CB2020,047,3,Brooklyn,30888003006,0,0,0,0.5
2020,CB2020,047,3,Brooklyn,30888003007,0,0,0,0.37
2020,CB2020,047,3,Brooklyn,30888003008,0,0,0,0.44
2020,CB2020,047,3,Brooklyn,30888003009,281,126,155,2.02
2020,CB2020,047,3,Brooklyn,30888003010,0,0,0,0.59
2020,CB2020,047,3,Brooklyn,30888003011,117,48,69,3.77
2020,CB2020,047,3,Brooklyn,30888003012,286,126,160,5.03
2020,CB2020,047,3,Brooklyn,30888003013,0,0,0,1.02
2020,CB2020,047,3,Brooklyn,30890001000,868,418,450,5.69
2020,CB2020,047,3,Brooklyn,30890001001,0,0,0,0.16
2020,CB2020,047,3,Brooklyn,30890001002,448,206,242,3.46
2020,CB2020,047,3,Brooklyn,30890002000,630,260,370,5.8
2020,CB2020,047,3,Brooklyn,30890002001,790,328,462,5.2
2020,CB2020,047,3,Brooklyn,30890003000,683,317,366,5.7
2020,CB2020,047,3,Brooklyn,30890004000,1028,462,566,5.18
2020,CB2020,047,3,Brooklyn,30890004001,673,314,359,5.72
2020,CB2020,047,3,Brooklyn,30890005000,289,119,170,5.15
2020,CB2020,047,3,Brooklyn,30890005001,368,149,219,3.63
2020,CB2020,047,3,Brooklyn,30890005002,0,0,0,1.24
2020,CB2020,047,3,Brooklyn,30890006000,54,24,30,3.16
2020,CB2020,047,3,Brooklyn,30890006001,351,193,158,2.41
2020,CB2020,047,3,Brooklyn,30890006002,501,270,231,7.83
2020,CB2020,047,3,Brooklyn,30890006003,0,0,0,0.62
2020,CB2020,047,3,Brooklyn,30890006004,0,0,0,0.42
2020,CB2020,047,3,Brooklyn,30892001000,207,92,115,5.21
2020,CB2020,047,3,Brooklyn,30892001001,432,190,242,5.06
2020,CB2020,047,3,Brooklyn,30892002000,303,146,157,5.75
2020,CB2020,047,3,Brooklyn,30892002001,778,344,434,5.2
2020,CB2020,047,3,Brooklyn,30892003000,252,119,133,5.41
2020,CB2020,047,3,Brooklyn,30892003001,876,400,476,5.16
2020,CB2020,047,3,Brooklyn,30892003002,0,0,0,1.72
2020,CB2020,047,3,Brooklyn,30892003003,0,0,0,0.31
2020,CB2020,047,3,Brooklyn,30892004000,314,125,189,2.95
2020,CB2020,047,3,Brooklyn,30892004001,0,0,0,0.43
2020,CB2020,047,3,Brooklyn,30892004002,270,115,155,3.28
2020,CB2020,047,3,Brooklyn,30892004003,0,0,0,0.72
2020,CB2020,047,3,Brooklyn,30892004004,0,0,0,0.32
2020,CB2020,047,3,Brooklyn,30892004005,241,109,132,2.86
2020,CB2020,047,3,Brooklyn,30894001000,236,102,134,3.54
2020,CB2020,047,3,Brooklyn,30894001001,224,91,133,3.4
2020,CB2020,047,3,Brooklyn,30894001002,365,167,198,3.54
2020,CB2020,047,3,Brooklyn,30894002000,205,93,112,3.55
2020,CB2020,047,3,Brooklyn,30894002001,243,97,146,3.41
2020,CB2020,047,3,Brooklyn,30894002002,115,47,68,3.51
2020,CB2020,047,3,Brooklyn,30894002003,168,82,86,2.36
2020,CB2020,047,3,Brooklyn,30894002004,323,148,175,3.42
2020,CB2020,047,3,Brooklyn,30894003000,444,199,245,3.53
2020,CB2020,047,3,Brooklyn,30894003001,530,223,307,3.53
2020,CB2020,047,3,Brooklyn,30894004000,463,183,280,3.54
2020,CB2020,047,3,Brooklyn,30894004001,381,166,215,3.55
2020,CB2020,047,3,Brooklyn,30894004002,137,62,75,1.68
2020,CB2020,047,3,Brooklyn,30896001000,343,183,160,3.54
2020,CB2020,047,3,Brooklyn,30896001001,402,168,234,3.4
2020,CB2020,047,3,Brooklyn,30896001002,131,39,92,3.41
2020,CB2020,047,3,Brooklyn,30896002000,387,176,211,3.53
2020,CB2020,047,3,Brooklyn,30896002001,549,266,283,3.4
2020,CB2020,047,3,Brooklyn,30896002002,554,231,323,3.72
2020,CB2020,047,3,Brooklyn,30896002003,349,180,169,3.87
2020,CB2020,047,3,Brooklyn,30896003000,530,244,286,3.41
2020,CB2020,047,3,Brooklyn,30896003001,489,214,275,3.44
2020,CB2020,047,3,Brooklyn,30896003002,130,40,90,1.19
2020,CB2020,047,3,Brooklyn,30896003003,0,0,0,0.73
2020,CB2020,047,3,Brooklyn,30896003004,217,129,88,3.2
2020,CB2020,047,3,Brooklyn,30898001000,244,120,124,3.54
2020,CB2020,047,3,Brooklyn,30898001001,175,73,102,3.4
2020,CB2020,047,3,Brooklyn,30898001002,300,150,150,3.4
2020,CB2020,047,3,Brooklyn,30898001003,248,90,158,3.55
2020,CB2020,047,3,Brooklyn,30898002000,0,0,0,10.36
2020,CB2020,047,3,Brooklyn,30898002001,312,160,152,3.54
2020,CB2020,047,3,Brooklyn,30898002002,412,170,242,3.41
2020,CB2020,047,3,Brooklyn,30898002003,329,150,179,3.4
2020,CB2020,047,3,Brooklyn,30898002004,309,132,177,3.55
2020,CB2020,047,3,Brooklyn,30900001000,27,18,9,1.29
2020,CB2020,047,3,Brooklyn,30900001001,307,153,154,5.8
2020,CB2020,047,3,Brooklyn,30900001002,290,140,150,3.53
2020,CB2020,047,3,Brooklyn,30900002000,0,0,0,0.7
2020,CB2020,047,3,Brooklyn,30900002001,445,184,261,5.6
2020,CB2020,047,3,Brooklyn,30900002002,113,49,64,3.41
2020,CB2020,047,3,Brooklyn,30900003000,0,0,0,0.21
2020,CB2020,047,3,Brooklyn,30900003001,583,213,370,5.27
2020,CB2020,047,3,Brooklyn,30900003002,253,132,121,3.49
2020,CB2020,047,3,Brooklyn,30900004000,686,317,369,5.92
2020,CB2020,047,3,Brooklyn,30900004001,315,149,166,3.58
2020,CB2020,047,3,Brooklyn,30900005000,575,246,329,4.66
2020,CB2020,047,3,Brooklyn,30900005001,476,204,272,3.41
2020,CB2020,047,3,Brooklyn,30900006000,574,235,339,4.27
2020,CB2020,047,3,Brooklyn,30900006001,298,136,162,3.5
2020,CB2020,047,3,Brooklyn,30900007000,447,178,269,5.1
2020,CB2020,047,3,Brooklyn,30900007001,45,15,30,1.1
2020,CB2020,047,3,Brooklyn,30902001000,128,52,76,3.4
2020,CB2020,047,3,Brooklyn,30902001001,418,191,227,2.85
2020,CB2020,047,3,Brooklyn,30902001002,501,222,279,2.32
2020,CB2020,047,3,Brooklyn,30902001003,37,24,13,1.87
2020,CB2020,047,3,Brooklyn,30902002000,641,291,350,3.54
2020,CB2020,047,3,Brooklyn,30902003000,597,252,345,3.4
2020,CB2020,047,3,Brooklyn,30902004000,299,131,168,5.8
2020,CB2020,047,3,Brooklyn,30902004001,283,136,147,3.53
2020,CB2020,047,3,Brooklyn,30902004002,267,139,128,3.4
2020,CB2020,047,3,Brooklyn,30902005000,173,77,96,5.8
2020,CB2020,047,3,Brooklyn,30902005001,238,130,108,5.58
2020,CB2020,047,3,Brooklyn,30902005002,235,83,152,5.57
2020,CB2020,047,3,Brooklyn,30906001000,136,61,75,2.96
2020,CB2020,047,3,Brooklyn,30906001001,816,337,479,8.45
2020,CB2020,047,3,Brooklyn,30906002000,259,105,154,2.95
2020,CB2020,047,3,Brooklyn,30906002001,21,8,13,2.79
2020,CB2020,047,3,Brooklyn,30906002002,196,86,110,2.8
2020,CB2020,047,3,Brooklyn,30906002003,53,16,37,2.87
2020,CB2020,047,3,Brooklyn,30906002004,1539,661,878,11.42
2020,CB2020,047,3,Brooklyn,30906003000,1514,584,930,14.13
2020,CB2020,047,3,Brooklyn,30908001000,1871,749,1122,4.47
2020,CB2020,047,3,Brooklyn,30908001001,418,169,249,2.81
2020,CB2020,047,3,Brooklyn,30908001002,17,12,5,2.75
2020,CB2020,047,3,Brooklyn,30908001003,0,0,0,3.75
2020,CB2020,047,3,Brooklyn,30908001004,27,10,17,3.19
2020,CB2020,047,3,Brooklyn,30908001005,7,7,0,2.68
2020,CB2020,047,3,Brooklyn,30908001006,86,50,36,2.29
2020,CB2020,047,3,Brooklyn,30908001007,196,88,108,2.92
2020,CB2020,047,3,Brooklyn,30908001008,0,0,0,2.75
2020,CB2020,047,3,Brooklyn,30908001009,257,105,152,2.75
2020,CB2020,047,3,Brooklyn,30908001010,598,270,328,5.59
2020,CB2020,047,3,Brooklyn,30908001011,130,94,36,2.82
2020,CB2020,047,3,Brooklyn,30908001012,0,0,0,2.93
2020,CB2020,047,3,Brooklyn,30908001013,367,140,227,2.97
2020,CB2020,047,3,Brooklyn,30908002000,0,0,0,5.86
2020,CB2020,047,3,Brooklyn,30908002001,0,0,0,2.85
2020,CB2020,047,3,Brooklyn,30908002002,1116,476,640,5.59
2020,CB2020,047,3,Brooklyn,30908003000,4,2,2,2.86
2020,CB2020,047,3,Brooklyn,30908003001,394,182,212,2.73
2020,CB2020,047,3,Brooklyn,30908003002,0,0,0,2.8
2020,CB2020,047,3,Brooklyn,30908003003,68,31,37,2.94
2020,CB2020,047,3,Brooklyn,30908003004,337,136,201,2.95
2020,CB2020,047,3,Brooklyn,30910001000,1000,422,578,6.64
2020,CB2020,047,3,Brooklyn,30910001001,732,300,432,3.6
2020,CB2020,047,3,Brooklyn,30910002000,1421,578,843,10.2
2020,CB2020,047,3,Brooklyn,30910003000,1570,634,936,10.42
2020,CB2020,047,3,Brooklyn,30910004000,35,14,21,3.56
2020,CB2020,047,3,Brooklyn,30910004001,284,197,87,3.53
2020,CB2020,047,3,Brooklyn,30910004002,220,109,111,3.55
2020,CB2020,047,3,Brooklyn,30910004003,0,0,0,3.65
2020,CB2020,047,3,Brooklyn,30910004004,9,8,1,3.74
2020,CB2020,047,3,Brooklyn,30910004005,543,230,313,3.52
2020,CB2020,047,3,Brooklyn,30912001000,1649,640,1009,13.7
2020,CB2020,047,3,Brooklyn,30912002000,1103,441,662,7.15
2020,CB2020,047,3,Brooklyn,30912002001,950,420,530,6.55
2020,CB2020,047,3,Brooklyn,30912003000,2870,1196,1674,13.93
2020,CB2020,047,3,Brooklyn,30916001000,394,202,192,3.47
2020,CB2020,047,3,Brooklyn,30916001001,416,183,233,3.4
2020,CB2020,047,3,Brooklyn,30916001002,386,170,216,3.53
2020,CB2020,047,3,Brooklyn,30916002000,141,60,81,3.48
2020,CB2020,047,3,Brooklyn,30916002001,257,115,142,3.47
2020,CB2020,047,3,Brooklyn,30916002002,391,146,245,3.41
2020,CB2020,047,3,Brooklyn,30916002003,364,157,207,3.54
2020,CB2020,047,3,Brooklyn,30916003000,291,116,175,3.48
2020,CB2020,047,3,Brooklyn,30916003001,186,93,93,3.47
2020,CB2020,047,3,Brooklyn,30916003002,333,149,184,3.77
2020,CB2020,047,3,Brooklyn,30916003003,338,151,187,3.78
2020,CB2020,047,3,Brooklyn,30916004000,403,168,235,3.41
2020,CB2020,047,3,Brooklyn,30916004001,471,206,265,3.53
2020,CB2020,047,3,Brooklyn,30916004002,548,243,305,3.83
2020,CB2020,047,3,Brooklyn,30916004003,390,183,207,3.73
2020,CB2020,047,3,Brooklyn,30918001000,22,17,5,3.56
2020,CB2020,047,3,Brooklyn,30918001001,1312,531,781,6.84
2020,CB2020,047,3,Brooklyn,30918001002,20,7,13,3.47
2020,CB2020,047,3,Brooklyn,30918001003,308,146,162,3.56
2020,CB2020,047,3,Brooklyn,30918001004,101,24,77,3.42
2020,CB2020,047,3,Brooklyn,30918001005,0,0,0,3.41
2020,CB2020,047,3,Brooklyn,30918002000,147,71,76,3.41
2020,CB2020,047,3,Brooklyn,30918002001,76,37,39,3.37
2020,CB2020,047,3,Brooklyn,30918002002,166,80,86,3.41
2020,CB2020,047,3,Brooklyn,30918002003,140,53,87,3.57
2020,CB2020,047,3,Brooklyn,30918002004,17,15,2,3.58
2020,CB2020,047,3,Brooklyn,30918002005,163,57,106,3.41
2020,CB2020,047,3,Brooklyn,30918002006,150,59,91,3.4
2020,CB2020,047,3,Brooklyn,30918002007,81,41,40,3.4
2020,CB2020,047,3,Brooklyn,30920001000,304,104,200,3.4
2020,CB2020,047,3,Brooklyn,30920001001,450,199,251,3.69
2020,CB2020,047,3,Brooklyn,30920002000,132,56,76,3.58
2020,CB2020,047,3,Brooklyn,30920002001,298,113,185,3.4
2020,CB2020,047,3,Brooklyn,30920002002,1224,513,711,7.23
2020,CB2020,047,3,Brooklyn,30920002003,25,11,14,0.36
2020,CB2020,047,3,Brooklyn,30920003000,0,0,0,4.27
2020,CB2020,047,3,Brooklyn,30920003001,176,57,119,3.4
2020,CB2020,047,3,Brooklyn,30920003002,203,101,102,3.41
2020,CB2020,047,3,Brooklyn,30920003003,151,55,96,3.41
2020,CB2020,047,3,Brooklyn,30920003004,166,60,106,3.57
2020,CB2020,047,3,Brooklyn,30920003005,94,55,39,2.86
2020,CB2020,047,3,Brooklyn,30920003006,80,46,34,2.18
2020,CB2020,047,3,Brooklyn,30920003007,71,39,32,1.63
2020,CB2020,047,3,Brooklyn,30920003008,55,32,23,1.08
2020,CB2020,047,3,Brooklyn,30920003009,28,12,16,1
2020,CB2020,047,3,Brooklyn,30920003010,10,4,6,1.55
2020,CB2020,047,3,Brooklyn,30920003011,24,10,14,2.1
2020,CB2020,047,3,Brooklyn,30920004000,0,0,0,3.06
2020,CB2020,047,3,Brooklyn,30920004001,0,0,0,1.53
2020,CB2020,047,3,Brooklyn,30920004002,0,0,0,1.9
2020,CB2020,047,3,Brooklyn,30922001000,0,0,0,2.8
2020,CB2020,047,3,Brooklyn,30922001001,195,64,131,2.73
2020,CB2020,047,3,Brooklyn,30922001002,328,144,184,3.21
2020,CB2020,047,3,Brooklyn,30922001003,305,176,129,3.05
2020,CB2020,047,3,Brooklyn,30922001004,154,81,73,6.13
2020,CB2020,047,3,Brooklyn,30922001005,0,0,0,1.46
2020,CB2020,047,3,Brooklyn,30922001006,0,0,0,1.09
2020,CB2020,047,3,Brooklyn,30922002000,766,280,486,6.14
2020,CB2020,047,3,Brooklyn,30922002001,778,349,429,3.15
2020,CB2020,047,3,Brooklyn,30922002002,0,0,0,0.37
2020,CB2020,047,3,Brooklyn,30922002003,0,0,0,0.78
2020,CB2020,047,3,Brooklyn,30922002004,0,0,0,0.74
2020,CB2020,047,3,Brooklyn,30922002005,373,191,182,4.29
2020,CB2020,047,3,Brooklyn,30922002006,132,64,68,3.94
2020,CB2020,047,3,Brooklyn,30924001000,152,82,70,5.07
2020,CB2020,047,3,Brooklyn,30924001001,59,48,11,4.56
2020,CB2020,047,3,Brooklyn,30924001002,485,206,279,4.22
2020,CB2020,047,3,Brooklyn,30924001003,478,227,251,5.78
2020,CB2020,047,3,Brooklyn,30924001004,98,42,56,5.7
2020,CB2020,047,3,Brooklyn,30924001005,500,237,263,5.61
2020,CB2020,047,3,Brooklyn,30924002000,167,94,73,3.41
2020,CB2020,047,3,Brooklyn,30924002001,0,0,0,3.46
2020,CB2020,047,3,Brooklyn,30924002002,140,58,82,3.54
2020,CB2020,047,3,Brooklyn,30924002003,3,2,1,3.54
2020,CB2020,047,3,Brooklyn,30924002004,214,81,133,3.44
2020,CB2020,047,3,Brooklyn,30924002005,152,70,82,3.45
2020,CB2020,047,3,Brooklyn,30924002006,398,175,223,3.48
2020,CB2020,047,3,Brooklyn,30924003000,484,193,291,3.4
2020,CB2020,047,3,Brooklyn,30924003001,298,117,181,3.53
2020,CB2020,047,3,Brooklyn,30928001000,0,0,0,0.56
2020,CB2020,047,3,Brooklyn,30928001001,362,161,201,4.12
2020,CB2020,047,3,Brooklyn,30928001002,538,260,278,5.69
2020,CB2020,047,3,Brooklyn,30928001003,465,197,268,4.66
2020,CB2020,047,3,Brooklyn,30928002000,0,0,0,0.7
2020,CB2020,047,3,Brooklyn,30928002001,325,153,172,2.65
2020,CB2020,047,3,Brooklyn,30928002002,210,106,104,5.04
2020,CB2020,047,3,Brooklyn,30928002003,346,149,197,4.48
2020,CB2020,047,3,Brooklyn,30928002004,316,150,166,4.98
2020,CB2020,047,3,Brooklyn,30928002005,218,76,142,4.07
2020,CB2020,047,3,Brooklyn,30928003000,0,0,0,0.37
2020,CB2020,047,3,Brooklyn,30928003001,81,41,40,1.52
2020,CB2020,047,3,Brooklyn,30930001000,125,46,79,4.66
2020,CB2020,047,3,Brooklyn,30930001001,282,117,165,4.65
2020,CB2020,047,3,Brooklyn,30930001002,327,152,175,4.66
2020,CB2020,047,3,Brooklyn,30930001003,277,133,144,5
2020,CB2020,047,3,Brooklyn,30930002000,249,104,145,4.06
2020,CB2020,047,3,Brooklyn,30930002001,248,116,132,4.06
2020,CB2020,047,3,Brooklyn,30930002002,52,20,32,4.04
2020,CB2020,047,3,Brooklyn,30930002003,258,110,148,4.38
2020,CB2020,047,3,Brooklyn,30930002004,333,127,206,4.37
2020,CB2020,047,3,Brooklyn,30930002005,235,121,114,4.03
2020,CB2020,047,3,Brooklyn,30930002006,181,70,111,4.09
2020,CB2020,047,3,Brooklyn,30932001000,0,0,0,0.88
2020,CB2020,047,3,Brooklyn,30932001001,0,0,0,3.64
2020,CB2020,047,3,Brooklyn,30932001002,0,0,0,4.5
2020,CB2020,047,3,Brooklyn,30932001003,0,0,0,5.49
2020,CB2020,047,3,Brooklyn,30932001004,164,79,85,5.49
2020,CB2020,047,3,Brooklyn,30932001005,415,189,226,5.1
2020,CB2020,047,3,Brooklyn,30932001006,333,118,215,5.3
2020,CB2020,047,3,Brooklyn,30932001007,275,146,129,5.3
2020,CB2020,047,3,Brooklyn,30932001008,59,17,42,4.82
2020,CB2020,047,3,Brooklyn,30932001009,31,16,15,5.97
2020,CB2020,047,3,Brooklyn,30932001010,0,0,0,2.6
2020,CB2020,047,3,Brooklyn,30932001011,0,0,0,10.39
2020,CB2020,047,3,Brooklyn,30932001012,0,0,0,7.02
2020,CB2020,047,3,Brooklyn,30932001013,0,0,0,1.59
2020,CB2020,047,3,Brooklyn,30932001014,0,0,0,1.21
2020,CB2020,047,3,Brooklyn,30934001000,260,114,146,5.36
2020,CB2020,047,3,Brooklyn,30934001001,327,177,150,5.02
2020,CB2020,047,3,Brooklyn,30934001002,241,83,158,4.64
2020,CB2020,047,3,Brooklyn,30934001003,323,145,178,3.7
2020,CB2020,047,3,Brooklyn,30934001004,85,33,52,1.37
2020,CB2020,047,3,Brooklyn,30934002000,288,137,151,4.68
2020,CB2020,047,3,Brooklyn,30934002001,252,117,135,4
2020,CB2020,047,3,Brooklyn,30934002002,154,64,90,4.05
2020,CB2020,047,3,Brooklyn,30934002003,109,45,64,2.66
2020,CB2020,047,3,Brooklyn,30934002004,85,29,56,1.86
2020,CB2020,047,3,Brooklyn,30934002005,93,41,52,2.16
2020,CB2020,047,3,Brooklyn,30934002006,122,57,65,2.19
2020,CB2020,047,3,Brooklyn,30934002007,127,66,61,2.23
2020,CB2020,047,3,Brooklyn,30936001000,107,44,63,2.12
2020,CB2020,047,3,Brooklyn,30936001001,207,84,123,2.23
2020,CB2020,047,3,Brooklyn,30936001002,405,182,223,6.7
2020,CB2020,047,3,Brooklyn,30936001003,252,130,122,4.2
2020,CB2020,047,3,Brooklyn,30936002000,178,46,132,2.39
2020,CB2020,047,3,Brooklyn,30936002001,153,68,85,2.15
2020,CB2020,047,3,Brooklyn,30936002002,46,30,16,4.36
2020,CB2020,047,3,Brooklyn,30936002003,0,0,0,8.12
2020,CB2020,047,3,Brooklyn,30936002004,278,161,117,4.11
2020,CB2020,047,3,Brooklyn,30936002005,140,47,93,2.28
2020,CB2020,047,3,Brooklyn,30936002006,88,40,48,2.16
2020,CB2020,047,3,Brooklyn,30938001000,46,15,31,1.61
2020,CB2020,047,3,Brooklyn,30938001001,308,145,163,4.56
2020,CB2020,047,3,Brooklyn,30938001002,716,309,407,4.61
2020,CB2020,047,3,Brooklyn,30938001003,456,212,244,4.46
2020,CB2020,047,3,Brooklyn,30938002000,250,128,122,4.16
2020,CB2020,047,3,Brooklyn,30938002001,100,36,64,2.69
2020,CB2020,047,3,Brooklyn,30938002002,60,26,34,1.72
2020,CB2020,047,3,Brooklyn,30938002003,324,158,166,4.39
2020,CB2020,047,3,Brooklyn,30938002004,402,149,253,4.21
2020,CB2020,047,3,Brooklyn,30944011000,637,259,378,9.6
2020,CB2020,047,3,Brooklyn,30944011001,133,62,71,7.87
2020,CB2020,047,3,Brooklyn,30944012000,49,20,29,6.55
2020,CB2020,047,3,Brooklyn,30944012001,38,14,24,6.04
2020,CB2020,047,3,Brooklyn,30944012002,287,132,155,4.89
2020,CB2020,047,3,Brooklyn,30944012003,280,98,182,3.86
2020,CB2020,047,3,Brooklyn,30944012004,190,87,103,3.12
2020,CB2020,047,3,Brooklyn,30944012005,124,56,68,2.28
2020,CB2020,047,3,Brooklyn,30944012006,0,0,0,1.33
2020,CB2020,047,3,Brooklyn,30944012007,0,0,0,0.73
2020,CB2020,047,3,Brooklyn,30944013000,14,14,0,13.71
2020,CB2020,047,3,Brooklyn,30944013001,8,2,6,8.38
2020,CB2020,047,3,Brooklyn,30944013002,500,215,285,5.36
2020,CB2020,047,3,Brooklyn,30944013003,470,182,288,5.42
2020,CB2020,047,3,Brooklyn,30944014000,223,105,118,6.36
2020,CB2020,047,3,Brooklyn,30944014001,494,226,268,5.65
2020,CB2020,047,3,Brooklyn,30944021000,2810,1057,1753,26.41
2020,CB2020,047,3,Brooklyn,30946001000,250,127,123,4.22
2020,CB2020,047,3,Brooklyn,30946001001,44,25,19,1.3
2020,CB2020,047,3,Brooklyn,30946001002,79,22,57,2.9
2020,CB2020,047,3,Brooklyn,30946001003,160,51,109,4.06
2020,CB2020,047,3,Brooklyn,30946001004,209,88,121,4.16
2020,CB2020,047,3,Brooklyn,30946001005,0,0,0,0.46
2020,CB2020,047,3,Brooklyn,30946002000,265,88,177,4.11
2020,CB2020,047,3,Brooklyn,30946002001,272,111,161,4.25
2020,CB2020,047,3,Brooklyn,30946002002,146,85,61,3.69
2020,CB2020,047,3,Brooklyn,30946003000,7,5,2,4.25
2020,CB2020,047,3,Brooklyn,30946003001,22,15,7,3.99
2020,CB2020,047,3,Brooklyn,30946003002,24,19,5,5.01
2020,CB2020,047,3,Brooklyn,30946003003,313,130,183,5.62
2020,CB2020,047,3,Brooklyn,30946003004,152,51,101,2.28
2020,CB2020,047,3,Brooklyn,30946003005,65,36,29,2.15
2020,CB2020,047,3,Brooklyn,30946003006,71,43,28,17.17
2020,CB2020,047,3,Brooklyn,30950001000,384,145,239,4.6
2020,CB2020,047,3,Brooklyn,30950001001,350,154,196,4.27
2020,CB2020,047,3,Brooklyn,30950001002,135,64,71,18.68
2020,CB2020,047,3,Brooklyn,30950001003,405,181,224,5.19
2020,CB2020,047,3,Brooklyn,30950001004,52,18,34,1.01
2020,CB2020,047,3,Brooklyn,30950001005,10,8,2,1.65
2020,CB2020,047,3,Brooklyn,30950001006,246,97,149,4.54
2020,CB2020,047,3,Brooklyn,30950002000,0,0,0,0.62
2020,CB2020,047,3,Brooklyn,30950002001,402,169,233,5.75
2020,CB2020,047,3,Brooklyn,30950002002,208,93,115,3.27
2020,CB2020,047,3,Brooklyn,30950002003,344,129,215,5.05
2020,CB2020,047,3,Brooklyn,30950002004,634,309,325,5.27
2020,CB2020,047,3,Brooklyn,30954001000,315,150,165,5.09
2020,CB2020,047,3,Brooklyn,30954001001,279,127,152,5.36
2020,CB2020,047,3,Brooklyn,30954001002,427,180,247,5.44
2020,CB2020,047,3,Brooklyn,30954001003,418,196,222,5.84
2020,CB2020,047,3,Brooklyn,30954002000,476,226,250,4.78
2020,CB2020,047,3,Brooklyn,30954002001,471,183,288,4.77
2020,CB2020,047,3,Brooklyn,30954002002,583,260,323,4.76
2020,CB2020,047,3,Brooklyn,30954002003,635,288,347,5.13
2020,CB2020,047,3,Brooklyn,30954003000,360,162,198,4.27
2020,CB2020,047,3,Brooklyn,30954003001,387,173,214,4.27
2020,CB2020,047,3,Brooklyn,30954003002,383,169,214,4.27
2020,CB2020,047,3,Brooklyn,30954003003,422,183,239,4.6
2020,CB2020,047,3,Brooklyn,30956001000,33,11,22,4.7
2020,CB2020,047,3,Brooklyn,30956001001,375,158,217,5.08
2020,CB2020,047,3,Brooklyn,30956001002,394,173,221,5.19
2020,CB2020,047,3,Brooklyn,30956001003,435,191,244,5.16
2020,CB2020,047,3,Brooklyn,30956001004,465,192,273,5.99
2020,CB2020,047,3,Brooklyn,30956001005,275,134,141,3.94
2020,CB2020,047,3,Brooklyn,30956002000,328,137,191,4.71
2020,CB2020,047,3,Brooklyn,30956002001,296,130,166,4.72
2020,CB2020,047,3,Brooklyn,30956002002,494,220,274,4.89
2020,CB2020,047,3,Brooklyn,30956002003,416,179,237,4.9
2020,CB2020,047,3,Brooklyn,30956002004,422,177,245,4.71
2020,CB2020,047,3,Brooklyn,30956002005,458,235,223,4.72
2020,CB2020,047,3,Brooklyn,30958001000,228,95,133,3.58
2020,CB2020,047,3,Brooklyn,30958001001,335,146,189,5.62
2020,CB2020,047,3,Brooklyn,30958001002,428,200,228,5.58
2020,CB2020,047,3,Brooklyn,30958001003,303,122,181,5.39
2020,CB2020,047,3,Brooklyn,30958001004,171,67,104,2.07
2020,CB2020,047,3,Brooklyn,30958002000,334,158,176,4.2
2020,CB2020,047,3,Brooklyn,30958002001,111,38,73,2.21
2020,CB2020,047,3,Brooklyn,30958002002,112,32,80,2.13
2020,CB2020,047,3,Brooklyn,30958002003,438,199,239,4.78
2020,CB2020,047,3,Brooklyn,30958002004,419,212,207,4.95
2020,CB2020,047,3,Brooklyn,30958002005,279,107,172,4.44
2020,CB2020,047,3,Brooklyn,30958002006,282,148,134,4.44
2020,CB2020,047,3,Brooklyn,30958002007,89,39,50,4.26
2020,CB2020,047,3,Brooklyn,30958002008,241,96,145,4.26
2020,CB2020,047,3,Brooklyn,30960001000,1,0,1,8.08
2020,CB2020,047,3,Brooklyn,30960001001,0,0,0,7.18
2020,CB2020,047,3,Brooklyn,30960001002,0,0,0,4.43
2020,CB2020,047,3,Brooklyn,30960001003,2,1,1,5.25
2020,CB2020,047,3,Brooklyn,30960001004,0,0,0,5.5
2020,CB2020,047,3,Brooklyn,30960001005,0,0,0,20.41
2020,CB2020,047,3,Brooklyn,30960001006,0,0,0,19.08
2020,CB2020,047,3,Brooklyn,30960001007,0,0,0,1.68
2020,CB2020,047,3,Brooklyn,30960001008,0,0,0,0.51
2020,CB2020,047,3,Brooklyn,30960001009,0,0,0,1.72
2020,CB2020,047,3,Brooklyn,30960001010,0,0,0,1.57
2020,CB2020,047,3,Brooklyn,30960001011,0,0,0,3.93
2020,CB2020,047,3,Brooklyn,30960001012,0,0,0,1.65
2020,CB2020,047,3,Brooklyn,30960001013,0,0,0,0.51
2020,CB2020,047,3,Brooklyn,30960001014,0,0,0,2.61
2020,CB2020,047,3,Brooklyn,30960001015,0,0,0,2.7
2020,CB2020,047,3,Brooklyn,30960001016,0,0,0,4.37
2020,CB2020,047,3,Brooklyn,30960001017,0,0,0,1.69
2020,CB2020,047,3,Brooklyn,30960001018,0,0,0,1.74
2020,CB2020,047,3,Brooklyn,30960001019,3,2,1,1.58
2020,CB2020,047,3,Brooklyn,30960001020,0,0,0,1.58
2020,CB2020,047,3,Brooklyn,30960001021,0,0,0,5.38
2020,CB2020,047,3,Brooklyn,30960001022,0,0,0,1.58
2020,CB2020,047,3,Brooklyn,30962001000,25,13,12,0.83
2020,CB2020,047,3,Brooklyn,30962001001,20,4,16,4.83
2020,CB2020,047,3,Brooklyn,30962001002,383,170,213,5.8
2020,CB2020,047,3,Brooklyn,30962001003,100,75,25,2.65
2020,CB2020,047,3,Brooklyn,30962001004,32,9,23,3.78
2020,CB2020,047,3,Brooklyn,30962001005,313,161,152,6.29
2020,CB2020,047,3,Brooklyn,30962001006,340,165,175,4.3
2020,CB2020,047,3,Brooklyn,30962001007,194,93,101,2.49
2020,CB2020,047,3,Brooklyn,30962001008,55,8,47,2.84
2020,CB2020,047,3,Brooklyn,30962001009,0,0,0,3.52
2020,CB2020,047,3,Brooklyn,30962001010,0,0,0,1.59
2020,CB2020,047,3,Brooklyn,30962001011,114,40,74,3.15
2020,CB2020,047,3,Brooklyn,30962001012,125,77,48,2.2
2020,CB2020,047,3,Brooklyn,30964001000,475,243,232,5.45
2020,CB2020,047,3,Brooklyn,30964001001,155,64,91,2.51
2020,CB2020,047,3,Brooklyn,30964001002,138,65,73,1.66
2020,CB2020,047,3,Brooklyn,30964001003,80,35,45,2.01
2020,CB2020,047,3,Brooklyn,30964001004,53,17,36,3.04
2020,CB2020,047,3,Brooklyn,30964001005,122,36,86,1.88
2020,CB2020,047,3,Brooklyn,30964001006,221,109,112,2.61
2020,CB2020,047,3,Brooklyn,30964001007,82,33,49,1.61
2020,CB2020,047,3,Brooklyn,30964001008,57,22,35,0.99
2020,CB2020,047,3,Brooklyn,30964002000,187,82,105,2.96
2020,CB2020,047,3,Brooklyn,30964002001,123,50,73,2.19
2020,CB2020,047,3,Brooklyn,30964002002,111,52,59,3.42
2020,CB2020,047,3,Brooklyn,30964002003,95,34,61,1.67
2020,CB2020,047,3,Brooklyn,30964002004,202,86,116,2.81
2020,CB2020,047,3,Brooklyn,30964002005,212,93,119,4.58
2020,CB2020,047,3,Brooklyn,30964002006,308,159,149,4.26
2020,CB2020,047,3,Brooklyn,30966001000,229,94,135,3.9
2020,CB2020,047,3,Brooklyn,30966001001,344,156,188,5.08
2020,CB2020,047,3,Brooklyn,30966001002,370,171,199,5.08
2020,CB2020,047,3,Brooklyn,30966001003,324,140,184,4.71
2020,CB2020,047,3,Brooklyn,30966002000,110,46,64,3.59
2020,CB2020,047,3,Brooklyn,30966002001,143,72,71,4.01
2020,CB2020,047,3,Brooklyn,30966002002,220,105,115,4.71
2020,CB2020,047,3,Brooklyn,30966002003,158,67,91,3.33
2020,CB2020,047,3,Brooklyn,30966002004,192,66,126,3.9
2020,CB2020,047,3,Brooklyn,30966002005,106,51,55,1.62
2020,CB2020,047,3,Brooklyn,30966002006,59,26,33,1.4
2020,CB2020,047,3,Brooklyn,30966002007,45,16,29,1.66
2020,CB2020,047,3,Brooklyn,30966002008,53,16,37,1.79
2020,CB2020,047,3,Brooklyn,30968001000,121,58,63,1.56
2020,CB2020,047,3,Brooklyn,30968001001,59,23,36,3.19
2020,CB2020,047,3,Brooklyn,30968001002,279,110,169,5.25
2020,CB2020,047,3,Brooklyn,30968001003,115,57,58,2.95
2020,CB2020,047,3,Brooklyn,30968001004,66,28,38,2.67
2020,CB2020,047,3,Brooklyn,30968001005,50,26,24,2.02
2020,CB2020,047,3,Brooklyn,30968001006,90,46,44,2.24
2020,CB2020,047,3,Brooklyn,30968002000,200,98,102,4.27
2020,CB2020,047,3,Brooklyn,30968002001,256,117,139,4.27
2020,CB2020,047,3,Brooklyn,30968002002,121,61,60,2.39
2020,CB2020,047,3,Brooklyn,30968002003,72,32,40,2.39
2020,CB2020,047,3,Brooklyn,30968002004,76,41,35,1.82
2020,CB2020,047,3,Brooklyn,30968002005,50,8,42,1.82
2020,CB2020,047,3,Brooklyn,30970001000,0,0,0,3.43
2020,CB2020,047,3,Brooklyn,30970001001,75,37,38,3.75
2020,CB2020,047,3,Brooklyn,30970001002,232,103,129,2.01
2020,CB2020,047,3,Brooklyn,30970001003,0,0,0,1.73
2020,CB2020,047,3,Brooklyn,30970001004,369,169,200,5.13
2020,CB2020,047,3,Brooklyn,30970001005,439,191,248,5.72
2020,CB2020,047,3,Brooklyn,30970002000,239,90,149,3.01
2020,CB2020,047,3,Brooklyn,30970002001,259,103,156,4.66
2020,CB2020,047,3,Brooklyn,30970002002,187,80,107,1.64
2020,CB2020,047,3,Brooklyn,30970002003,331,173,158,4.65
2020,CB2020,047,3,Brooklyn,30970002004,226,93,133,4.66
2020,CB2020,047,3,Brooklyn,30974001000,531,255,276,4.46
2020,CB2020,047,3,Brooklyn,30974001001,395,299,96,4.36
2020,CB2020,047,3,Brooklyn,30974001002,421,192,229,4.32
2020,CB2020,047,3,Brooklyn,30974001003,75,28,47,12.91
2020,CB2020,047,3,Brooklyn,30974001004,103,53,50,1.47
2020,CB2020,047,3,Brooklyn,30974001005,50,13,37,6.51
2020,CB2020,047,3,Brooklyn,30974001006,70,44,26,1.72
2020,CB2020,047,3,Brooklyn,30974002000,362,141,221,4.41
2020,CB2020,047,3,Brooklyn,30974002001,354,156,198,4.22
2020,CB2020,047,3,Brooklyn,30974002002,0,0,0,4.2
2020,CB2020,047,3,Brooklyn,30974002003,192,89,103,2.43
2020,CB2020,047,3,Brooklyn,30974002004,84,26,58,1.81
2020,CB2020,047,3,Brooklyn,30974002005,79,44,35,1.89
2020,CB2020,047,3,Brooklyn,30974002006,119,50,69,2.47
2020,CB2020,047,3,Brooklyn,30974002007,55,35,20,2.95
2020,CB2020,047,3,Brooklyn,30974002008,21,7,14,2.24
2020,CB2020,047,3,Brooklyn,30982001000,1033,393,640,12.42
2020,CB2020,047,3,Brooklyn,30982001001,548,220,328,12.73
2020,CB2020,047,3,Brooklyn,30982001002,631,280,351,8.87
2020,CB2020,047,3,Brooklyn,30982002000,0,0,0,14.99
2020,CB2020,047,3,Brooklyn,30982002001,667,267,400,11.62
2020,CB2020,047,3,Brooklyn,30982002002,730,280,450,9.04
2020,CB2020,047,3,Brooklyn,30982002003,327,132,195,6.24
2020,CB2020,047,3,Brooklyn,30982002004,0,0,0,7.43
2020,CB2020,047,3,Brooklyn,30982002005,140,40,100,2.07
2020,CB2020,047,3,Brooklyn,30984001000,109,49,60,4.81
2020,CB2020,047,3,Brooklyn,30984001001,489,211,278,4.69
2020,CB2020,047,3,Brooklyn,30984001002,330,151,179,4.57
2020,CB2020,047,3,Brooklyn,30984001003,433,186,247,4.71
2020,CB2020,047,3,Brooklyn,30984001004,376,168,208,4.42
2020,CB2020,047,3,Brooklyn,30984001005,337,152,185,4.68
2020,CB2020,047,3,Brooklyn,30986001000,357,141,216,4.89
2020,CB2020,047,3,Brooklyn,30986001001,432,213,219,4.9
2020,CB2020,047,3,Brooklyn,30986001002,346,166,180,4.89
2020,CB2020,047,3,Brooklyn,30986001003,450,191,259,4.71
2020,CB2020,047,3,Brooklyn,30986002000,359,183,176,4.83
2020,CB2020,047,3,Brooklyn,30986002001,105,47,58,4.83
2020,CB2020,047,3,Brooklyn,30986002002,403,168,235,4.83
2020,CB2020,047,3,Brooklyn,30986002003,362,141,221,4.65
2020,CB2020,047,3,Brooklyn,30988001000,410,190,220,4.72
2020,CB2020,047,3,Brooklyn,30988001001,381,162,219,4.7
2020,CB2020,047,3,Brooklyn,30988001002,162,95,67,2.05
2020,CB2020,047,3,Brooklyn,30988001003,300,138,162,2.86
2020,CB2020,047,3,Brooklyn,30988001004,311,117,194,3.41
2020,CB2020,047,3,Brooklyn,30988001005,127,50,77,2.4
2020,CB2020,047,3,Brooklyn,30988002000,0,0,0,4.65
2020,CB2020,047,3,Brooklyn,30988002001,374,174,200,4.66
2020,CB2020,047,3,Brooklyn,30988002002,354,139,215,4.84
2020,CB2020,047,3,Brooklyn,30988002003,664,288,376,5.72
2020,CB2020,047,3,Brooklyn,30990001000,0,0,0,10.93
2020,CB2020,047,3,Brooklyn,30990001001,142,82,60,1.99
2020,CB2020,047,3,Brooklyn,30990001002,132,52,80,1.82
2020,CB2020,047,3,Brooklyn,30990001003,169,79,90,3.37
2020,CB2020,047,3,Brooklyn,30990001004,138,66,72,3.74
2020,CB2020,047,3,Brooklyn,30990001005,180,72,108,4.64
2020,CB2020,047,3,Brooklyn,30990001006,356,166,190,4.66
2020,CB2020,047,3,Brooklyn,30990001007,305,137,168,4.67
2020,CB2020,047,3,Brooklyn,30990001008,230,113,117,4.64
2020,CB2020,047,3,Brooklyn,30992001000,346,128,218,5.02
2020,CB2020,047,3,Brooklyn,30992001001,24,16,8,0.89
2020,CB2020,047,3,Brooklyn,30992001002,158,75,83,3.41
2020,CB2020,047,3,Brooklyn,30992001003,301,131,170,3.95
2020,CB2020,047,3,Brooklyn,30992001004,84,27,57,1.2
2020,CB2020,047,3,Brooklyn,30992001005,298,170,128,4.9
2020,CB2020,047,3,Brooklyn,30992001006,300,111,189,4.41
2020,CB2020,047,3,Brooklyn,30992001007,307,142,165,4.92
2020,CB2020,047,3,Brooklyn,30992001008,144,77,67,2.24
2020,CB2020,047,3,Brooklyn,30992001009,94,37,57,2.34
2020,CB2020,047,3,Brooklyn,30994001000,84,43,41,1.28
2020,CB2020,047,3,Brooklyn,30994001001,63,14,49,15.62
2020,CB2020,047,3,Brooklyn,30994001002,106,50,56,1.31
2020,CB2020,047,3,Brooklyn,30994001003,47,5,42,1.34
2020,CB2020,047,3,Brooklyn,30994001004,142,60,82,1.5
2020,CB2020,047,3,Brooklyn,30994001005,124,67,57,1.67
2020,CB2020,047,3,Brooklyn,30994001006,357,182,175,3.52
2020,CB2020,047,3,Brooklyn,30994001007,370,157,213,4.48
2020,CB2020,047,3,Brooklyn,30994001008,319,143,176,4.01
2020,CB2020,047,3,Brooklyn,30994001009,72,33,39,2.06
2020,CB2020,047,3,Brooklyn,30994001010,154,84,70,2.07
2020,CB2020,047,3,Brooklyn,30994001011,53,36,17,0.84
2020,CB2020,047,3,Brooklyn,30994001012,77,36,41,1.25
2020,CB2020,047,3,Brooklyn,30994001013,91,49,42,1.22
2020,CB2020,047,3,Brooklyn,30994001014,57,25,32,0.8
2020,CB2020,047,3,Brooklyn,30996001000,413,194,219,4.86
2020,CB2020,047,3,Brooklyn,30996001001,444,205,239,4.65
2020,CB2020,047,3,Brooklyn,30996001002,87,34,53,4.65
2020,CB2020,047,3,Brooklyn,30996001003,397,166,231,4.65
2020,CB2020,047,3,Brooklyn,30996001004,537,270,267,5.04
2020,CB2020,047,3,Brooklyn,30996002000,429,180,249,4.83
2020,CB2020,047,3,Brooklyn,30996002001,486,241,245,4.64
2020,CB2020,047,3,Brooklyn,30996002002,393,164,229,4.66
2020,CB2020,047,3,Brooklyn,30996002003,450,198,252,4.64
2020,CB2020,047,3,Brooklyn,30996002004,416,197,219,4.24
2020,CB2020,047,3,Brooklyn,30998001000,365,131,234,5
2020,CB2020,047,3,Brooklyn,30998001001,392,186,206,4.25
2020,CB2020,047,3,Brooklyn,30998001002,0,0,0,32.89
2020,CB2020,047,3,Brooklyn,30998001003,354,149,205,4.01
2020,CB2020,047,3,Brooklyn,30998001004,318,125,193,2.9
2020,CB2020,047,3,Brooklyn,30998001005,219,106,113,3.33
2020,CB2020,047,3,Brooklyn,30998001006,0,0,0,0
2020,CB2020,047,3,Brooklyn,30998001007,203,82,121,2.94
2020,CB2020,047,3,Brooklyn,30998001008,306,120,186,2.92
2020,CB2020,047,3,Brooklyn,30998002000,299,98,201,2.82
2020,CB2020,047,3,Brooklyn,30998002001,233,108,125,2.97
2020,CB2020,047,3,Brooklyn,30998002002,245,128,117,2.93
2020,CB2020,047,3,Brooklyn,30998002003,224,83,141,2.82
2020,CB2020,047,3,Brooklyn,30998002004,162,76,86,2.93
2020,CB2020,047,3,Brooklyn,30998002005,23,10,13,21.81
2020,CB2020,047,3,Brooklyn,30998002006,323,166,157,2.82
2020,CB2020,047,3,Brooklyn,30998002007,299,122,177,2.95
2020,CB2020,047,3,Brooklyn,30998002008,0,0,0,0
2020,CB2020,047,3,Brooklyn,30998002009,269,80,189,3.44
2020,CB2020,047,3,Brooklyn,31004001000,481,181,300,4.83
2020,CB2020,047,3,Brooklyn,31004001001,446,217,229,4.64
2020,CB2020,047,3,Brooklyn,31004001002,415,179,236,4.56
2020,CB2020,047,3,Brooklyn,31004001003,328,121,207,4.69
2020,CB2020,047,3,Brooklyn,31004001004,349,184,165,4.41
2020,CB2020,047,3,Brooklyn,31004001005,455,193,262,4.65
2020,CB2020,047,3,Brooklyn,31004001006,427,191,236,4.84
2020,CB2020,047,3,Brooklyn,31006001000,290,153,137,4.65
2020,CB2020,047,3,Brooklyn,31006001001,168,57,111,4.66
2020,CB2020,047,3,Brooklyn,31006001002,335,139,196,4.65
2020,CB2020,047,3,Brooklyn,31006001003,401,196,205,4.84
2020,CB2020,047,3,Brooklyn,31006002000,315,119,196,4.65
2020,CB2020,047,3,Brooklyn,31006002001,353,149,204,4.64
2020,CB2020,047,3,Brooklyn,31006002002,432,183,249,4.66
2020,CB2020,047,3,Brooklyn,31006002003,368,188,180,4.83
2020,CB2020,047,3,Brooklyn,31008001000,281,139,142,3.64
2020,CB2020,047,3,Brooklyn,31008001001,183,70,113,5.68
2020,CB2020,047,3,Brooklyn,31008001002,341,144,197,5.02
2020,CB2020,047,3,Brooklyn,31008001003,319,156,163,5.01
2020,CB2020,047,3,Brooklyn,31008002000,48,13,35,1.52
2020,CB2020,047,3,Brooklyn,31008002001,182,94,88,3.86
2020,CB2020,047,3,Brooklyn,31008002002,112,42,70,2.06
2020,CB2020,047,3,Brooklyn,31008002003,372,172,200,5
2020,CB2020,047,3,Brooklyn,31008002004,351,145,206,5.01
2020,CB2020,047,3,Brooklyn,31010001000,267,147,120,5.2
2020,CB2020,047,3,Brooklyn,31010001001,329,116,213,5.73
2020,CB2020,047,3,Brooklyn,31010001002,299,138,161,4.66
2020,CB2020,047,3,Brooklyn,31010001003,348,158,190,4.65
2020,CB2020,047,3,Brooklyn,31010002000,323,143,180,5.19
2020,CB2020,047,3,Brooklyn,31010002001,293,136,157,5.73
2020,CB2020,047,3,Brooklyn,31010002002,312,146,166,4.65
2020,CB2020,047,3,Brooklyn,31010002003,132,61,71,2.51
2020,CB2020,047,3,Brooklyn,31010002004,127,49,78,2.09
2020,CB2020,047,3,Brooklyn,31010002005,175,81,94,1.93
2020,CB2020,047,3,Brooklyn,31012001000,308,133,175,4.65
2020,CB2020,047,3,Brooklyn,31012001001,368,180,188,4.65
2020,CB2020,047,3,Brooklyn,31012001002,233,129,104,4.84
2020,CB2020,047,3,Brooklyn,31012001003,275,127,148,5.73
2020,CB2020,047,3,Brooklyn,31012002000,166,61,105,4.65
2020,CB2020,047,3,Brooklyn,31012002001,146,68,78,4.65
2020,CB2020,047,3,Brooklyn,31012002002,269,126,143,4.83
2020,CB2020,047,3,Brooklyn,31012002003,350,166,184,5.73
2020,CB2020,047,3,Brooklyn,31014001000,408,200,208,4.84
2020,CB2020,047,3,Brooklyn,31014001001,364,153,211,4.82
2020,CB2020,047,3,Brooklyn,31014001002,397,180,217,4.84
2020,CB2020,047,3,Brooklyn,31014001003,337,145,192,4.66
2020,CB2020,047,3,Brooklyn,31014002000,165,74,91,4.84
2020,CB2020,047,3,Brooklyn,31014002001,167,61,106,4.81
2020,CB2020,047,3,Brooklyn,31014002002,229,109,120,4.83
2020,CB2020,047,3,Brooklyn,31014002003,201,101,100,4.65
2020,CB2020,047,3,Brooklyn,31016001000,277,131,146,4.77
2020,CB2020,047,3,Brooklyn,31016001001,441,223,218,4.4
2020,CB2020,047,3,Brooklyn,31016001002,284,120,164,4.75
2020,CB2020,047,3,Brooklyn,31016001003,232,118,114,4.7
2020,CB2020,047,3,Brooklyn,31016001004,174,86,88,4.45
2020,CB2020,047,3,Brooklyn,31016001005,143,67,76,4.7
2020,CB2020,047,3,Brooklyn,31018001000,1101,524,577,42.07
2020,CB2020,047,3,Brooklyn,31018001001,162,67,95,4.43
2020,CB2020,047,3,Brooklyn,31018001002,145,79,66,4.71
2020,CB2020,047,3,Brooklyn,31018001003,134,56,78,4.7
2020,CB2020,047,3,Brooklyn,31018001004,118,45,73,4.65
2020,CB2020,047,3,Brooklyn,31018001005,167,89,78,4.54
2020,CB2020,047,3,Brooklyn,31018001006,203,106,97,5.02
2020,CB2020,047,3,Brooklyn,31020001000,168,70,98,4.86
2020,CB2020,047,3,Brooklyn,31020001001,153,58,95,4.82
2020,CB2020,047,3,Brooklyn,31020001002,194,71,123,4.86
2020,CB2020,047,3,Brooklyn,31020001003,171,86,85,4.66
2020,CB2020,047,3,Brooklyn,31020001004,526,253,273,4.72
2020,CB2020,047,3,Brooklyn,31020001005,440,220,220,5
2020,CB2020,047,3,Brooklyn,31020001006,260,151,109,4.96
2020,CB2020,047,3,Brooklyn,31020001007,274,119,155,4.92
2020,CB2020,047,3,Brooklyn,31022001000,228,102,126,4.66
2020,CB2020,047,3,Brooklyn,31022001001,358,152,206,4.65
2020,CB2020,047,3,Brooklyn,31022001002,385,192,193,4.84
2020,CB2020,047,3,Brooklyn,31022001003,131,77,54,5.74
2020,CB2020,047,3,Brooklyn,31022001004,161,56,105,5.85
2020,CB2020,047,3,Brooklyn,31022001005,245,128,117,4.96
2020,CB2020,047,3,Brooklyn,31022001006,380,181,199,4.8
2020,CB2020,047,3,Brooklyn,31022001007,425,196,229,4.75
2020,CB2020,047,3,Brooklyn,31024001000,184,70,114,5.34
2020,CB2020,047,3,Brooklyn,31024001001,409,169,240,5.85
2020,CB2020,047,3,Brooklyn,31024001002,362,151,211,4.95
2020,CB2020,047,3,Brooklyn,31024001003,239,118,121,3.14
2020,CB2020,047,3,Brooklyn,31024001004,409,195,214,4.82
2020,CB2020,047,3,Brooklyn,31024001005,58,42,16,1.47
2020,CB2020,047,3,Brooklyn,31024001006,395,195,200,4.69
2020,CB2020,047,3,Brooklyn,31024001007,201,100,101,5.11
2020,CB2020,047,3,Brooklyn,31026001000,297,140,157,5.13
2020,CB2020,047,3,Brooklyn,31026001001,412,177,235,4.79
2020,CB2020,047,3,Brooklyn,31026001002,487,218,269,4.76
2020,CB2020,047,3,Brooklyn,31026001003,506,214,292,4.74
2020,CB2020,047,3,Brooklyn,31026001004,485,231,254,4.92
2020,CB2020,047,3,Brooklyn,31026001005,446,207,239,4.96
2020,CB2020,047,3,Brooklyn,31026001006,340,144,196,4.29
2020,CB2020,047,3,Brooklyn,31028011000,95,56,39,6.72
2020,CB2020,047,3,Brooklyn,31028011001,0,0,0,2.11
2020,CB2020,047,3,Brooklyn,31028011002,19,7,12,2.16
2020,CB2020,047,3,Brooklyn,31028011003,82,26,56,3.41
2020,CB2020,047,3,Brooklyn,31028011004,253,119,134,3.83
2020,CB2020,047,3,Brooklyn,31028011005,217,91,126,2.07
2020,CB2020,047,3,Brooklyn,31028011006,24,17,7,3.17
2020,CB2020,047,3,Brooklyn,31028011007,67,24,43,0.9
2020,CB2020,047,3,Brooklyn,31028011008,154,69,85,3.06
2020,CB2020,047,3,Brooklyn,31028011009,115,51,64,1.47
2020,CB2020,047,3,Brooklyn,31028011010,291,129,162,3.68
2020,CB2020,047,3,Brooklyn,31028011011,274,130,144,3.23
2020,CB2020,047,3,Brooklyn,31028011012,163,79,84,2.23
2020,CB2020,047,3,Brooklyn,31028020001,0,0,0,0
2020,CB2020,047,3,Brooklyn,31028020002,0,0,0,0
2020,CB2020,047,3,Brooklyn,31028020003,0,0,0,0
2020,CB2020,047,3,Brooklyn,31028021000,5,4,1,120.2
2020,CB2020,047,3,Brooklyn,31028021001,0,0,0,0
2020,CB2020,047,3,Brooklyn,31028021002,0,0,0,7.15
2020,CB2020,047,3,Brooklyn,31028021003,0,0,0,86.4
2020,CB2020,047,3,Brooklyn,31034011000,2396,971,1425,21.41
2020,CB2020,047,3,Brooklyn,31034012000,1584,586,998,22.1
2020,CB2020,047,3,Brooklyn,31034020001,0,0,0,0
2020,CB2020,047,3,Brooklyn,31034021000,0,0,0,56.8
2020,CB2020,047,3,Brooklyn,31034021001,0,0,0,3.37
2020,CB2020,047,3,Brooklyn,31034021002,0,0,0,60.94
2020,CB2020,047,3,Brooklyn,31058011000,1704,660,1044,18.7
2020,CB2020,047,3,Brooklyn,31058011001,0,0,0,2.27
2020,CB2020,047,3,Brooklyn,31058012000,3183,1243,1940,33.93
2020,CB2020,047,3,Brooklyn,31058012001,0,0,0,2.35
2020,CB2020,047,3,Brooklyn,31058012002,0,0,0,2.84
2020,CB2020,047,3,Brooklyn,31058012003,0,0,0,2.41
2020,CB2020,047,3,Brooklyn,31058013000,2126,820,1306,29.47
2020,CB2020,047,3,Brooklyn,31058013001,0,0,0,2.36
2020,CB2020,047,3,Brooklyn,31058013002,0,0,0,8.2
2020,CB2020,047,3,Brooklyn,31058013003,0,0,0,0.88
2020,CB2020,047,3,Brooklyn,31058041000,701,288,413,82.11
2020,CB2020,047,3,Brooklyn,31058041001,0,0,0,0.65
2020,CB2020,047,3,Brooklyn,31058041002,0,0,0,0
2020,CB2020,047,3,Brooklyn,31058041003,0,0,0,0
2020,CB2020,047,3,Brooklyn,31058042000,757,232,525,22.08
2020,CB2020,047,3,Brooklyn,31058043000,2550,965,1585,21.83
2020,CB2020,047,3,Brooklyn,31058043001,17,13,4,2.42
2020,CB2020,047,3,Brooklyn,31058044000,2355,915,1440,41.56
2020,CB2020,047,3,Brooklyn,31058044001,102,35,67,2.68
2020,CB2020,047,3,Brooklyn,31058044002,0,0,0,2.27
2020,CB2020,047,3,Brooklyn,31058044003,0,0,0,0.28
2020,CB2020,047,3,Brooklyn,31058044004,0,0,0,12.82
2020,CB2020,047,3,Brooklyn,31058044005,0,0,0,1.63
2020,CB2020,047,3,Brooklyn,31070011000,0,0,0,12.78
2020,CB2020,047,3,Brooklyn,31070011001,0,0,0,10.24
2020,CB2020,047,3,Brooklyn,31070011002,118,35,83,3.35
2020,CB2020,047,3,Brooklyn,31070011003,133,81,52,3.52
2020,CB2020,047,3,Brooklyn,31070011004,927,386,541,24.55
2020,CB2020,047,3,Brooklyn,31070011005,383,149,234,3.21
2020,CB2020,047,3,Brooklyn,31070011006,270,123,147,4.94
2020,CB2020,047,3,Brooklyn,31070011007,213,77,136,6.36
2020,CB2020,047,3,Brooklyn,31070011008,28,5,23,40.7
2020,CB2020,047,3,Brooklyn,31070011009,36,23,13,3.53
2020,CB2020,047,3,Brooklyn,31070011010,21,16,5,38.24
2020,CB2020,047,3,Brooklyn,31070011011,958,420,538,114.85
2020,CB2020,047,3,Brooklyn,31070011012,456,180,276,7.3
2020,CB2020,047,3,Brooklyn,31070011013,0,0,0,19.95
2020,CB2020,047,3,Brooklyn,31070011014,0,0,0,1.82
2020,CB2020,047,3,Brooklyn,31070011015,0,0,0,2.96
2020,CB2020,047,3,Brooklyn,31070020001,0,0,0,0
2020,CB2020,047,3,Brooklyn,31070021000,0,0,0,489.69
2020,CB2020,047,3,Brooklyn,31070031000,0,0,0,67.12
2020,CB2020,047,3,Brooklyn,31070031001,0,0,0,0.86
2020,CB2020,047,3,Brooklyn,31078001000,0,0,0,3.78
2020,CB2020,047,3,Brooklyn,31078001001,0,0,0,6.72
2020,CB2020,047,3,Brooklyn,31078001002,0,0,0,3.43
2020,CB2020,047,3,Brooklyn,31078001003,0,0,0,3.41
2020,CB2020,047,3,Brooklyn,31078001004,0,0,0,3.41
2020,CB2020,047,3,Brooklyn,31078001005,0,0,0,3.41
2020,CB2020,047,3,Brooklyn,31078001006,0,0,0,3.4
2020,CB2020,047,3,Brooklyn,31078001007,0,0,0,3.42
2020,CB2020,047,3,Brooklyn,31078001008,38,19,19,3.31
2020,CB2020,047,3,Brooklyn,31078001009,241,113,128,3.57
2020,CB2020,047,3,Brooklyn,31078001010,255,99,156,3.27
2020,CB2020,047,3,Brooklyn,31078001011,0,0,0,3.38
2020,CB2020,047,3,Brooklyn,31078001012,250,109,141,3.43
2020,CB2020,047,3,Brooklyn,31078001013,245,104,141,3.43
2020,CB2020,047,3,Brooklyn,31078002000,0,0,0,4.04
2020,CB2020,047,3,Brooklyn,31078002001,0,0,0,3.66
2020,CB2020,047,3,Brooklyn,31078002002,0,0,0,3.49
2020,CB2020,047,3,Brooklyn,31078002003,0,0,0,3.47
2020,CB2020,047,3,Brooklyn,31078002004,0,0,0,3.49
2020,CB2020,047,3,Brooklyn,31078002005,0,0,0,3.45
2020,CB2020,047,3,Brooklyn,31078002006,0,0,0,3.48
2020,CB2020,047,3,Brooklyn,31078002007,14,2,12,3.45
2020,CB2020,047,3,Brooklyn,31078002008,9,4,5,3.53
2020,CB2020,047,3,Brooklyn,31078002009,295,131,164,5.97
2020,CB2020,047,3,Brooklyn,31078002010,791,349,442,7.84
2020,CB2020,047,3,Brooklyn,31078003000,296,137,159,3.58
2020,CB2020,047,3,Brooklyn,31078003001,247,135,112,3.41
2020,CB2020,047,3,Brooklyn,31078003002,176,73,103,3.58
2020,CB2020,047,3,Brooklyn,31078003003,244,119,125,5.35
2020,CB2020,047,3,Brooklyn,31078004000,1011,424,587,11.99
2020,CB2020,047,3,Brooklyn,31098001000,0,0,0,18.39
2020,CB2020,047,3,Brooklyn,31098001001,0,0,0,1.13
2020,CB2020,047,3,Brooklyn,31098001002,0,0,0,1.53
2020,CB2020,047,3,Brooklyn,31098001003,0,0,0,0.35
2020,CB2020,047,3,Brooklyn,31098001004,0,0,0,3.14
2020,CB2020,047,3,Brooklyn,31098001005,0,0,0,5.55
2020,CB2020,047,3,Brooklyn,31098001006,0,0,0,2.69
2020,CB2020,047,3,Brooklyn,31098002000,219,88,131,26.91
2020,CB2020,047,3,Brooklyn,31098002001,0,0,0,0.68
2020,CB2020,047,3,Brooklyn,31098002002,0,0,0,6.8
2020,CB2020,047,3,Brooklyn,31098002003,23,8,15,6.84
2020,CB2020,047,3,Brooklyn,31098002004,0,0,0,3.3
2020,CB2020,047,3,Brooklyn,31098002005,0,0,0,9.3
2020,CB2020,047,3,Brooklyn,31098002006,0,0,0,9.42
2020,CB2020,047,3,Brooklyn,31098002007,373,196,177,4.88
2020,CB2020,047,3,Brooklyn,31098002008,168,74,94,5.2
2020,CB2020,047,3,Brooklyn,31098002009,0,0,0,0.46
2020,CB2020,047,3,Brooklyn,31098002010,26,7,19,0.6
2020,CB2020,047,3,Brooklyn,31098003000,0,0,0,18.89
2020,CB2020,047,3,Brooklyn,31098003001,20,11,9,19.07
2020,CB2020,047,3,Brooklyn,31098004000,0,0,0,5.01
2020,CB2020,047,3,Brooklyn,31098004001,0,0,0,12.56
2020,CB2020,047,3,Brooklyn,31098004002,0,0,0,3.75
2020,CB2020,047,3,Brooklyn,31098004003,0,0,0,10.02
2020,CB2020,047,3,Brooklyn,31098005000,0,0,0,0.26
2020,CB2020,047,3,Brooklyn,31098005001,0,0,0,0.3
2020,CB2020,047,3,Brooklyn,31098005002,0,0,0,0.33
2020,CB2020,047,3,Brooklyn,31098005003,0,0,0,0.34
2020,CB2020,047,3,Brooklyn,31098005004,455,182,273,3.58
2020,CB2020,047,3,Brooklyn,31098005005,232,128,104,3.11
2020,CB2020,047,3,Brooklyn,31098005006,379,211,168,3.08
2020,CB2020,047,3,Brooklyn,31098005007,304,145,159,2.69
2020,CB2020,047,3,Brooklyn,31098005008,0,0,0,2.59
2020,CB2020,047,3,Brooklyn,31098005009,0,0,0,1.57
2020,CB2020,047,3,Brooklyn,31098005010,0,0,0,2.19
2020,CB2020,047,3,Brooklyn,31098005011,0,0,0,3.86
2020,CB2020,047,3,Brooklyn,31098005012,0,0,0,4.63
2020,CB2020,047,3,Brooklyn,31098005013,91,36,55,6.11
2020,CB2020,047,3,Brooklyn,31104001000,253,112,141,3.02
2020,CB2020,047,3,Brooklyn,31104001001,157,77,80,2.56
2020,CB2020,047,3,Brooklyn,31104001002,60,23,37,1.24
2020,CB2020,047,3,Brooklyn,31104001003,0,0,0,0.98
2020,CB2020,047,3,Brooklyn,31104001004,0,0,0,0.47
2020,CB2020,047,3,Brooklyn,31104001005,0,0,0,0.47
2020,CB2020,047,3,Brooklyn,31104001006,0,0,0,0.43
2020,CB2020,047,3,Brooklyn,31104001007,0,0,0,0.34
2020,CB2020,047,3,Brooklyn,31104001008,0,0,0,3.63
2020,CB2020,047,3,Brooklyn,31104001009,62,20,42,3.74
2020,CB2020,047,3,Brooklyn,31104001010,0,0,0,0.63
2020,CB2020,047,3,Brooklyn,31104001011,168,92,76,1.43
2020,CB2020,047,3,Brooklyn,31104001012,70,38,32,3.74
2020,CB2020,047,3,Brooklyn,31104001013,3,3,0,3.83
2020,CB2020,047,3,Brooklyn,31104001014,0,0,0,3.7
2020,CB2020,047,3,Brooklyn,31104001015,0,0,0,3.7
2020,CB2020,047,3,Brooklyn,31104001016,0,0,0,3.41
2020,CB2020,047,3,Brooklyn,31104001017,0,0,0,6.92
2020,CB2020,047,3,Brooklyn,31104001018,26,17,9,3.24
2020,CB2020,047,3,Brooklyn,31104001019,16,13,3,3.53
2020,CB2020,047,3,Brooklyn,31104001020,146,62,84,3.63
2020,CB2020,047,3,Brooklyn,31104001021,0,0,0,3.31
2020,CB2020,047,3,Brooklyn,31104001022,33,21,12,3.59
2020,CB2020,047,3,Brooklyn,31104001023,137,126,11,3.44
2020,CB2020,047,3,Brooklyn,31104001024,8,5,3,3.45
2020,CB2020,047,3,Brooklyn,31104001025,0,0,0,3.44
2020,CB2020,047,3,Brooklyn,31104001026,0,0,0,3.39
2020,CB2020,047,3,Brooklyn,31104001027,0,0,0,3.42
2020,CB2020,047,3,Brooklyn,31104001028,0,0,0,2.53
2020,CB2020,047,3,Brooklyn,31104002000,0,0,0,3.09
2020,CB2020,047,3,Brooklyn,31104002001,243,95,148,3.05
2020,CB2020,047,3,Brooklyn,31104002002,270,132,138,3.08
2020,CB2020,047,3,Brooklyn,31104002003,200,86,114,3.03
2020,CB2020,047,3,Brooklyn,31104002004,0,0,0,0.73
2020,CB2020,047,3,Brooklyn,31104002005,0,0,0,0.67
2020,CB2020,047,3,Brooklyn,31104002006,0,0,0,0.72
2020,CB2020,047,3,Brooklyn,31104002007,31,18,13,3.74
2020,CB2020,047,3,Brooklyn,31104002008,19,16,3,3.53
2020,CB2020,047,3,Brooklyn,31104002009,20,5,15,3.74
2020,CB2020,047,3,Brooklyn,31104002010,0,0,0,0.75
2020,CB2020,047,3,Brooklyn,31104002011,0,0,0,3.64
2020,CB2020,047,3,Brooklyn,31104002012,0,0,0,3.71
2020,CB2020,047,3,Brooklyn,31104002013,27,14,13,3.84
2020,CB2020,047,3,Brooklyn,31104002014,387,158,229,3.55
2020,CB2020,047,3,Brooklyn,31104002015,371,143,228,3.85
2020,CB2020,047,3,Brooklyn,31104003000,92,38,54,2.84
2020,CB2020,047,3,Brooklyn,31104003001,250,143,107,3.06
2020,CB2020,047,3,Brooklyn,31104003002,352,160,192,3.04
2020,CB2020,047,3,Brooklyn,31104003003,319,134,185,3.05
2020,CB2020,047,3,Brooklyn,31104003004,0,0,0,0.28
2020,CB2020,047,3,Brooklyn,31104003005,0,0,0,0.76
2020,CB2020,047,3,Brooklyn,31104003006,0,0,0,0.96
2020,CB2020,047,3,Brooklyn,31104003007,0,0,0,0.89
2020,CB2020,047,3,Brooklyn,31104003008,26,20,6,14.22
2020,CB2020,047,3,Brooklyn,31104004000,0,0,0,3.04
2020,CB2020,047,3,Brooklyn,31104004001,216,86,130,3.01
2020,CB2020,047,3,Brooklyn,31104004002,249,92,157,3.07
2020,CB2020,047,3,Brooklyn,31104004003,203,147,56,2.99
2020,CB2020,047,3,Brooklyn,31104004004,244,122,122,3.04
2020,CB2020,047,3,Brooklyn,31104004005,361,163,198,3.26
2020,CB2020,047,3,Brooklyn,31104004006,0,0,0,0.51
2020,CB2020,047,3,Brooklyn,31104004007,0,0,0,0.27
2020,CB2020,047,3,Brooklyn,31104004008,0,0,0,0.77
2020,CB2020,047,3,Brooklyn,31104004009,0,0,0,0.6
2020,CB2020,047,3,Brooklyn,31104004010,0,0,0,0.4
2020,CB2020,047,3,Brooklyn,31104004011,26,21,5,3.7
2020,CB2020,047,3,Brooklyn,31104004012,23,6,17,3.79
2020,CB2020,047,3,Brooklyn,31106001000,593,240,353,7.51
2020,CB2020,047,3,Brooklyn,31106001001,1909,829,1080,14.46
2020,CB2020,047,3,Brooklyn,31106002000,749,344,405,7.03
2020,CB2020,047,3,Brooklyn,31106002001,1307,487,820,13.26
2020,CB2020,047,3,Brooklyn,31110001000,0,0,0,1.05
2020,CB2020,047,3,Brooklyn,31110001001,0,0,0,0.78
2020,CB2020,047,3,Brooklyn,31110001002,1678,704,974,14.51
2020,CB2020,047,3,Brooklyn,31110002000,1359,548,811,14.54
2020,CB2020,047,3,Brooklyn,31116001000,247,123,124,3.15
2020,CB2020,047,3,Brooklyn,31116001001,378,209,169,3.04
2020,CB2020,047,3,Brooklyn,31116001002,190,98,92,3.04
2020,CB2020,047,3,Brooklyn,31116001003,209,97,112,3.04
2020,CB2020,047,3,Brooklyn,31116001004,0,0,0,3.04
2020,CB2020,047,3,Brooklyn,31116001005,190,83,107,3.04
2020,CB2020,047,3,Brooklyn,31116001006,227,100,127,3.03
2020,CB2020,047,3,Brooklyn,31116001007,234,81,153,3.03
2020,CB2020,047,3,Brooklyn,31116001008,0,0,0,3.01
2020,CB2020,047,3,Brooklyn,31116001009,260,103,157,3.03
2020,CB2020,047,3,Brooklyn,31116001010,251,102,149,3.08
2020,CB2020,047,3,Brooklyn,31116001011,0,0,0,0.5
2020,CB2020,047,3,Brooklyn,31116001012,0,0,0,0.56
2020,CB2020,047,3,Brooklyn,31116001013,0,0,0,0.73
2020,CB2020,047,3,Brooklyn,31116001014,0,0,0,1.04
2020,CB2020,047,3,Brooklyn,31116002000,0,0,0,1.1
2020,CB2020,047,3,Brooklyn,31116002001,0,0,0,0.85
2020,CB2020,047,3,Brooklyn,31116002002,71,40,31,3.89
2020,CB2020,047,3,Brooklyn,31116002003,45,21,24,3.64
2020,CB2020,047,3,Brooklyn,31116002004,55,28,27,3.66
2020,CB2020,047,3,Brooklyn,31116002005,33,16,17,3.64
2020,CB2020,047,3,Brooklyn,31116002006,0,0,0,3.64
2020,CB2020,047,3,Brooklyn,31116002007,0,0,0,0.79
2020,CB2020,047,3,Brooklyn,31116002008,0,0,0,1.08
2020,CB2020,047,3,Brooklyn,31116002009,0,0,0,0.74
2020,CB2020,047,3,Brooklyn,31116002010,0,0,0,0.59
2020,CB2020,047,3,Brooklyn,31116002011,0,0,0,3.66
2020,CB2020,047,3,Brooklyn,31116002012,0,0,0,3.67
2020,CB2020,047,3,Brooklyn,31116002013,0,0,0,3.67
2020,CB2020,047,3,Brooklyn,31116002014,0,0,0,3.68
2020,CB2020,047,3,Brooklyn,31116002015,319,146,173,3.68
2020,CB2020,047,3,Brooklyn,31116002016,78,44,34,1.29
2020,CB2020,047,3,Brooklyn,31116002017,88,27,61,2.49
2020,CB2020,047,3,Brooklyn,31116002018,43,17,26,2.37
2020,CB2020,047,3,Brooklyn,31116002019,353,146,207,3.72
2020,CB2020,047,3,Brooklyn,31116002020,70,33,37,3.7
2020,CB2020,047,3,Brooklyn,31116002021,0,0,0,3.7
2020,CB2020,047,3,Brooklyn,31116002022,3,2,1,3.71
2020,CB2020,047,3,Brooklyn,31116002023,0,0,0,3.71
2020,CB2020,047,3,Brooklyn,31116002024,0,0,0,3.71
2020,CB2020,047,3,Brooklyn,31116002025,0,0,0,3.72
2020,CB2020,047,3,Brooklyn,31116002026,0,0,0,3.71
2020,CB2020,047,3,Brooklyn,31116002027,0,0,0,3.74
2020,CB2020,047,3,Brooklyn,31116002028,6,3,3,4.05
2020,CB2020,047,3,Brooklyn,31116002029,84,32,52,1.46
2020,CB2020,047,3,Brooklyn,31118001000,0,0,0,3.6
2020,CB2020,047,3,Brooklyn,31118001001,276,149,127,2.53
2020,CB2020,047,3,Brooklyn,31118001002,234,109,125,3.04
2020,CB2020,047,3,Brooklyn,31118001003,410,218,192,3.4
2020,CB2020,047,3,Brooklyn,31118001004,393,172,221,3.41
2020,CB2020,047,3,Brooklyn,31118001005,0,0,0,0.67
2020,CB2020,047,3,Brooklyn,31118001006,0,0,0,0.19
2020,CB2020,047,3,Brooklyn,31118001007,352,135,217,3.61
2020,CB2020,047,3,Brooklyn,31118002000,0,0,0,0.91
2020,CB2020,047,3,Brooklyn,31118002001,0,0,0,0.36
2020,CB2020,047,3,Brooklyn,31118002002,498,235,263,4.63
2020,CB2020,047,3,Brooklyn,31118002003,400,176,224,4.08
2020,CB2020,047,3,Brooklyn,31118002004,515,255,260,4.76
2020,CB2020,047,3,Brooklyn,31118002005,429,207,222,4.93
2020,CB2020,047,3,Brooklyn,31120001000,67,16,51,1.18
2020,CB2020,047,3,Brooklyn,31120001001,102,73,29,1.68
2020,CB2020,047,3,Brooklyn,31120001002,118,57,61,2.03
2020,CB2020,047,3,Brooklyn,31120001003,125,43,82,2.43
2020,CB2020,047,3,Brooklyn,31120001004,330,163,167,2.74
2020,CB2020,047,3,Brooklyn,31120001005,236,104,132,2.19
2020,CB2020,047,3,Brooklyn,31120001006,184,76,108,0.96
2020,CB2020,047,3,Brooklyn,31120002000,456,242,214,4.97
2020,CB2020,047,3,Brooklyn,31120002001,531,235,296,5
2020,CB2020,047,3,Brooklyn,31120002002,255,100,155,4.85
2020,CB2020,047,3,Brooklyn,31120002003,276,109,167,4.84
2020,CB2020,047,3,Brooklyn,31120002004,416,187,229,4.99
2020,CB2020,047,3,Brooklyn,31120002005,254,123,131,3.18
2020,CB2020,047,3,Brooklyn,31120002006,130,78,52,1.73
2020,CB2020,047,3,Brooklyn,31122001000,493,217,276,4.89
2020,CB2020,047,3,Brooklyn,31122001001,447,202,245,4.9
2020,CB2020,047,3,Brooklyn,31122001002,152,78,74,4.25
2020,CB2020,047,3,Brooklyn,31122001003,381,171,210,4.91
2020,CB2020,047,3,Brooklyn,31122001004,462,182,280,5.26
2020,CB2020,047,3,Brooklyn,31122001005,226,108,118,2.77
2020,CB2020,047,3,Brooklyn,31122001006,209,94,115,2.79
2020,CB2020,047,3,Brooklyn,31122002000,548,255,293,4.52
2020,CB2020,047,3,Brooklyn,31122002001,23,16,7,1.03
2020,CB2020,047,3,Brooklyn,31122002002,573,230,343,4.77
2020,CB2020,047,3,Brooklyn,31124001000,405,191,214,3
2020,CB2020,047,3,Brooklyn,31124001001,295,125,170,3.25
2020,CB2020,047,3,Brooklyn,31124001002,338,141,197,3.26
2020,CB2020,047,3,Brooklyn,31124001003,288,138,150,1.6
2020,CB2020,047,3,Brooklyn,31124001004,52,15,37,1.12
2020,CB2020,047,3,Brooklyn,31124001005,4,1,3,0.59
2020,CB2020,047,3,Brooklyn,31124002000,149,65,84,3.31
2020,CB2020,047,3,Brooklyn,31124002001,186,96,90,3.35
2020,CB2020,047,3,Brooklyn,31124002002,337,177,160,3.33
2020,CB2020,047,3,Brooklyn,31124002003,376,164,212,3.1
2020,CB2020,047,3,Brooklyn,31124002004,209,94,115,2.59
2020,CB2020,047,3,Brooklyn,31124002005,0,0,0,2.09
2020,CB2020,047,3,Brooklyn,31124003000,389,193,196,3.26
2020,CB2020,047,3,Brooklyn,31124003001,294,127,167,3.41
2020,CB2020,047,3,Brooklyn,31124003002,505,224,281,3.41
2020,CB2020,047,3,Brooklyn,31124003003,461,210,251,3.27
2020,CB2020,047,3,Brooklyn,31126001000,236,119,117,3.4
2020,CB2020,047,3,Brooklyn,31126001001,429,167,262,3.41
2020,CB2020,047,3,Brooklyn,31126001002,409,206,203,3.37
2020,CB2020,047,3,Brooklyn,31126001003,455,208,247,3.39
2020,CB2020,047,3,Brooklyn,31126002000,377,152,225,3.42
2020,CB2020,047,3,Brooklyn,31126002001,583,292,291,3.69
2020,CB2020,047,3,Brooklyn,31126002002,0,0,0,3.65
2020,CB2020,047,3,Brooklyn,31126002003,412,186,226,3.39
2020,CB2020,047,3,Brooklyn,31126003000,369,168,201,3.63
2020,CB2020,047,3,Brooklyn,31126003001,309,125,184,3.38
2020,CB2020,047,3,Brooklyn,31126003002,348,171,177,3.31
2020,CB2020,047,3,Brooklyn,31126003003,441,194,247,3.59
2020,CB2020,047,3,Brooklyn,31128001000,126,51,75,1.32
2020,CB2020,047,3,Brooklyn,31128001001,208,91,117,1.82
2020,CB2020,047,3,Brooklyn,31128001002,432,187,245,4.86
2020,CB2020,047,3,Brooklyn,31128001003,480,228,252,4.91
2020,CB2020,047,3,Brooklyn,31128002000,229,108,121,2.39
2020,CB2020,047,3,Brooklyn,31128002001,326,183,143,2.92
2020,CB2020,047,3,Brooklyn,31128002002,580,253,327,4.75
2020,CB2020,047,3,Brooklyn,31128002003,430,208,222,4.96
2020,CB2020,047,3,Brooklyn,31128003000,372,164,208,4.06
2020,CB2020,047,3,Brooklyn,31128003001,266,125,141,4.08
2020,CB2020,047,3,Brooklyn,31128003002,586,287,299,4.76
2020,CB2020,047,3,Brooklyn,31128003003,426,207,219,4.68
2020,CB2020,047,3,Brooklyn,31130001000,337,153,184,3.42
2020,CB2020,047,3,Brooklyn,31130001001,169,75,94,3.43
2020,CB2020,047,3,Brooklyn,31130001002,144,57,87,3.43
2020,CB2020,047,3,Brooklyn,31130002000,374,153,221,3.38
2020,CB2020,047,3,Brooklyn,31130002001,325,145,180,3.38
2020,CB2020,047,3,Brooklyn,31130002002,519,246,273,3.39
2020,CB2020,047,3,Brooklyn,31130003000,377,193,184,3.43
2020,CB2020,047,3,Brooklyn,31130003001,357,171,186,3.41
2020,CB2020,047,3,Brooklyn,31130003002,612,268,344,3.41
2020,CB2020,047,3,Brooklyn,31130004000,517,217,300,4.74
2020,CB2020,047,3,Brooklyn,31130004001,0,0,0,1.13
2020,CB2020,047,3,Brooklyn,31130004002,72,41,31,1.76
2020,CB2020,047,3,Brooklyn,31130004003,411,187,224,4.71
2020,CB2020,047,3,Brooklyn,31130004004,246,106,140,4.24
2020,CB2020,047,3,Brooklyn,31130004005,0,0,0,0.65
2020,CB2020,047,3,Brooklyn,31132001000,115,30,85,2.31
2020,CB2020,047,3,Brooklyn,31132001001,225,107,118,2.86
2020,CB2020,047,3,Brooklyn,31132001002,178,97,81,3.02
2020,CB2020,047,3,Brooklyn,31132001003,123,49,74,3.3
2020,CB2020,047,3,Brooklyn,31132001004,223,77,146,4.16
2020,CB2020,047,3,Brooklyn,31132001005,318,168,150,4.73
2020,CB2020,047,3,Brooklyn,31132001006,0,0,0,0.43
2020,CB2020,047,3,Brooklyn,31132001007,0,0,0,0.36
2020,CB2020,047,3,Brooklyn,31132001008,0,0,0,0.31
2020,CB2020,047,3,Brooklyn,31132002000,300,101,199,3.44
2020,CB2020,047,3,Brooklyn,31132002001,124,47,77,3.1
2020,CB2020,047,3,Brooklyn,31132002002,33,17,16,2.99
2020,CB2020,047,3,Brooklyn,31132002003,350,152,198,3.39
2020,CB2020,047,3,Brooklyn,31132002004,334,176,158,3.41
2020,CB2020,047,3,Brooklyn,31132002005,99,47,52,3.06
2020,CB2020,047,3,Brooklyn,31132003000,0,0,0,3.68
2020,CB2020,047,3,Brooklyn,31132003001,5,0,5,3.92
2020,CB2020,047,3,Brooklyn,31134001000,36,19,17,2.78
2020,CB2020,047,3,Brooklyn,31134001001,189,149,40,2.78
2020,CB2020,047,3,Brooklyn,31134001002,53,26,27,2.78
2020,CB2020,047,3,Brooklyn,31134001003,0,0,0,2.66
2020,CB2020,047,3,Brooklyn,31134001004,270,124,146,3.41
2020,CB2020,047,3,Brooklyn,31134001005,100,40,60,3.41
2020,CB2020,047,3,Brooklyn,31134001006,106,37,69,3.4
2020,CB2020,047,3,Brooklyn,31134002000,429,173,256,3.41
2020,CB2020,047,3,Brooklyn,31134002001,554,230,324,3.4
2020,CB2020,047,3,Brooklyn,31134003000,121,47,74,3.26
2020,CB2020,047,3,Brooklyn,31134003001,328,143,185,3.2
2020,CB2020,047,3,Brooklyn,31134003002,472,199,273,3.4
2020,CB2020,047,3,Brooklyn,31142011000,0,0,0,0.2
2020,CB2020,047,3,Brooklyn,31142011001,0,0,0,0.77
2020,CB2020,047,3,Brooklyn,31142011002,0,0,0,1.73
2020,CB2020,047,3,Brooklyn,31142011003,245,118,127,9.06
2020,CB2020,047,3,Brooklyn,31142011004,366,164,202,7.33
2020,CB2020,047,3,Brooklyn,31142011005,174,71,103,2.34
2020,CB2020,047,3,Brooklyn,31142011006,240,125,115,3.5
2020,CB2020,047,3,Brooklyn,31142012000,150,79,71,3.78
2020,CB2020,047,3,Brooklyn,31142012001,0,0,0,0.39
2020,CB2020,047,3,Brooklyn,31142012002,0,0,0,1.05
2020,CB2020,047,3,Brooklyn,31142012003,0,0,0,1
2020,CB2020,047,3,Brooklyn,31142012004,0,0,0,0.71
2020,CB2020,047,3,Brooklyn,31142012005,0,0,0,0.76
2020,CB2020,047,3,Brooklyn,31142012006,0,0,0,1.16
2020,CB2020,047,3,Brooklyn,31142012007,186,80,106,2.56
2020,CB2020,047,3,Brooklyn,31142012008,350,165,185,5.63
2020,CB2020,047,3,Brooklyn,31142012009,0,0,0,2.43
2020,CB2020,047,3,Brooklyn,31142012010,0,0,0,0.16
2020,CB2020,047,3,Brooklyn,31142012011,135,74,61,2.27
2020,CB2020,047,3,Brooklyn,31142012012,16,10,6,1.42
2020,CB2020,047,3,Brooklyn,31142012013,18,14,4,22.72
2020,CB2020,047,3,Brooklyn,31142012014,0,0,0,1.93
2020,CB2020,047,3,Brooklyn,31142012015,0,0,0,1.46
2020,CB2020,047,3,Brooklyn,31142021000,25,16,9,1.71
2020,CB2020,047,3,Brooklyn,31142021001,312,139,173,3.67
2020,CB2020,047,3,Brooklyn,31142021002,41,15,26,1.97
2020,CB2020,047,3,Brooklyn,31142021003,57,29,28,2.35
2020,CB2020,047,3,Brooklyn,31142021004,999,465,534,9.08
2020,CB2020,047,3,Brooklyn,31142022000,306,158,148,3.15
2020,CB2020,047,3,Brooklyn,31142022001,377,183,194,3.76
2020,CB2020,047,3,Brooklyn,31142022002,553,254,299,3.76
2020,CB2020,047,3,Brooklyn,31144001000,9,5,4,2.16
2020,CB2020,047,3,Brooklyn,31144001001,42,25,17,1.92
2020,CB2020,047,3,Brooklyn,31144001002,0,0,0,0.45
2020,CB2020,047,3,Brooklyn,31144001003,0,0,0,0.52
2020,CB2020,047,3,Brooklyn,31144001004,12,4,8,0.47
2020,CB2020,047,3,Brooklyn,31144001005,125,49,76,3.82
2020,CB2020,047,3,Brooklyn,31144001006,23,14,9,3.53
2020,CB2020,047,3,Brooklyn,31144001007,0,0,0,2.75
2020,CB2020,047,3,Brooklyn,31144001008,117,6,111,2.75
2020,CB2020,047,3,Brooklyn,31144001009,0,0,0,2.77
2020,CB2020,047,3,Brooklyn,31144001010,20,11,9,4.33
2020,CB2020,047,3,Brooklyn,31144001011,0,0,0,4.66
2020,CB2020,047,3,Brooklyn,31144001012,7,2,5,2.69
2020,CB2020,047,3,Brooklyn,31144001013,19,11,8,2.69
2020,CB2020,047,3,Brooklyn,31144001014,0,0,0,2.81
2020,CB2020,047,3,Brooklyn,31144001015,19,11,8,2.81
2020,CB2020,047,3,Brooklyn,31144001016,0,0,0,2.81
2020,CB2020,047,3,Brooklyn,31144001017,0,0,0,2.82
2020,CB2020,047,3,Brooklyn,31144001018,18,6,12,2.81
2020,CB2020,047,3,Brooklyn,31144001019,0,0,0,2.81
2020,CB2020,047,3,Brooklyn,31144001020,0,0,0,2.65
2020,CB2020,047,3,Brooklyn,31144002000,195,96,99,2.77
2020,CB2020,047,3,Brooklyn,31144002001,95,53,42,2.71
2020,CB2020,047,3,Brooklyn,31144002002,169,91,78,3.05
2020,CB2020,047,3,Brooklyn,31144002003,247,100,147,2.92
2020,CB2020,047,3,Brooklyn,31144002004,0,0,0,2.69
2020,CB2020,047,3,Brooklyn,31144002005,0,0,0,2.75
2020,CB2020,047,3,Brooklyn,31144003000,228,102,126,2.83
2020,CB2020,047,3,Brooklyn,31144003001,133,81,52,2.74
2020,CB2020,047,3,Brooklyn,31144003002,78,41,37,3.05
2020,CB2020,047,3,Brooklyn,31144003003,234,101,133,2.96
2020,CB2020,047,3,Brooklyn,31144003004,7,3,4,2.76
2020,CB2020,047,3,Brooklyn,31144003005,15,2,13,2.81
2020,CB2020,047,3,Brooklyn,31144004000,17,10,7,2.82
2020,CB2020,047,3,Brooklyn,31144004001,40,17,23,2.79
2020,CB2020,047,3,Brooklyn,31144004002,129,65,64,3.04
2020,CB2020,047,3,Brooklyn,31144004003,416,154,262,2.97
2020,CB2020,047,3,Brooklyn,31144004004,0,0,0,2.76
2020,CB2020,047,3,Brooklyn,31144004005,0,0,0,2.8
2020,CB2020,047,3,Brooklyn,31146001000,248,148,100,3.36
2020,CB2020,047,3,Brooklyn,31146001001,263,133,130,2.69
2020,CB2020,047,3,Brooklyn,31146001002,286,138,148,2.09
2020,CB2020,047,3,Brooklyn,31146001003,478,204,274,3.71
2020,CB2020,047,3,Brooklyn,31146001004,202,92,110,3.7
2020,CB2020,047,3,Brooklyn,31146001005,256,100,156,3.57
2020,CB2020,047,3,Brooklyn,31146002000,96,38,58,1.53
2020,CB2020,047,3,Brooklyn,31146002001,101,44,57,0.91
2020,CB2020,047,3,Brooklyn,31146002002,0,0,0,0.31
2020,CB2020,047,3,Brooklyn,31146002003,236,93,143,3.72
2020,CB2020,047,3,Brooklyn,31146002004,285,138,147,3.74
2020,CB2020,047,3,Brooklyn,31146002005,312,162,150,3.72
2020,CB2020,047,3,Brooklyn,31146002006,140,70,70,3.56
2020,CB2020,047,3,Brooklyn,31146002007,231,108,123,2.94
2020,CB2020,047,3,Brooklyn,31150001000,271,127,144,2.43
2020,CB2020,047,3,Brooklyn,31150001001,222,132,90,2.43
2020,CB2020,047,3,Brooklyn,31150001002,214,113,101,2.65
2020,CB2020,047,3,Brooklyn,31150001003,296,146,150,2.64
2020,CB2020,047,3,Brooklyn,31150001004,138,63,75,2.68
2020,CB2020,047,3,Brooklyn,31150002000,216,116,100,1.87
2020,CB2020,047,3,Brooklyn,31150002001,71,19,52,0.61
2020,CB2020,047,3,Brooklyn,31150002002,69,25,44,2.48
2020,CB2020,047,3,Brooklyn,31150002003,237,123,114,2.71
2020,CB2020,047,3,Brooklyn,31150002004,226,136,90,2.7
2020,CB2020,047,3,Brooklyn,31150002005,239,110,129,2.76
2020,CB2020,047,3,Brooklyn,31150003000,107,60,47,1.18
2020,CB2020,047,3,Brooklyn,31150003001,77,44,33,1.31
2020,CB2020,047,3,Brooklyn,31150003002,217,77,140,2.48
2020,CB2020,047,3,Brooklyn,31150003003,173,77,96,2.71
2020,CB2020,047,3,Brooklyn,31150003004,206,83,123,2.7
2020,CB2020,047,3,Brooklyn,31150003005,144,73,71,2.75
2020,CB2020,047,3,Brooklyn,31152001000,171,83,88,2.71
2020,CB2020,047,3,Brooklyn,31152001001,195,109,86,2.69
2020,CB2020,047,3,Brooklyn,31152001002,206,91,115,2.7
2020,CB2020,047,3,Brooklyn,31152001003,170,71,99,2.7
2020,CB2020,047,3,Brooklyn,31152001004,119,55,64,2.7
2020,CB2020,047,3,Brooklyn,31152002000,217,92,125,2.76
2020,CB2020,047,3,Brooklyn,31152002001,176,92,84,2.74
2020,CB2020,047,3,Brooklyn,31152002002,329,145,184,2.76
2020,CB2020,047,3,Brooklyn,31152002003,314,133,181,2.76
2020,CB2020,047,3,Brooklyn,31152002004,236,98,138,2.76
2020,CB2020,047,3,Brooklyn,31152003000,134,57,77,2.76
2020,CB2020,047,3,Brooklyn,31152003001,129,55,74,2.74
2020,CB2020,047,3,Brooklyn,31152003002,300,164,136,2.72
2020,CB2020,047,3,Brooklyn,31152003003,309,133,176,2.79
2020,CB2020,047,3,Brooklyn,31152003004,491,237,254,2.77
2020,CB2020,047,3,Brooklyn,31156001000,315,150,165,2.99
2020,CB2020,047,3,Brooklyn,31156001001,377,178,199,3.67
2020,CB2020,047,3,Brooklyn,31156001002,421,180,241,3.67
2020,CB2020,047,3,Brooklyn,31156002000,60,27,33,3.59
2020,CB2020,047,3,Brooklyn,31156002001,605,274,331,3.34
2020,CB2020,047,3,Brooklyn,31156002002,435,166,269,3.42
2020,CB2020,047,3,Brooklyn,31156003000,522,217,305,3.34
2020,CB2020,047,3,Brooklyn,31156003001,673,263,410,3.42
2020,CB2020,047,3,Brooklyn,31156004000,260,121,139,2.95
2020,CB2020,047,3,Brooklyn,31156004001,108,23,85,2.73
2020,CB2020,047,3,Brooklyn,31156004002,95,53,42,2.78
2020,CB2020,047,3,Brooklyn,31156004003,581,277,304,3.61
2020,CB2020,047,3,Brooklyn,31158001000,308,143,165,2.79
2020,CB2020,047,3,Brooklyn,31158001001,233,109,124,2.76
2020,CB2020,047,3,Brooklyn,31158001002,217,107,110,2.78
2020,CB2020,047,3,Brooklyn,31158001003,300,125,175,2.78
2020,CB2020,047,3,Brooklyn,31158002000,448,201,247,3.41
2020,CB2020,047,3,Brooklyn,31158002001,240,108,132,3.38
2020,CB2020,047,3,Brooklyn,31158002002,111,45,66,3.4
2020,CB2020,047,3,Brooklyn,31158002003,325,146,179,3.41
2020,CB2020,047,3,Brooklyn,31158003000,3,1,2,3.41
2020,CB2020,047,3,Brooklyn,31158003001,483,221,262,3.39
2020,CB2020,047,3,Brooklyn,31158003002,385,188,197,3.39
2020,CB2020,047,3,Brooklyn,31158003003,207,99,108,3.4
2020,CB2020,047,3,Brooklyn,31160001000,0,0,0,2.72
2020,CB2020,047,3,Brooklyn,31160001001,169,88,81,2.73
2020,CB2020,047,3,Brooklyn,31160001002,184,109,75,2.72
2020,CB2020,047,3,Brooklyn,31160001003,356,133,223,2.67
2020,CB2020,047,3,Brooklyn,31160001004,195,50,145,3.34
2020,CB2020,047,3,Brooklyn,31160002000,249,108,141,3.35
2020,CB2020,047,3,Brooklyn,31160002001,258,125,133,3.34
2020,CB2020,047,3,Brooklyn,31160002002,409,190,219,3.26
2020,CB2020,047,3,Brooklyn,31160003000,199,68,131,3.34
2020,CB2020,047,3,Brooklyn,31160003001,152,77,75,3.35
2020,CB2020,047,3,Brooklyn,31160003002,204,88,116,3.34
2020,CB2020,047,3,Brooklyn,31160003003,255,126,129,3.26
2020,CB2020,047,3,Brooklyn,31162001000,96,38,58,1.07
2020,CB2020,047,3,Brooklyn,31162001001,115,56,59,1.39
2020,CB2020,047,3,Brooklyn,31162001002,170,89,81,2.46
2020,CB2020,047,3,Brooklyn,31162001003,246,126,120,2.68
2020,CB2020,047,3,Brooklyn,31162001004,187,56,131,2.68
2020,CB2020,047,3,Brooklyn,31162002000,114,55,59,2.21
2020,CB2020,047,3,Brooklyn,31162002001,71,30,41,0.81
2020,CB2020,047,3,Brooklyn,31162002002,154,59,95,3.01
2020,CB2020,047,3,Brooklyn,31162002003,189,77,112,3.28
2020,CB2020,047,3,Brooklyn,31162002004,159,69,90,3.28
2020,CB2020,047,3,Brooklyn,31162003000,196,105,91,2.07
2020,CB2020,047,3,Brooklyn,31162003001,77,42,35,0.95
2020,CB2020,047,3,Brooklyn,31162003002,247,114,133,3.01
2020,CB2020,047,3,Brooklyn,31162003003,179,82,97,3.28
2020,CB2020,047,3,Brooklyn,31162003004,174,86,88,3.27
2020,CB2020,047,3,Brooklyn,31164001000,244,114,130,2.78
2020,CB2020,047,3,Brooklyn,31164001001,255,123,132,2.72
2020,CB2020,047,3,Brooklyn,31164001002,239,100,139,2.61
2020,CB2020,047,3,Brooklyn,31164001003,186,93,93,2.46
2020,CB2020,047,3,Brooklyn,31164001004,219,118,101,2.46
2020,CB2020,047,3,Brooklyn,31164002000,275,132,143,3.41
2020,CB2020,047,3,Brooklyn,31164002001,228,112,116,3.34
2020,CB2020,047,3,Brooklyn,31164002002,139,59,80,3.16
2020,CB2020,047,3,Brooklyn,31164002003,212,99,113,3.02
2020,CB2020,047,3,Brooklyn,31164002004,182,91,91,3.01
2020,CB2020,047,3,Brooklyn,31164003000,0,0,0,3.41
2020,CB2020,047,3,Brooklyn,31164003001,180,68,112,3.34
2020,CB2020,047,3,Brooklyn,31164003002,228,106,122,3.12
2020,CB2020,047,3,Brooklyn,31164003003,316,147,169,3.02
2020,CB2020,047,3,Brooklyn,31164003004,372,188,184,3.01
2020,CB2020,047,3,Brooklyn,31166001000,106,53,53,2.75
2020,CB2020,047,3,Brooklyn,31166001001,176,74,102,2.7
2020,CB2020,047,3,Brooklyn,31166001002,263,137,126,2.66
2020,CB2020,047,3,Brooklyn,31166001003,239,106,133,2.43
2020,CB2020,047,3,Brooklyn,31166001004,134,66,68,2.43
2020,CB2020,047,3,Brooklyn,31166002000,393,165,228,2.81
2020,CB2020,047,3,Brooklyn,31166002001,210,93,117,2.76
2020,CB2020,047,3,Brooklyn,31166002002,283,136,147,2.69
2020,CB2020,047,3,Brooklyn,31166002003,236,94,142,2.48
2020,CB2020,047,3,Brooklyn,31166002004,194,85,109,2.49
2020,CB2020,047,3,Brooklyn,31166003000,260,126,134,2.8
2020,CB2020,047,3,Brooklyn,31166003001,381,177,204,2.76
2020,CB2020,047,3,Brooklyn,31166003002,308,156,152,2.66
2020,CB2020,047,3,Brooklyn,31166003003,127,61,66,2.48
2020,CB2020,047,3,Brooklyn,31166003004,174,66,108,2.48
2020,CB2020,047,3,Brooklyn,31168001000,96,36,60,0.8
2020,CB2020,047,3,Brooklyn,31168001001,95,44,51,1.12
2020,CB2020,047,3,Brooklyn,31168001002,169,95,74,4.26
2020,CB2020,047,3,Brooklyn,31168001003,326,136,190,4.4
2020,CB2020,047,3,Brooklyn,31168001004,241,119,122,4.78
2020,CB2020,047,3,Brooklyn,31168001005,239,113,126,4.42
2020,CB2020,047,3,Brooklyn,31168002000,105,49,56,1.47
2020,CB2020,047,3,Brooklyn,31168002001,135,55,80,1.77
2020,CB2020,047,3,Brooklyn,31168002002,371,186,185,4.13
2020,CB2020,047,3,Brooklyn,31168002003,149,61,88,2.36
2020,CB2020,047,3,Brooklyn,31168002004,119,60,59,1.9
2020,CB2020,047,3,Brooklyn,31168002005,228,131,97,4.17
2020,CB2020,047,3,Brooklyn,31170001000,326,162,164,4.07
2020,CB2020,047,3,Brooklyn,31170001001,226,110,116,2.89
2020,CB2020,047,3,Brooklyn,31170001002,180,77,103,1.2
2020,CB2020,047,3,Brooklyn,31170001003,260,106,154,3.75
2020,CB2020,047,3,Brooklyn,31170002000,0,0,0,6.88
2020,CB2020,047,3,Brooklyn,31170002001,140,85,55,3.05
2020,CB2020,047,3,Brooklyn,31170002002,75,39,36,3.06
2020,CB2020,047,3,Brooklyn,31170002003,49,28,21,3.06
2020,CB2020,047,3,Brooklyn,31170002004,236,128,108,3.64
2020,CB2020,047,3,Brooklyn,31170002005,319,175,144,3.49
2020,CB2020,047,3,Brooklyn,31170002006,163,66,97,2.91
2020,CB2020,047,3,Brooklyn,31172011000,153,75,78,1.39
2020,CB2020,047,3,Brooklyn,31172011001,51,26,25,0.8
2020,CB2020,047,3,Brooklyn,31172011002,256,144,112,2.84
2020,CB2020,047,3,Brooklyn,31172011003,94,33,61,1.4
2020,CB2020,047,3,Brooklyn,31172011004,268,143,125,4.17
2020,CB2020,047,3,Brooklyn,31172011005,322,168,154,4.32
2020,CB2020,047,3,Brooklyn,31172011006,277,132,145,3.64
2020,CB2020,047,3,Brooklyn,31172012000,185,115,70,2.09
2020,CB2020,047,3,Brooklyn,31172012001,173,79,94,1.66
2020,CB2020,047,3,Brooklyn,31172012002,236,113,123,2.68
2020,CB2020,047,3,Brooklyn,31172012003,257,115,142,2.94
2020,CB2020,047,3,Brooklyn,31172012004,280,123,157,3.22
2020,CB2020,047,3,Brooklyn,31172012005,50,18,32,0.76
2020,CB2020,047,3,Brooklyn,31172021000,501,298,203,4.43
2020,CB2020,047,3,Brooklyn,31172021001,368,194,174,3.77
2020,CB2020,047,3,Brooklyn,31172021002,255,148,107,3.32
2020,CB2020,047,3,Brooklyn,31172021003,347,158,189,2.57
2020,CB2020,047,3,Brooklyn,31172021004,324,137,187,1.99
2020,CB2020,047,3,Brooklyn,31172022000,644,294,350,4.33
2020,CB2020,047,3,Brooklyn,31172022001,551,273,278,4.25
2020,CB2020,047,3,Brooklyn,31172022002,483,223,260,4.37
2020,CB2020,047,3,Brooklyn,31172022003,387,187,200,4.24
2020,CB2020,047,3,Brooklyn,31172022004,406,206,200,4.24
2020,CB2020,047,3,Brooklyn,31174001000,404,197,207,3.68
2020,CB2020,047,3,Brooklyn,31174001001,218,117,101,2.37
2020,CB2020,047,3,Brooklyn,31174001002,48,19,29,1.31
2020,CB2020,047,3,Brooklyn,31174001003,360,191,169,3.31
2020,CB2020,047,3,Brooklyn,31174001004,32,22,10,0.36
2020,CB2020,047,3,Brooklyn,31174001005,233,108,125,3.1
2020,CB2020,047,3,Brooklyn,31174001006,304,139,165,4.84
2020,CB2020,047,3,Brooklyn,31174001007,182,76,106,3.06
2020,CB2020,047,3,Brooklyn,31174001008,271,140,131,3.16
2020,CB2020,047,3,Brooklyn,31174001009,109,44,65,1.23
2020,CB2020,047,3,Brooklyn,31174002000,617,301,316,5.34
2020,CB2020,047,3,Brooklyn,31174002001,448,229,219,4.25
2020,CB2020,047,3,Brooklyn,31174002002,27,17,10,0.45
2020,CB2020,047,3,Brooklyn,31174002003,389,193,196,4.4
2020,CB2020,047,3,Brooklyn,31174002004,346,170,176,5.56
2020,CB2020,047,3,Brooklyn,31174002005,343,169,174,6.18
2020,CB2020,047,3,Brooklyn,31176011000,289,135,154,5.5
2020,CB2020,047,3,Brooklyn,31176011001,209,89,120,4.57
2020,CB2020,047,3,Brooklyn,31176011002,327,157,170,4.84
2020,CB2020,047,3,Brooklyn,31176011003,342,187,155,4.85
2020,CB2020,047,3,Brooklyn,31176012000,407,195,212,5.83
2020,CB2020,047,3,Brooklyn,31176012001,628,304,324,5.96
2020,CB2020,047,3,Brooklyn,31176012002,558,279,279,6.1
2020,CB2020,047,3,Brooklyn,31176021000,557,281,276,9.27
2020,CB2020,047,3,Brooklyn,31176021001,437,212,225,6.19
2020,CB2020,047,3,Brooklyn,31176021002,510,245,265,4.83
2020,CB2020,047,3,Brooklyn,31176022000,438,230,208,3.33
2020,CB2020,047,3,Brooklyn,31176022001,579,274,305,3.48
2020,CB2020,047,3,Brooklyn,31176022002,491,245,246,4.12
2020,CB2020,047,3,Brooklyn,31176022003,480,226,254,4.32
2020,CB2020,047,3,Brooklyn,31178001000,504,264,240,4.49
2020,CB2020,047,3,Brooklyn,31178001001,417,196,221,5.3
2020,CB2020,047,3,Brooklyn,31178001002,0,0,0,6.1
2020,CB2020,047,3,Brooklyn,31178001003,167,81,86,3.68
2020,CB2020,047,3,Brooklyn,31178001004,54,17,37,1.7
2020,CB2020,047,3,Brooklyn,31178001005,151,80,71,1.42
2020,CB2020,047,3,Brooklyn,31178001006,0,0,0,5.39
2020,CB2020,047,3,Brooklyn,31178001007,182,68,114,3.32
2020,CB2020,047,3,Brooklyn,31178001008,345,191,154,3.34
2020,CB2020,047,3,Brooklyn,31180001000,0,0,0,92.3
2020,CB2020,047,3,Brooklyn,31180001001,0,0,0,58.4
2020,CB2020,047,3,Brooklyn,31180001002,7,5,2,35.03
2020,CB2020,047,3,Brooklyn,31182011000,576,289,287,5.47
2020,CB2020,047,3,Brooklyn,31182011001,624,310,314,6.07
2020,CB2020,047,3,Brooklyn,31182011002,294,125,169,2.2
2020,CB2020,047,3,Brooklyn,31182011003,115,68,47,0.84
2020,CB2020,047,3,Brooklyn,31182012000,658,314,344,8.66
2020,CB2020,047,3,Brooklyn,31182012001,134,58,76,1.09
2020,CB2020,047,3,Brooklyn,31182012002,102,49,53,0.84
2020,CB2020,047,3,Brooklyn,31182012003,329,162,167,2.58
2020,CB2020,047,3,Brooklyn,31182012004,228,119,109,1.73
2020,CB2020,047,3,Brooklyn,31182012005,285,151,134,1.74
2020,CB2020,047,3,Brooklyn,31182021000,330,146,184,3.92
2020,CB2020,047,3,Brooklyn,31182021001,237,110,127,2.45
2020,CB2020,047,3,Brooklyn,31182021002,873,459,414,7.67
2020,CB2020,047,3,Brooklyn,31182021003,135,52,83,1.36
2020,CB2020,047,3,Brooklyn,31182022000,680,322,358,5.71
2020,CB2020,047,3,Brooklyn,31182022001,206,120,86,2.45
2020,CB2020,047,3,Brooklyn,31182022002,421,196,225,3.56
2020,CB2020,047,3,Brooklyn,31182022003,247,107,140,2.26
2020,CB2020,047,3,Brooklyn,31182022004,51,28,23,0.64
2020,CB2020,047,3,Brooklyn,31182022005,95,37,58,0.69
2020,CB2020,047,3,Brooklyn,31184001000,376,183,193,3.93
2020,CB2020,047,3,Brooklyn,31184001001,578,280,298,4.47
2020,CB2020,047,3,Brooklyn,31184001002,431,196,235,5.12
2020,CB2020,047,3,Brooklyn,31184001003,336,192,144,4.62
2020,CB2020,047,3,Brooklyn,31184002000,315,159,156,3.42
2020,CB2020,047,3,Brooklyn,31184002001,483,242,241,3.35
2020,CB2020,047,3,Brooklyn,31184002002,419,183,236,4.04
2020,CB2020,047,3,Brooklyn,31184002003,563,227,336,4.11
2020,CB2020,047,3,Brooklyn,31184003000,583,284,299,3.85
2020,CB2020,047,3,Brooklyn,31184003001,152,76,76,1.76
2020,CB2020,047,3,Brooklyn,31184003002,135,54,81,1.5
2020,CB2020,047,3,Brooklyn,31184003003,112,71,41,1.41
2020,CB2020,047,3,Brooklyn,31184003004,531,278,253,4.6
2020,CB2020,047,3,Brooklyn,31184003005,420,201,219,4.47
2020,CB2020,047,3,Brooklyn,31186001000,202,117,85,2.8
2020,CB2020,047,3,Brooklyn,31186001001,477,216,261,3.34
2020,CB2020,047,3,Brooklyn,31186001002,393,166,227,5.26
2020,CB2020,047,3,Brooklyn,31186001003,463,216,247,5.25
2020,CB2020,047,3,Brooklyn,31186002000,527,272,255,4.6
2020,CB2020,047,3,Brooklyn,31186002001,546,293,253,4.37
2020,CB2020,047,3,Brooklyn,31186002002,192,87,105,3.98
2020,CB2020,047,3,Brooklyn,31186002003,347,156,191,2.91
2020,CB2020,047,3,Brooklyn,31188001000,369,217,152,1.61
2020,CB2020,047,3,Brooklyn,31188001001,385,209,176,2.28
2020,CB2020,047,3,Brooklyn,31188001002,573,282,291,4.59
2020,CB2020,047,3,Brooklyn,31188001003,0,0,0,0.43
2020,CB2020,047,3,Brooklyn,31188001004,284,120,164,5.55
2020,CB2020,047,3,Brooklyn,31188001005,392,222,170,2.76
2020,CB2020,047,3,Brooklyn,31188002000,454,204,250,3.69
2020,CB2020,047,3,Brooklyn,31188002001,459,226,233,3.67
2020,CB2020,047,3,Brooklyn,31188002002,393,201,192,2.76
2020,CB2020,047,3,Brooklyn,31188002003,125,74,51,2.06
2020,CB2020,047,3,Brooklyn,31188002004,0,0,0,0.68
2020,CB2020,047,3,Brooklyn,31188003000,619,302,317,3.69
2020,CB2020,047,3,Brooklyn,31188003001,437,231,206,3.82
2020,CB2020,047,3,Brooklyn,31188003002,320,147,173,2.76
2020,CB2020,047,3,Brooklyn,31188003003,346,155,191,2.75
2020,CB2020,047,3,Brooklyn,31190001000,311,173,138,3.37
2020,CB2020,047,3,Brooklyn,31190001001,123,33,90,5.85
2020,CB2020,047,3,Brooklyn,31190001002,0,0,0,2.37
2020,CB2020,047,3,Brooklyn,31190001003,0,0,0,0.41
2020,CB2020,047,3,Brooklyn,31190001004,166,72,94,3.09
2020,CB2020,047,3,Brooklyn,31190001005,478,231,247,3.35
2020,CB2020,047,3,Brooklyn,31190001006,0,0,0,2.6
2020,CB2020,047,3,Brooklyn,31190001007,0,0,0,0.89
2020,CB2020,047,3,Brooklyn,31190002000,388,201,187,2.9
2020,CB2020,047,3,Brooklyn,31190002001,358,179,179,2.89
2020,CB2020,047,3,Brooklyn,31190002002,196,86,110,2.9
2020,CB2020,047,3,Brooklyn,31190002003,45,16,29,1.58
2020,CB2020,047,3,Brooklyn,31190002004,152,88,64,2.56
2020,CB2020,047,3,Brooklyn,31192001000,484,241,243,5.89
2020,CB2020,047,3,Brooklyn,31192001001,428,206,222,6.05
2020,CB2020,047,3,Brooklyn,31192001002,131,57,74,2.75
2020,CB2020,047,3,Brooklyn,31192001003,266,125,141,2.75
2020,CB2020,047,3,Brooklyn,31192002000,268,133,135,2.8
2020,CB2020,047,3,Brooklyn,31192002001,294,156,138,2.81
2020,CB2020,047,3,Brooklyn,31192002002,333,168,165,2.81
2020,CB2020,047,3,Brooklyn,31192002003,325,163,162,2.82
2020,CB2020,047,3,Brooklyn,31192002004,187,86,101,2.82
2020,CB2020,047,3,Brooklyn,31192003000,241,118,123,5.61
2020,CB2020,047,3,Brooklyn,31192003001,59,27,32,5.29
2020,CB2020,047,3,Brooklyn,31192003002,293,158,135,5.05
2020,CB2020,047,3,Brooklyn,31192003003,0,0,0,2.75
2020,CB2020,047,3,Brooklyn,31192003004,169,93,76,2.75
2020,CB2020,047,3,Brooklyn,31192003005,158,66,92,2.76
2020,CB2020,047,3,Brooklyn,31194001000,313,143,170,2.81
2020,CB2020,047,3,Brooklyn,31194001001,370,199,171,2.81
2020,CB2020,047,3,Brooklyn,31194001002,305,139,166,2.81
2020,CB2020,047,3,Brooklyn,31194001003,254,132,122,2.81
2020,CB2020,047,3,Brooklyn,31194001004,126,51,75,2.81
2020,CB2020,047,3,Brooklyn,31194002000,373,184,189,2.82
2020,CB2020,047,3,Brooklyn,31194002001,308,146,162,2.78
2020,CB2020,047,3,Brooklyn,31194002002,257,133,124,2.79
2020,CB2020,047,3,Brooklyn,31194002003,191,84,107,2.78
2020,CB2020,047,3,Brooklyn,31194002004,187,82,105,2.78
2020,CB2020,047,3,Brooklyn,31194003000,333,142,191,3.56
2020,CB2020,047,3,Brooklyn,31194003001,395,188,207,3.42
2020,CB2020,047,3,Brooklyn,31194003002,326,154,172,3.41
2020,CB2020,047,3,Brooklyn,31194003003,316,151,165,3.41
2020,CB2020,047,3,Brooklyn,31194003004,266,125,141,3.4
2020,CB2020,047,3,Brooklyn,31196001000,27,13,14,10.65
2020,CB2020,047,3,Brooklyn,31196001001,198,104,94,1.87
2020,CB2020,047,3,Brooklyn,31196001002,82,63,19,0.72
2020,CB2020,047,3,Brooklyn,31196001003,279,124,155,2.22
2020,CB2020,047,3,Brooklyn,31196001004,239,134,105,2.14
2020,CB2020,047,3,Brooklyn,31196001005,72,36,36,2.15
2020,CB2020,047,3,Brooklyn,31196001006,195,86,109,1.09
2020,CB2020,047,3,Brooklyn,31196001007,306,147,159,2.79
2020,CB2020,047,3,Brooklyn,31196001008,190,91,99,2.75
2020,CB2020,047,3,Brooklyn,31196001009,105,56,49,1.81
2020,CB2020,047,3,Brooklyn,31196002000,312,169,143,2.81
2020,CB2020,047,3,Brooklyn,31196002001,77,38,39,2.81
2020,CB2020,047,3,Brooklyn,31196002002,235,106,129,2.3
2020,CB2020,047,3,Brooklyn,31196002003,176,79,97,2.3
2020,CB2020,047,3,Brooklyn,31196002004,211,109,102,2.82
2020,CB2020,047,3,Brooklyn,31196002005,146,53,93,2.82
2020,CB2020,047,3,Brooklyn,31196003000,511,264,247,2.82
2020,CB2020,047,3,Brooklyn,31196003001,461,244,217,2.81
2020,CB2020,047,3,Brooklyn,31196003002,235,118,117,2.3
2020,CB2020,047,3,Brooklyn,31196003003,224,120,104,2.32
2020,CB2020,047,3,Brooklyn,31196003004,226,100,126,2.81
2020,CB2020,047,3,Brooklyn,31196003005,265,135,130,2.81
2020,CB2020,047,3,Brooklyn,31196004000,399,209,190,2.79
2020,CB2020,047,3,Brooklyn,31196004001,398,223,175,2.83
2020,CB2020,047,3,Brooklyn,31196004002,184,82,102,2.28
2020,CB2020,047,3,Brooklyn,31196004003,307,115,192,2.32
2020,CB2020,047,3,Brooklyn,31196004004,94,45,49,2.81
2020,CB2020,047,3,Brooklyn,31196004005,304,134,170,2.78
2020,CB2020,047,3,Brooklyn,31198001000,199,163,36,2.67
2020,CB2020,047,3,Brooklyn,31198001001,24,12,12,1.83
2020,CB2020,047,3,Brooklyn,31198001002,0,0,0,0.98
2020,CB2020,047,3,Brooklyn,31198001003,0,0,0,0.48
2020,CB2020,047,3,Brooklyn,31198001004,134,93,41,2.59
2020,CB2020,047,3,Brooklyn,31198001005,213,119,94,2.86
2020,CB2020,047,3,Brooklyn,31198001006,131,61,70,3.35
2020,CB2020,047,3,Brooklyn,31198001007,51,36,15,3.65
2020,CB2020,047,3,Brooklyn,31198001008,52,30,22,3.17
2020,CB2020,047,3,Brooklyn,31198001009,224,107,117,3.24
2020,CB2020,047,3,Brooklyn,31198001010,26,7,19,3.18
2020,CB2020,047,3,Brooklyn,31198001011,0,0,0,3.33
2020,CB2020,047,3,Brooklyn,31198001012,0,0,0,0.31
2020,CB2020,047,3,Brooklyn,31198002000,212,115,97,3.53
2020,CB2020,047,3,Brooklyn,31198002001,210,103,107,3.52
2020,CB2020,047,3,Brooklyn,31198002002,283,141,142,3.57
2020,CB2020,047,3,Brooklyn,31198002003,248,123,125,3.39
2020,CB2020,047,3,Brooklyn,31198002004,111,50,61,2.71
2020,CB2020,047,3,Brooklyn,31198002005,40,21,19,2.7
2020,CB2020,047,3,Brooklyn,31198002006,170,89,81,2.6
2020,CB2020,047,3,Brooklyn,31198002007,53,27,26,2.59
2020,CB2020,047,3,Brooklyn,31198003000,213,88,125,3.4
2020,CB2020,047,3,Brooklyn,31198003001,297,155,142,3.36
2020,CB2020,047,3,Brooklyn,31198003002,190,113,77,3.44
2020,CB2020,047,3,Brooklyn,31198003003,380,175,205,3.5
2020,CB2020,047,3,Brooklyn,31198003004,121,55,66,2.6
2020,CB2020,047,3,Brooklyn,31198003005,39,16,23,2.66
2020,CB2020,047,3,Brooklyn,31198003006,49,29,20,2.73
2020,CB2020,047,3,Brooklyn,31198003007,26,11,15,2.82
2020,CB2020,047,3,Brooklyn,31200001000,0,0,0,1.53
2020,CB2020,047,3,Brooklyn,31200001001,41,13,28,2.31
2020,CB2020,047,3,Brooklyn,31200001002,216,109,107,2.93
2020,CB2020,047,3,Brooklyn,31200001003,0,0,0,0.7
2020,CB2020,047,3,Brooklyn,31200001004,134,87,47,1.88
2020,CB2020,047,3,Brooklyn,31200001005,102,49,53,2.75
2020,CB2020,047,3,Brooklyn,31200001006,0,0,0,0.2
2020,CB2020,047,3,Brooklyn,31200001007,276,130,146,2.81
2020,CB2020,047,3,Brooklyn,31200001008,492,227,265,2.8
2020,CB2020,047,3,Brooklyn,31200002000,49,14,35,0.82
2020,CB2020,047,3,Brooklyn,31200002001,164,156,8,1.81
2020,CB2020,047,3,Brooklyn,31200002002,323,157,166,2.84
2020,CB2020,047,3,Brooklyn,31200002003,0,0,0,2.67
2020,CB2020,047,3,Brooklyn,31200002004,187,77,110,2.77
2020,CB2020,047,3,Brooklyn,31200002005,288,140,148,2.8
2020,CB2020,047,3,Brooklyn,31200002006,267,143,124,2.78
2020,CB2020,047,3,Brooklyn,31200002007,334,164,170,2.78
2020,CB2020,047,3,Brooklyn,31202001000,112,30,82,1.39
2020,CB2020,047,3,Brooklyn,31202001001,186,105,81,1.43
2020,CB2020,047,3,Brooklyn,31202001002,292,143,149,2.82
2020,CB2020,047,3,Brooklyn,31202001003,0,0,0,2.74
2020,CB2020,047,3,Brooklyn,31202001004,148,83,65,2.84
2020,CB2020,047,3,Brooklyn,31202001005,0,0,0,0.6
2020,CB2020,047,3,Brooklyn,31202001006,0,0,0,8.04
2020,CB2020,047,3,Brooklyn,31202001007,0,0,0,0.25
2020,CB2020,047,3,Brooklyn,31202001008,131,74,57,1.23
2020,CB2020,047,3,Brooklyn,31202001009,183,108,75,2.18
2020,CB2020,047,3,Brooklyn,31202002000,341,176,165,2.83
2020,CB2020,047,3,Brooklyn,31202002001,81,42,39,2.84
2020,CB2020,047,3,Brooklyn,31202002002,326,166,160,2.77
2020,CB2020,047,3,Brooklyn,31202002003,34,19,15,1.93
2020,CB2020,047,3,Brooklyn,31202002004,138,70,68,0.93
2020,CB2020,047,3,Brooklyn,31202002005,0,0,0,3.01
2020,CB2020,047,3,Brooklyn,31208011000,391,186,205,3.4
2020,CB2020,047,3,Brooklyn,31208011001,489,251,238,3.49
2020,CB2020,047,3,Brooklyn,31208012000,290,137,153,3.41
2020,CB2020,047,3,Brooklyn,31208012001,385,172,213,3.54
2020,CB2020,047,3,Brooklyn,31208012002,114,37,77,3.27
2020,CB2020,047,3,Brooklyn,31208012003,218,106,112,2.76
2020,CB2020,047,3,Brooklyn,31208012004,0,0,0,0.51
2020,CB2020,047,3,Brooklyn,31208013000,354,186,168,3.48
2020,CB2020,047,3,Brooklyn,31208013001,315,151,164,3.4
2020,CB2020,047,3,Brooklyn,31208013002,381,169,212,3.42
2020,CB2020,047,3,Brooklyn,31208014000,200,85,115,3.5
2020,CB2020,047,3,Brooklyn,31208014001,258,110,148,3.4
2020,CB2020,047,3,Brooklyn,31208014002,248,103,145,3.41
2020,CB2020,047,3,Brooklyn,31208014003,71,27,44,2.7
2020,CB2020,047,3,Brooklyn,31208014004,71,21,50,2.73
2020,CB2020,047,3,Brooklyn,31208014005,214,97,117,3.07
2020,CB2020,047,3,Brooklyn,31208014006,0,0,0,0.48
2020,CB2020,047,3,Brooklyn,31208021000,3002,1286,1716,19.21
2020,CB2020,047,3,Brooklyn,31208022000,768,338,430,9.12
2020,CB2020,047,3,Brooklyn,31208022001,0,0,0,0.66
2020,CB2020,047,3,Brooklyn,31208031000,0,0,0,0.26
2020,CB2020,047,3,Brooklyn,31208031001,82,40,42,3.14
2020,CB2020,047,3,Brooklyn,31208031002,187,72,115,3.37
2020,CB2020,047,3,Brooklyn,31208031003,214,103,111,3.44
2020,CB2020,047,3,Brooklyn,31208031004,194,100,94,3.5
2020,CB2020,047,3,Brooklyn,31208031005,220,98,122,3.38
2020,CB2020,047,3,Brooklyn,31208031006,99,58,41,3.39
2020,CB2020,047,3,Brooklyn,31208031007,212,101,111,2.76
2020,CB2020,047,3,Brooklyn,31208031008,141,61,80,2.72
2020,CB2020,047,3,Brooklyn,31208031009,44,36,8,2.74
2020,CB2020,047,3,Brooklyn,31208031010,0,0,0,2.75
2020,CB2020,047,3,Brooklyn,31208031011,0,0,0,0.94
2020,CB2020,047,3,Brooklyn,31208031012,0,0,0,0.43
2020,CB2020,047,3,Brooklyn,31208031013,617,320,297,5.54
2020,CB2020,047,3,Brooklyn,31210001000,1939,786,1153,24.04
2020,CB2020,047,3,Brooklyn,31210002000,1749,731,1018,14.52
2020,CB2020,047,3,Brooklyn,31210002001,0,0,0,0.66
2020,CB2020,047,3,Brooklyn,31214001000,0,0,0,1.16
2020,CB2020,047,3,Brooklyn,31214001001,0,0,0,0.81
2020,CB2020,047,3,Brooklyn,31214001002,0,0,0,0.58
2020,CB2020,047,3,Brooklyn,31214001003,0,0,0,0.44
2020,CB2020,047,3,Brooklyn,31214001004,799,359,440,6.56
2020,CB2020,047,3,Brooklyn,31214001005,1496,594,902,13.25
2020,CB2020,047,3,Brooklyn,31214002000,1075,420,655,13.39
2020,CB2020,047,3,Brooklyn,31214002001,730,292,438,6.64
2020,CB2020,047,3,Brooklyn,31220001000,0,0,0,2
2020,CB2020,047,3,Brooklyn,31220001001,0,0,0,6.63
2020,CB2020,047,3,Brooklyn,31220001002,24,6,18,3.27
2020,CB2020,047,3,Brooklyn,31220001003,38,16,22,3.33
2020,CB2020,047,3,Brooklyn,31220001004,256,110,146,3.48
2020,CB2020,047,3,Brooklyn,31220001005,332,145,187,3.46
2020,CB2020,047,3,Brooklyn,31220001006,421,187,234,3.18
2020,CB2020,047,3,Brooklyn,31220001007,651,277,374,3.76
2020,CB2020,047,3,Brooklyn,31220001008,529,232,297,3.33
2020,CB2020,047,3,Brooklyn,31220001009,20,14,6,6.81
2020,CB2020,047,3,Brooklyn,31220001010,0,0,0,0.36
2020,CB2020,047,3,Brooklyn,31220001011,0,0,0,0.69
2020,CB2020,047,3,Brooklyn,31220001012,131,63,68,53.75
2020,CB2020,047,3,Brooklyn,31220001013,0,0,0,5.05
2020,CB2020,047,3,Brooklyn,31220001014,0,0,0,26.6
2020,CB2020,047,3,Brooklyn,31220001015,0,0,0,17.43
2020,CB2020,047,3,Brooklyn,31220001016,148,87,61,3.54
2020,CB2020,047,3,Brooklyn,31220002000,0,0,0,6.97
2020,CB2020,047,3,Brooklyn,31220002001,46,34,12,3.13
2020,CB2020,047,3,Brooklyn,31220002002,250,153,97,3.43
2020,CB2020,047,3,Brooklyn,31220002003,116,75,41,3.43
2020,CB2020,047,3,Brooklyn,31220002004,0,0,0,3.44
2020,CB2020,047,3,Brooklyn,31220002005,238,107,131,3.4
2020,CB2020,047,3,Brooklyn,31220002006,169,48,121,3.45
2020,CB2020,047,3,Brooklyn,31220002007,178,92,86,3.49
2020,CB2020,047,3,Brooklyn,31220002008,217,104,113,3.43
2020,CB2020,047,3,Brooklyn,31220002009,0,0,0,0.43
2020,CB2020,047,3,Brooklyn,31220002010,0,0,0,0.65
2020,CB2020,047,3,Brooklyn,31220002011,0,0,0,0.71
2020,CB2020,047,3,Brooklyn,31220002012,8,3,5,0.5
2020,CB2020,047,3,Brooklyn,31220002013,21,6,15,0.66
2020,CB2020,047,3,Brooklyn,31220002014,0,0,0,1.79
2020,CB2020,047,3,Brooklyn,31220002015,0,0,0,2.86
2020,CB2020,047,3,Brooklyn,31220002016,232,147,85,3.43
2020,CB2020,047,3,Brooklyn,31220002017,196,86,110,3.39
2020,CB2020,047,3,Brooklyn,31220002018,0,0,0,2.37
2020,CB2020,047,3,Brooklyn,31220002019,0,0,0,3.15
2020,CB2020,047,3,Brooklyn,31220002020,304,135,169,3.45
2020,CB2020,047,3,Brooklyn,31220002021,305,135,170,4.27
2020,CB2020,047,3,Brooklyn,31220002022,212,125,87,3.79
2020,CB2020,047,3,Brooklyn,31220002023,97,34,63,33.3
2020,CB2020,047,3,Brooklyn,31220002024,84,39,45,1.85
2020,CB2020,047,3,Brooklyn,31220002025,0,0,0,8.08
2020,CB2020,047,3,Brooklyn,31220002026,326,122,204,4.79
2020,CB2020,047,3,Brooklyn,31220002027,121,35,86,1.41
2020,CB2020,047,3,Brooklyn,31220002028,210,102,108,3.34
2020,CB2020,047,3,Brooklyn,31220002029,289,120,169,4.37
2020,CB2020,047,3,Brooklyn,31237001000,102,49,53,6.61
2020,CB2020,047,3,Brooklyn,31237001001,0,0,0,1.24
2020,CB2020,047,3,Brooklyn,31237001002,307,165,142,2.89
2020,CB2020,047,3,Brooklyn,31237001003,431,241,190,4.45
2020,CB2020,047,3,Brooklyn,31237001004,674,340,334,6.93
2020,CB2020,047,3,Brooklyn,31237002000,728,346,382,4.87
2020,CB2020,047,3,Brooklyn,31237002001,650,319,331,4.58
2020,CB2020,047,3,Brooklyn,31237002002,1156,592,564,4.76
2020,CB2020,047,3,Brooklyn,31237002003,1560,801,759,4.94
2020,CB2020,047,3,Brooklyn,31237003000,99,51,48,4.82
2020,CB2020,047,3,Brooklyn,31237003001,0,0,0,4.66
2020,CB2020,047,3,Brooklyn,31237003002,88,52,36,4.65
2020,CB2020,047,3,Brooklyn,31237003003,754,394,360,4.92
2020,CB2020,047,3,Brooklyn,31237003004,1430,735,695,4.95
2020,CB2020,047,3,Brooklyn,31237003005,326,156,170,4.66
2020,CB2020,047,3,Brooklyn,31237003006,208,100,108,4.67
2020,CB2020,047,3,Brooklyn,31237003007,73,35,38,4.84
2020,CB2020,047,3,Brooklyn,31502001000,20,8,12,1.76
2020,CB2020,047,3,Brooklyn,31502001001,206,90,116,4.39
2020,CB2020,047,3,Brooklyn,31502001002,249,109,140,4.6
2020,CB2020,047,3,Brooklyn,31502001003,243,129,114,4.58
2020,CB2020,047,3,Brooklyn,31502001004,309,167,142,5.77
2020,CB2020,047,3,Brooklyn,31502002000,0,0,0,1.24
2020,CB2020,047,3,Brooklyn,31502002001,36,22,14,1.37
2020,CB2020,047,3,Brooklyn,31502002002,67,40,27,1.68
2020,CB2020,047,3,Brooklyn,31502002003,195,83,112,3.23
2020,CB2020,047,3,Brooklyn,31502002004,260,110,150,5.2
2020,CB2020,047,3,Brooklyn,31502002005,136,66,70,2.15
2020,CB2020,047,3,Brooklyn,31502002006,96,56,40,1.91
2020,CB2020,047,3,Brooklyn,31502003000,0,0,0,1.87
2020,CB2020,047,3,Brooklyn,31502003001,0,0,0,3.02
2020,CB2020,047,3,Brooklyn,31502003002,206,84,122,4.68
2020,CB2020,047,3,Brooklyn,31502003003,37,15,22,4.66
2020,CB2020,047,3,Brooklyn,31502003004,0,0,0,2.25
2020,CB2020,047,3,Brooklyn,31502003005,0,0,0,2.36
2020,CB2020,047,3,Brooklyn,31502003006,0,0,0,2.38
2020,CB2020,047,3,Brooklyn,31502003007,0,0,0,2.23
2020,CB2020,047,3,Brooklyn,31502003008,0,0,0,4.75
2020,CB2020,047,3,Brooklyn,31502003009,288,148,140,5
2020,CB2020,047,3,Brooklyn,31502003010,31,6,25,2.04
2020,CB2020,047,3,Brooklyn,31502003011,0,0,0,2.31
2020,CB2020,047,3,Brooklyn,31502003012,237,121,116,3.48
2020,CB2020,047,3,Brooklyn,31522001000,34,11,23,2.35
2020,CB2020,047,3,Brooklyn,31522001001,56,27,29,1.81
2020,CB2020,047,3,Brooklyn,31522001002,23,15,8,1.89
2020,CB2020,047,3,Brooklyn,31522001003,188,84,104,2.96
2020,CB2020,047,3,Brooklyn,31522001004,116,60,56,5.25
2020,CB2020,047,3,Brooklyn,31522001005,125,60,65,5.25
2020,CB2020,047,3,Brooklyn,31522001006,116,47,69,4.56
2020,CB2020,047,3,Brooklyn,31522001007,95,50,45,2.28
2020,CB2020,047,3,Brooklyn,31522001008,65,32,33,2.67
2020,CB2020,047,3,Brooklyn,31522001009,448,192,256,2.78
2020,CB2020,047,3,Brooklyn,31522001010,44,20,24,1.91
2020,CB2020,047,3,Brooklyn,31522001011,133,99,34,2.04
2020,CB2020,047,3,Brooklyn,31522002000,285,117,168,8.37
2020,CB2020,047,3,Brooklyn,31522002001,136,73,63,4.45
2020,CB2020,047,3,Brooklyn,31522002002,466,268,198,5.71
2020,CB2020,047,3,Brooklyn,31522003000,55,32,23,3.92
2020,CB2020,047,3,Brooklyn,31522003001,115,70,45,3.4
2020,CB2020,047,3,Brooklyn,31522003002,40,22,18,2.89
2020,CB2020,047,3,Brooklyn,31522003003,42,12,30,2.65
2020,CB2020,047,3,Brooklyn,31522003004,59,27,32,2.6
2020,CB2020,047,3,Brooklyn,31522003005,76,33,43,5.29
2020,CB2020,047,3,Brooklyn,31522003006,162,94,68,7.1
2020,CB2020,047,3,Brooklyn,31522003007,146,79,67,2.89
2020,CB2020,047,3,Brooklyn,31522003008,115,47,68,3.58
2020,CB2020,047,3,Brooklyn,31522003009,82,41,41,5.39
2020,CB2020,047,3,Brooklyn,31522003010,65,17,48,2.34
2020,CB2020,047,3,Brooklyn,39901000001,0,0,0,0
2020,CB2020,047,3,Brooklyn,39901000002,0,0,0,0
2020,CB2020,047,3,Brooklyn,39901000003,0,0,0,0
2020,CB2020,047,3,Brooklyn,39901000004,0,0,0,0
2020,CB2020,047,3,Brooklyn,39901000005,0,0,0,0
2020,CB2020,047,3,Brooklyn,39901000006,0,0,0,0
2020,CB2020,047,3,Brooklyn,39901000007,0,0,0,0
2020,CB2020,047,3,Brooklyn,39901000008,0,0,0,0
2020,CB2020,061,1,Manhattan,10001001000,0,0,0,4.68
2020,CB2020,061,1,Manhattan,10001001001,0,0,0,14.19
2020,CB2020,061,1,Manhattan,10002010001,0,0,0,0
2020,CB2020,061,1,Manhattan,10002011000,801,414,387,2.92
2020,CB2020,061,1,Manhattan,10002011001,0,0,0,3.23
2020,CB2020,061,1,Manhattan,10002012000,1186,488,698,6.03
2020,CB2020,061,1,Manhattan,10002012001,25,15,10,4.66
2020,CB2020,061,1,Manhattan,10002012002,0,0,0,0.39
2020,CB2020,061,1,Manhattan,10002012003,0,0,0,0.45
2020,CB2020,061,1,Manhattan,10002012004,0,0,0,4.63
2020,CB2020,061,1,Manhattan,10002020001,0,0,0,0
2020,CB2020,061,1,Manhattan,10002021000,0,0,0,1.34
2020,CB2020,061,1,Manhattan,10002021001,410,197,213,5.06
2020,CB2020,061,1,Manhattan,10002021002,96,44,52,4.73
2020,CB2020,061,1,Manhattan,10002021003,0,0,0,0.6
2020,CB2020,061,1,Manhattan,10002021004,248,101,147,1.9
2020,CB2020,061,1,Manhattan,10002022000,863,370,493,3.78
2020,CB2020,061,1,Manhattan,10002022001,788,335,453,3.25
2020,CB2020,061,1,Manhattan,10002023000,553,244,309,1.97
2020,CB2020,061,1,Manhattan,10002023001,673,268,405,4.77
2020,CB2020,061,1,Manhattan,10002024000,0,0,0,11.12
2020,CB2020,061,1,Manhattan,10002024001,0,0,0,1.21
2020,CB2020,061,1,Manhattan,10002024002,44,16,28,6.65
2020,CB2020,061,1,Manhattan,10002024003,2075,957,1118,8.91
2020,CB2020,061,1,Manhattan,10002025000,0,0,0,0.78
2020,CB2020,061,1,Manhattan,10002026000,270,117,153,1.99
2020,CB2020,061,1,Manhattan,10002026001,267,118,149,3.15
2020,CB2020,061,1,Manhattan,10002026002,162,97,65,0.73
2020,CB2020,061,1,Manhattan,10002026003,557,256,301,3.31
2020,CB2020,061,1,Manhattan,10002026004,0,0,0,1
2020,CB2020,061,1,Manhattan,10002026005,260,131,129,1.07
2020,CB2020,061,1,Manhattan,10002026006,0,0,0,1.3
2020,CB2020,061,1,Manhattan,10002026007,0,0,0,8.01
2020,CB2020,061,1,Manhattan,10005000001,0,0,0,0
2020,CB2020,061,1,Manhattan,10005000002,0,0,0,0
2020,CB2020,061,1,Manhattan,10005000003,0,0,0,0
2020,CB2020,061,1,Manhattan,10005000004,0,0,0,0
2020,CB2020,061,1,Manhattan,10005001000,0,0,0,0.41
2020,CB2020,061,1,Manhattan,10005001001,0,0,0,12.37
2020,CB2020,061,1,Manhattan,10005001002,0,0,0,4.2
2020,CB2020,061,1,Manhattan,10005001003,1,0,1,10.49
2020,CB2020,061,1,Manhattan,10005001004,0,0,0,0.69
2020,CB2020,061,1,Manhattan,10005001005,0,0,0,1.95
2020,CB2020,061,1,Manhattan,10005001006,0,0,0,5.56
2020,CB2020,061,1,Manhattan,10005001007,1,0,1,11.76
2020,CB2020,061,1,Manhattan,10005001008,0,0,0,2.47
2020,CB2020,061,1,Manhattan,10005001009,0,0,0,4.11
2020,CB2020,061,1,Manhattan,10005001010,0,0,0,2.01
2020,CB2020,061,1,Manhattan,10005001011,0,0,0,7.41
2020,CB2020,061,1,Manhattan,10005001012,0,0,0,5.12
2020,CB2020,061,1,Manhattan,10005001013,0,0,0,12.64
2020,CB2020,061,1,Manhattan,10005001014,0,0,0,1
2020,CB2020,061,1,Manhattan,10005001015,0,0,0,0.91
2020,CB2020,061,1,Manhattan,10005001016,0,0,0,4.82
2020,CB2020,061,1,Manhattan,10005001017,0,0,0,0.62
2020,CB2020,061,1,Manhattan,10005001018,0,0,0,0.67
2020,CB2020,061,1,Manhattan,10005001019,0,0,0,0.8
2020,CB2020,061,1,Manhattan,10005001020,0,0,0,25.23
2020,CB2020,061,1,Manhattan,10005001021,2,0,2,4.87
2020,CB2020,061,1,Manhattan,10005001022,0,0,0,2.17
2020,CB2020,061,1,Manhattan,10005001023,1,1,0,5.56
2020,CB2020,061,1,Manhattan,10005001024,0,0,0,40.03
2020,CB2020,061,1,Manhattan,10005001025,0,0,0,0.26
2020,CB2020,061,1,Manhattan,10005001026,0,0,0,0.88
2020,CB2020,061,1,Manhattan,10005001027,0,0,0,0.79
2020,CB2020,061,1,Manhattan,10005001028,0,0,0,0.1
2020,CB2020,061,1,Manhattan,10005001029,0,0,0,5.11
2020,CB2020,061,1,Manhattan,10005001030,0,0,0,1.39
2020,CB2020,061,1,Manhattan,10005001031,0,0,0,1.74
2020,CB2020,061,1,Manhattan,10005002000,0,0,0,5.35
2020,CB2020,061,1,Manhattan,10005002001,0,0,0,5.31
2020,CB2020,061,1,Manhattan,10005002002,0,0,0,5.05
2020,CB2020,061,1,Manhattan,10005002003,0,0,0,5.08
2020,CB2020,061,1,Manhattan,10005002004,0,0,0,0.14
2020,CB2020,061,1,Manhattan,10005002005,0,0,0,0.29
2020,CB2020,061,1,Manhattan,10005002006,0,0,0,2.76
2020,CB2020,061,1,Manhattan,10005002007,0,0,0,6.39
2020,CB2020,061,1,Manhattan,10006000001,0,0,0,0
2020,CB2020,061,1,Manhattan,10006000002,0,0,0,0
2020,CB2020,061,1,Manhattan,10006001000,501,270,231,2.74
2020,CB2020,061,1,Manhattan,10006001001,1056,525,531,3.55
2020,CB2020,061,1,Manhattan,10006001002,327,141,186,3.92
2020,CB2020,061,1,Manhattan,10006002000,1035,477,558,3.75
2020,CB2020,061,1,Manhattan,10006002001,666,278,388,4.28
2020,CB2020,061,1,Manhattan,10006002002,0,0,0,1.1
2020,CB2020,061,1,Manhattan,10006002003,2393,1118,1275,5.27
2020,CB2020,061,1,Manhattan,10006002004,0,0,0,0.5
2020,CB2020,061,1,Manhattan,10006002005,0,0,0,0.7
2020,CB2020,061,1,Manhattan,10006002006,25,12,13,0.38
2020,CB2020,061,1,Manhattan,10006003000,384,178,206,2.43
2020,CB2020,061,1,Manhattan,10006003001,514,236,278,2.39
2020,CB2020,061,1,Manhattan,10006003002,0,0,0,0.36
2020,CB2020,061,1,Manhattan,10006004000,266,108,158,2.69
2020,CB2020,061,1,Manhattan,10006004001,1054,532,522,2.62
2020,CB2020,061,1,Manhattan,10006005000,1080,439,641,7.65
2020,CB2020,061,1,Manhattan,10006005001,573,244,329,2.17
2020,CB2020,061,1,Manhattan,10006006000,1742,760,982,7.12
2020,CB2020,061,1,Manhattan,10006006001,0,0,0,0.52
2020,CB2020,061,1,Manhattan,10006006002,0,0,0,0.69
2020,CB2020,061,1,Manhattan,10006006003,0,0,0,4.58
2020,CB2020,061,1,Manhattan,10007000001,0,0,0,0
2020,CB2020,061,1,Manhattan,10007001000,0,0,0,1.63
2020,CB2020,061,1,Manhattan,10007001001,0,0,0,1.68
2020,CB2020,061,1,Manhattan,10007001002,23,12,11,1.99
2020,CB2020,061,1,Manhattan,10007001003,19,11,8,1.56
2020,CB2020,061,1,Manhattan,10007001004,404,243,161,1.75
2020,CB2020,061,1,Manhattan,10007001005,24,8,16,2.41
2020,CB2020,061,1,Manhattan,10007002000,2124,1068,1056,2.68
2020,CB2020,061,1,Manhattan,10007003000,656,345,311,3.75
2020,CB2020,061,1,Manhattan,10007004000,558,265,293,0.95
2020,CB2020,061,1,Manhattan,10007004001,476,205,271,1.22
2020,CB2020,061,1,Manhattan,10007004002,1103,575,528,2.02
2020,CB2020,061,1,Manhattan,10007004003,36,30,6,2.9
2020,CB2020,061,1,Manhattan,10007004004,126,60,66,1.13
2020,CB2020,061,1,Manhattan,10007005000,1102,524,578,1.02
2020,CB2020,061,1,Manhattan,10007005001,1089,481,608,0.93
2020,CB2020,061,1,Manhattan,10007006000,1130,544,586,2.53
2020,CB2020,061,1,Manhattan,10007006001,222,76,146,0.63
2020,CB2020,061,1,Manhattan,10007006002,308,155,153,1.17
2020,CB2020,061,1,Manhattan,10007007000,0,0,0,1.83
2020,CB2020,061,1,Manhattan,10007007001,196,87,109,1.2
2020,CB2020,061,1,Manhattan,10007007002,0,0,0,2.24
2020,CB2020,061,1,Manhattan,10007007003,103,51,52,3.52
2020,CB2020,061,1,Manhattan,10007007004,11,9,2,1.72
2020,CB2020,061,1,Manhattan,10007007005,811,334,477,1.23
2020,CB2020,061,1,Manhattan,10007007006,0,0,0,1.1
2020,CB2020,061,1,Manhattan,10007007007,0,0,0,1.44
2020,CB2020,061,1,Manhattan,10007007008,0,0,0,0.73
2020,CB2020,061,1,Manhattan,10007008000,0,0,0,1.04
2020,CB2020,061,1,Manhattan,10007008001,0,0,0,0.8
2020,CB2020,061,1,Manhattan,10007008002,21,15,6,8.83
2020,CB2020,061,1,Manhattan,10007009000,0,0,0,4.96
2020,CB2020,061,1,Manhattan,10008000001,0,0,0,0
2020,CB2020,061,1,Manhattan,10008000002,0,0,0,0
2020,CB2020,061,1,Manhattan,10008001000,453,230,223,3.53
2020,CB2020,061,1,Manhattan,10008001001,858,422,436,4.25
2020,CB2020,061,1,Manhattan,10008002000,1443,725,718,4.45
2020,CB2020,061,1,Manhattan,10008003000,1667,811,856,4.28
2020,CB2020,061,1,Manhattan,10008004000,1967,897,1070,3.55
2020,CB2020,061,1,Manhattan,10008005000,2845,1321,1524,2.76
2020,CB2020,061,1,Manhattan,10008005001,0,0,0,2.52
2020,CB2020,061,1,Manhattan,10008005002,0,0,0,0.38
2020,CB2020,061,1,Manhattan,10008005003,0,0,0,2.67
2020,CB2020,061,1,Manhattan,10008006000,0,0,0,0.34
2020,CB2020,061,1,Manhattan,10008006001,90,27,63,1.78
2020,CB2020,061,1,Manhattan,10008006002,0,0,0,0.35
2020,CB2020,061,1,Manhattan,10008006003,0,0,0,0.44
2020,CB2020,061,1,Manhattan,10008006004,0,0,0,0.25
2020,CB2020,061,1,Manhattan,10008006005,0,0,0,0.52
2020,CB2020,061,1,Manhattan,10008006006,240,138,102,0.97
2020,CB2020,061,1,Manhattan,10008006007,0,0,0,0.23
2020,CB2020,061,1,Manhattan,10008006008,12,11,1,0.2
2020,CB2020,061,1,Manhattan,10008006009,0,0,0,1.66
2020,CB2020,061,1,Manhattan,10008006010,479,296,183,1.98
2020,CB2020,061,1,Manhattan,10008006011,0,0,0,0.38
2020,CB2020,061,1,Manhattan,10008006012,0,0,0,0.42
2020,CB2020,061,1,Manhattan,10008006013,0,0,0,0.44
2020,CB2020,061,1,Manhattan,10008006014,414,167,247,1.14
2020,CB2020,061,1,Manhattan,10008006015,0,0,0,0.25
2020,CB2020,061,1,Manhattan,10008006016,0,0,0,0.42
2020,CB2020,061,1,Manhattan,10008006017,358,182,176,1.44
2020,CB2020,061,1,Manhattan,10008006018,0,0,0,2.83
2020,CB2020,061,1,Manhattan,10008006019,29,21,8,4.2
2020,CB2020,061,1,Manhattan,10008006020,0,0,0,0.23
2020,CB2020,061,1,Manhattan,10008006021,0,0,0,0.4
2020,CB2020,061,1,Manhattan,10008006022,0,0,0,0.32
2020,CB2020,061,1,Manhattan,10008006023,0,0,0,0.86
2020,CB2020,061,1,Manhattan,10008006024,0,0,0,0.56
2020,CB2020,061,1,Manhattan,10008006025,0,0,0,0.43
2020,CB2020,061,1,Manhattan,10008006026,0,0,0,0.43
2020,CB2020,061,1,Manhattan,10008006027,16,10,6,0.8
2020,CB2020,061,1,Manhattan,10008006028,0,0,0,0.84
2020,CB2020,061,1,Manhattan,10008006029,0,0,0,1.04
2020,CB2020,061,1,Manhattan,10009000001,0,0,0,0
2020,CB2020,061,1,Manhattan,10009000002,0,0,0,0
2020,CB2020,061,1,Manhattan,10009001000,564,306,258,1.17
2020,CB2020,061,1,Manhattan,10009001001,367,168,199,2.23
2020,CB2020,061,1,Manhattan,10009001002,246,113,133,2.98
2020,CB2020,061,1,Manhattan,10009001003,10,3,7,3.51
2020,CB2020,061,1,Manhattan,10009001004,27,19,8,3.1
2020,CB2020,061,1,Manhattan,10009001005,69,38,31,0.69
2020,CB2020,061,1,Manhattan,10009001006,72,57,15,1.9
2020,CB2020,061,1,Manhattan,10009001007,0,0,0,0.4
2020,CB2020,061,1,Manhattan,10009001008,0,0,0,2.62
2020,CB2020,061,1,Manhattan,10009001009,0,0,0,1.47
2020,CB2020,061,1,Manhattan,10009001010,0,0,0,1.07
2020,CB2020,061,1,Manhattan,10009001011,90,66,24,2.25
2020,CB2020,061,1,Manhattan,10009001012,51,24,27,0.99
2020,CB2020,061,1,Manhattan,10009001013,41,27,14,2.09
2020,CB2020,061,1,Manhattan,10009001014,0,0,0,9.15
2020,CB2020,061,1,Manhattan,10009001015,99,45,54,1.35
2020,CB2020,061,1,Manhattan,10009001016,173,162,11,1.17
2020,CB2020,061,1,Manhattan,10009001017,170,83,87,0.79
2020,CB2020,061,1,Manhattan,10009001018,4,4,0,2.18
2020,CB2020,061,1,Manhattan,10009001019,21,21,0,4.47
2020,CB2020,061,1,Manhattan,10009001020,0,0,0,3.63
2020,CB2020,061,1,Manhattan,10009001021,0,0,0,1.35
2020,CB2020,061,1,Manhattan,10009001022,0,0,0,10.96
2020,CB2020,061,1,Manhattan,10009001023,12,1,11,1.63
2020,CB2020,061,1,Manhattan,10009002000,0,0,0,5.21
2020,CB2020,061,1,Manhattan,10009002001,0,0,0,5.52
2020,CB2020,061,1,Manhattan,10010010001,0,0,0,0
2020,CB2020,061,1,Manhattan,10010010002,0,0,0,0
2020,CB2020,061,1,Manhattan,10010010003,0,0,0,0
2020,CB2020,061,1,Manhattan,10010011000,0,0,0,0.45
2020,CB2020,061,1,Manhattan,10010011001,0,0,0,0.36
2020,CB2020,061,1,Manhattan,10010011002,0,0,0,0.34
2020,CB2020,061,1,Manhattan,10010011003,0,0,0,0.34
2020,CB2020,061,1,Manhattan,10010011004,0,0,0,0.53
2020,CB2020,061,1,Manhattan,10010011005,0,0,0,0.32
2020,CB2020,061,1,Manhattan,10010011006,0,0,0,0.38
2020,CB2020,061,1,Manhattan,10010011007,0,0,0,0.35
2020,CB2020,061,1,Manhattan,10010011008,0,0,0,0.39
2020,CB2020,061,1,Manhattan,10010011009,1767,849,918,9.03
2020,CB2020,061,1,Manhattan,10010011010,0,0,0,0.4
2020,CB2020,061,1,Manhattan,10010011011,0,0,0,0.87
2020,CB2020,061,1,Manhattan,10010011012,0,0,0,0.49
2020,CB2020,061,1,Manhattan,10010011013,0,0,0,0.12
2020,CB2020,061,1,Manhattan,10010011014,0,0,0,4.88
2020,CB2020,061,1,Manhattan,10010011015,0,0,0,0.55
2020,CB2020,061,1,Manhattan,10010020001,0,0,0,0
2020,CB2020,061,1,Manhattan,10010020002,0,0,0,0
2020,CB2020,061,1,Manhattan,10010021000,993,458,535,5.91
2020,CB2020,061,1,Manhattan,10010021001,603,221,382,4.17
2020,CB2020,061,1,Manhattan,10010022000,680,312,368,2.97
2020,CB2020,061,1,Manhattan,10010022001,841,355,486,4.1
2020,CB2020,061,1,Manhattan,10010023000,14,4,10,10.42
2020,CB2020,061,1,Manhattan,10010023001,0,0,0,1.15
2020,CB2020,061,1,Manhattan,10010023002,0,0,0,1.45
2020,CB2020,061,1,Manhattan,10010023003,0,0,0,0.14
2020,CB2020,061,1,Manhattan,10010024000,569,222,347,2.4
2020,CB2020,061,1,Manhattan,10010025000,2600,1109,1491,16.64
2020,CB2020,061,1,Manhattan,10012001000,491,227,264,2.98
2020,CB2020,061,1,Manhattan,10012001001,0,0,0,0.17
2020,CB2020,061,1,Manhattan,10012001002,0,0,0,0.31
2020,CB2020,061,1,Manhattan,10012001003,0,0,0,0.15
2020,CB2020,061,1,Manhattan,10012001004,0,0,0,0.28
2020,CB2020,061,1,Manhattan,10012001005,0,0,0,0.13
2020,CB2020,061,1,Manhattan,10012001006,0,0,0,0.28
2020,CB2020,061,1,Manhattan,10012001007,0,0,0,0.13
2020,CB2020,061,1,Manhattan,10012001008,0,0,0,0.29
2020,CB2020,061,1,Manhattan,10012001009,49,22,27,1.39
2020,CB2020,061,1,Manhattan,10012001010,28,19,9,1.38
2020,CB2020,061,1,Manhattan,10012001011,955,409,546,2.13
2020,CB2020,061,1,Manhattan,10012001012,185,88,97,2.15
2020,CB2020,061,1,Manhattan,10012002000,0,0,0,0.37
2020,CB2020,061,1,Manhattan,10012002001,0,0,0,0.37
2020,CB2020,061,1,Manhattan,10012002002,0,0,0,0.23
2020,CB2020,061,1,Manhattan,10012002003,0,0,0,0.3
2020,CB2020,061,1,Manhattan,10012002004,0,0,0,0.31
2020,CB2020,061,1,Manhattan,10012002005,0,0,0,0.29
2020,CB2020,061,1,Manhattan,10012002006,0,0,0,0.27
2020,CB2020,061,1,Manhattan,10012002007,0,0,0,0.29
2020,CB2020,061,1,Manhattan,10012002008,21,12,9,2.5
2020,CB2020,061,1,Manhattan,10012002009,977,485,492,4.18
2020,CB2020,061,1,Manhattan,10012003000,0,0,0,0.7
2020,CB2020,061,1,Manhattan,10012003001,0,0,0,0.21
2020,CB2020,061,1,Manhattan,10012003002,0,0,0,0.64
2020,CB2020,061,1,Manhattan,10012003003,0,0,0,0.27
2020,CB2020,061,1,Manhattan,10012003004,0,0,0,0.65
2020,CB2020,061,1,Manhattan,10012003005,0,0,0,1.1
2020,CB2020,061,1,Manhattan,10012003006,1070,542,528,5.34
2020,CB2020,061,1,Manhattan,10013001000,449,188,261,1.9
2020,CB2020,061,1,Manhattan,10013001001,169,79,90,1.71
2020,CB2020,061,1,Manhattan,10013001002,1011,436,575,1.68
2020,CB2020,061,1,Manhattan,10013002000,0,0,0,1.52
2020,CB2020,061,1,Manhattan,10013002001,0,0,0,2.79
2020,CB2020,061,1,Manhattan,10013002002,1090,472,618,2.9
2020,CB2020,061,1,Manhattan,10013002003,520,262,258,0.59
2020,CB2020,061,1,Manhattan,10013002004,0,0,0,0.32
2020,CB2020,061,1,Manhattan,10013002005,0,0,0,0.52
2020,CB2020,061,1,Manhattan,10013002006,0,0,0,0.2
2020,CB2020,061,1,Manhattan,10013002007,0,0,0,0.83
2020,CB2020,061,1,Manhattan,10013002008,0,0,0,3.29
2020,CB2020,061,1,Manhattan,10013002009,0,0,0,1.36
2020,CB2020,061,1,Manhattan,10013003000,6,2,4,3.81
2020,CB2020,061,1,Manhattan,10013003001,0,0,0,2.7
2020,CB2020,061,1,Manhattan,10013003002,13,10,3,1.25
2020,CB2020,061,1,Manhattan,10013003003,641,334,307,3.97
2020,CB2020,061,1,Manhattan,10013003004,21,7,14,2.57
2020,CB2020,061,1,Manhattan,10013003005,400,185,215,1.82
2020,CB2020,061,1,Manhattan,10013004000,0,0,0,1.29
2020,CB2020,061,1,Manhattan,10013004001,0,0,0,2.36
2020,CB2020,061,1,Manhattan,10013004002,63,32,31,1.09
2020,CB2020,061,1,Manhattan,10013004003,359,185,174,0.91
2020,CB2020,061,1,Manhattan,10013004004,0,0,0,0.86
2020,CB2020,061,1,Manhattan,10013004005,591,262,329,1.24
2020,CB2020,061,1,Manhattan,10013004006,0,0,0,1.29
2020,CB2020,061,1,Manhattan,10013004007,0,0,0,0.72
2020,CB2020,061,1,Manhattan,10013004008,39,18,21,0.84
2020,CB2020,061,1,Manhattan,10013005000,0,0,0,22.54
2020,CB2020,061,1,Manhattan,10013005001,11,2,9,2.11
2020,CB2020,061,1,Manhattan,10013005002,0,0,0,2.41
2020,CB2020,061,1,Manhattan,10013005003,19,12,7,2.51
2020,CB2020,061,1,Manhattan,10013005004,0,0,0,2.47
2020,CB2020,061,1,Manhattan,10014011000,1852,894,958,14
2020,CB2020,061,1,Manhattan,10014012000,0,0,0,1.75
2020,CB2020,061,1,Manhattan,10014012001,1691,799,892,7.36
2020,CB2020,061,1,Manhattan,10014021000,738,320,418,2.67
2020,CB2020,061,1,Manhattan,10014021001,361,159,202,2.71
2020,CB2020,061,1,Manhattan,10014021002,0,0,0,0.42
2020,CB2020,061,1,Manhattan,10014021003,0,0,0,0.29
2020,CB2020,061,1,Manhattan,10014021004,24,13,11,1.69
2020,CB2020,061,1,Manhattan,10014021005,0,0,0,0.53
2020,CB2020,061,1,Manhattan,10014021006,0,0,0,1.47
2020,CB2020,061,1,Manhattan,10014021007,257,81,176,2.15
2020,CB2020,061,1,Manhattan,10014021008,365,193,172,2.12
2020,CB2020,061,1,Manhattan,10014022000,0,0,0,2.61
2020,CB2020,061,1,Manhattan,10014022001,556,287,269,2.62
2020,CB2020,061,1,Manhattan,10014022002,0,0,0,0.61
2020,CB2020,061,1,Manhattan,10014022003,0,0,0,0.64
2020,CB2020,061,1,Manhattan,10014022004,0,0,0,0.29
2020,CB2020,061,1,Manhattan,10014022005,151,90,61,0.5
2020,CB2020,061,1,Manhattan,10014022006,415,158,257,2.54
2020,CB2020,061,1,Manhattan,10014022007,474,225,249,2.21
2020,CB2020,061,1,Manhattan,10014022008,77,37,40,2.09
2020,CB2020,061,1,Manhattan,10015010001,0,0,0,0
2020,CB2020,061,1,Manhattan,10015010002,0,0,0,0
2020,CB2020,061,1,Manhattan,10015011000,0,0,0,0.3
2020,CB2020,061,1,Manhattan,10015011001,0,0,0,0.81
2020,CB2020,061,1,Manhattan,10015011002,32,13,19,0.91
2020,CB2020,061,1,Manhattan,10015011003,0,0,0,0.28
2020,CB2020,061,1,Manhattan,10015011004,340,105,235,4.13
2020,CB2020,061,1,Manhattan,10015011005,0,0,0,0.53
2020,CB2020,061,1,Manhattan,10015011006,0,0,0,0.44
2020,CB2020,061,1,Manhattan,10015011007,115,61,54,1.12
2020,CB2020,061,1,Manhattan,10015011008,0,0,0,0.48
2020,CB2020,061,1,Manhattan,10015011009,465,211,254,1.68
2020,CB2020,061,1,Manhattan,10015011010,509,250,259,1.07
2020,CB2020,061,1,Manhattan,10015011011,752,247,505,2.64
2020,CB2020,061,1,Manhattan,10015011012,1694,883,811,2.01
2020,CB2020,061,1,Manhattan,10015011013,16,11,5,1.93
2020,CB2020,061,1,Manhattan,10015011014,52,39,13,1.29
2020,CB2020,061,1,Manhattan,10015011015,0,0,0,1.13
2020,CB2020,061,1,Manhattan,10015011016,361,188,173,1.62
2020,CB2020,061,1,Manhattan,10015011017,38,17,21,1.89
2020,CB2020,061,1,Manhattan,10015012000,0,0,0,1.9
2020,CB2020,061,1,Manhattan,10015012001,0,0,0,0.29
2020,CB2020,061,1,Manhattan,10015012002,2733,1206,1527,12.6
2020,CB2020,061,1,Manhattan,10015013000,0,0,0,0.84
2020,CB2020,061,1,Manhattan,10015013001,0,0,0,1.05
2020,CB2020,061,1,Manhattan,10015013002,0,0,0,0.76
2020,CB2020,061,1,Manhattan,10015013003,220,133,87,2.43
2020,CB2020,061,1,Manhattan,10015013004,0,0,0,0.14
2020,CB2020,061,1,Manhattan,10015013005,0,0,0,1.92
2020,CB2020,061,1,Manhattan,10015013006,0,0,0,0.89
2020,CB2020,061,1,Manhattan,10015013007,175,98,77,1.81
2020,CB2020,061,1,Manhattan,10015013008,226,108,118,1.47
2020,CB2020,061,1,Manhattan,10015013009,53,15,38,1.4
2020,CB2020,061,1,Manhattan,10015013010,0,0,0,4.04
2020,CB2020,061,1,Manhattan,10015013011,0,0,0,2.33
2020,CB2020,061,1,Manhattan,10015013012,196,112,84,2.05
2020,CB2020,061,1,Manhattan,10015013013,0,0,0,1.15
2020,CB2020,061,1,Manhattan,10015013014,68,23,45,3.47
2020,CB2020,061,1,Manhattan,10015013015,0,0,0,0.5
2020,CB2020,061,1,Manhattan,10015013016,340,112,228,1.62
2020,CB2020,061,1,Manhattan,10015020001,0,0,0,0
2020,CB2020,061,1,Manhattan,10015021000,208,92,116,2.75
2020,CB2020,061,1,Manhattan,10015021001,1038,410,628,1.95
2020,CB2020,061,1,Manhattan,10015021002,50,22,28,1.42
2020,CB2020,061,1,Manhattan,10015021003,60,27,33,0.43
2020,CB2020,061,1,Manhattan,10015021004,258,124,134,0.52
2020,CB2020,061,1,Manhattan,10015022000,904,448,456,1.76
2020,CB2020,061,1,Manhattan,10015022001,0,0,0,2.74
2020,CB2020,061,1,Manhattan,10015022002,949,447,502,1.74
2020,CB2020,061,1,Manhattan,10015022003,603,289,314,2.69
2020,CB2020,061,1,Manhattan,10015022004,303,153,150,1.02
2020,CB2020,061,1,Manhattan,10015022005,238,100,138,1.57
2020,CB2020,061,1,Manhattan,10015022006,0,0,0,0.39
2020,CB2020,061,1,Manhattan,10015022007,20,11,9,1.63
2020,CB2020,061,1,Manhattan,10015023000,88,29,59,0.4
2020,CB2020,061,1,Manhattan,10015023001,1251,595,656,1.93
2020,CB2020,061,1,Manhattan,10015023002,52,22,30,2.03
2020,CB2020,061,1,Manhattan,10015023003,700,334,366,1.4
2020,CB2020,061,1,Manhattan,10015024000,807,401,406,1.75
2020,CB2020,061,1,Manhattan,10015024001,1575,775,800,1.84
2020,CB2020,061,1,Manhattan,10015024002,0,0,0,0.89
2020,CB2020,061,1,Manhattan,10015024003,96,52,44,0.53
2020,CB2020,061,1,Manhattan,10015024004,0,0,0,1.12
2020,CB2020,061,1,Manhattan,10015024005,76,34,42,1.48
2020,CB2020,061,1,Manhattan,10015024006,0,0,0,0.77
2020,CB2020,061,1,Manhattan,10015025000,1073,441,632,1.57
2020,CB2020,061,1,Manhattan,10015026000,0,0,0,1.46
2020,CB2020,061,1,Manhattan,10015026001,29,13,16,1.94
2020,CB2020,061,1,Manhattan,10015027000,0,0,0,0.51
2020,CB2020,061,1,Manhattan,10015027001,0,0,0,0.41
2020,CB2020,061,1,Manhattan,10015027002,0,0,0,3.18
2020,CB2020,061,1,Manhattan,10015028000,0,0,0,7.76
2020,CB2020,061,1,Manhattan,10016001000,0,0,0,4.41
2020,CB2020,061,1,Manhattan,10016001001,503,244,259,3.15
2020,CB2020,061,1,Manhattan,10016001002,352,243,109,3.13
2020,CB2020,061,1,Manhattan,10016001003,0,0,0,2.25
2020,CB2020,061,1,Manhattan,10016001004,1608,673,935,7.94
2020,CB2020,061,1,Manhattan,10016002000,302,135,167,2.53
2020,CB2020,061,1,Manhattan,10016002001,607,305,302,2.77
2020,CB2020,061,1,Manhattan,10016003000,634,318,316,2.42
2020,CB2020,061,1,Manhattan,10016003001,25,7,18,2.64
2020,CB2020,061,1,Manhattan,10016003002,415,203,212,2.11
2020,CB2020,061,1,Manhattan,10016003003,437,225,212,1.93
2020,CB2020,061,1,Manhattan,10016004000,691,354,337,2.52
2020,CB2020,061,1,Manhattan,10016004001,439,227,212,2.37
2020,CB2020,061,1,Manhattan,10016004002,228,96,132,1.51
2020,CB2020,061,1,Manhattan,10016004003,17,4,13,0.73
2020,CB2020,061,1,Manhattan,10016005000,468,223,245,2.45
2020,CB2020,061,1,Manhattan,10016005001,563,254,309,2.27
2020,CB2020,061,1,Manhattan,10016005002,295,150,145,1.47
2020,CB2020,061,1,Manhattan,10016005003,0,0,0,0.66
2020,CB2020,061,1,Manhattan,10016005004,0,0,0,0.5
2020,CB2020,061,1,Manhattan,10016005005,21,6,15,0.7
2020,CB2020,061,1,Manhattan,10016005006,93,48,45,0.76
2020,CB2020,061,1,Manhattan,10018001000,425,184,241,2.03
2020,CB2020,061,1,Manhattan,10018001001,0,0,0,2.01
2020,CB2020,061,1,Manhattan,10018001002,502,231,271,1.87
2020,CB2020,061,1,Manhattan,10018001003,201,84,117,1.18
2020,CB2020,061,1,Manhattan,10018001004,0,0,0,0.62
2020,CB2020,061,1,Manhattan,10018002000,0,0,0,0.33
2020,CB2020,061,1,Manhattan,10018002001,0,0,0,0.34
2020,CB2020,061,1,Manhattan,10018002002,0,0,0,0.33
2020,CB2020,061,1,Manhattan,10018002003,137,72,65,1.25
2020,CB2020,061,1,Manhattan,10018002004,0,0,0,0.65
2020,CB2020,061,1,Manhattan,10018002005,342,160,182,1.76
2020,CB2020,061,1,Manhattan,10018002006,152,65,87,1.76
2020,CB2020,061,1,Manhattan,10018002007,397,206,191,1.66
2020,CB2020,061,1,Manhattan,10018003000,270,141,129,2.62
2020,CB2020,061,1,Manhattan,10018003001,272,161,111,2.63
2020,CB2020,061,1,Manhattan,10018003002,849,368,481,2.46
2020,CB2020,061,1,Manhattan,10018003003,293,113,180,1.6
2020,CB2020,061,1,Manhattan,10018003004,0,0,0,0.75
2020,CB2020,061,1,Manhattan,10018004000,443,203,240,2.54
2020,CB2020,061,1,Manhattan,10018004001,342,185,157,2.82
2020,CB2020,061,1,Manhattan,10018005000,0,0,0,2.36
2020,CB2020,061,1,Manhattan,10018005001,500,263,237,3.94
2020,CB2020,061,1,Manhattan,10018005002,0,0,0,0.41
2020,CB2020,061,1,Manhattan,10018005003,351,199,152,2.46
2020,CB2020,061,1,Manhattan,10018005004,54,23,31,3.46
2020,CB2020,061,1,Manhattan,10018005005,23,13,10,0.3
2020,CB2020,061,1,Manhattan,10018005006,134,73,61,2.52
2020,CB2020,061,1,Manhattan,10018006000,594,300,294,1.94
2020,CB2020,061,1,Manhattan,10018006001,572,251,321,2.17
2020,CB2020,061,1,Manhattan,10018007000,0,0,0,0.34
2020,CB2020,061,1,Manhattan,10018007001,0,0,0,0.37
2020,CB2020,061,1,Manhattan,10018007002,515,252,263,1.93
2020,CB2020,061,1,Manhattan,10018007003,566,265,301,1.72
2020,CB2020,061,1,Manhattan,10020000001,0,0,0,0
2020,CB2020,061,1,Manhattan,10020001000,2296,992,1304,8.88
2020,CB2020,061,1,Manhattan,10020001001,0,0,0,0.86
2020,CB2020,061,1,Manhattan,10020001002,0,0,0,0.72
2020,CB2020,061,1,Manhattan,10020001003,27,16,11,8.6
2020,CB2020,061,1,Manhattan,10020002000,1496,673,823,5.49
2020,CB2020,061,1,Manhattan,10020003000,560,235,325,2.73
2020,CB2020,061,1,Manhattan,10020003001,0,0,0,2.31
2020,CB2020,061,1,Manhattan,10020003002,269,97,172,1.62
2020,CB2020,061,1,Manhattan,10021001000,116,65,51,0.94
2020,CB2020,061,1,Manhattan,10021001001,46,26,20,1.11
2020,CB2020,061,1,Manhattan,10021001002,246,121,125,2.32
2020,CB2020,061,1,Manhattan,10021001003,502,273,229,2.88
2020,CB2020,061,1,Manhattan,10021001004,387,213,174,2.66
2020,CB2020,061,1,Manhattan,10021001005,520,265,255,2.91
2020,CB2020,061,1,Manhattan,10021001006,283,158,125,2.3
2020,CB2020,061,1,Manhattan,10021002000,1033,492,541,2.21
2020,CB2020,061,1,Manhattan,10021002001,96,52,44,2.7
2020,CB2020,061,1,Manhattan,10021002002,236,120,116,2.67
2020,CB2020,061,1,Manhattan,10021002003,0,0,0,2.19
2020,CB2020,061,1,Manhattan,10021002004,13,8,5,2.8
2020,CB2020,061,1,Manhattan,10021002005,769,396,373,3.01
2020,CB2020,061,1,Manhattan,10021003000,683,344,339,2.66
2020,CB2020,061,1,Manhattan,10021003001,470,219,251,2.83
2020,CB2020,061,1,Manhattan,10021003002,411,213,198,2.38
2020,CB2020,061,1,Manhattan,10021003003,0,0,0,1.81
2020,CB2020,061,1,Manhattan,10021003004,0,0,0,4.49
2020,CB2020,061,1,Manhattan,10021003005,24,7,17,1.43
2020,CB2020,061,1,Manhattan,10021003006,0,0,0,2.2
2020,CB2020,061,1,Manhattan,10021003007,371,188,183,2.27
2020,CB2020,061,1,Manhattan,10021003008,0,0,0,0.3
2020,CB2020,061,1,Manhattan,10021004000,505,245,260,3.24
2020,CB2020,061,1,Manhattan,10021004001,892,427,465,3.08
2020,CB2020,061,1,Manhattan,10021004002,208,119,89,1.24
2020,CB2020,061,1,Manhattan,10022011000,712,376,336,2.89
2020,CB2020,061,1,Manhattan,10022011001,656,299,357,2.79
2020,CB2020,061,1,Manhattan,10022011002,524,311,213,2.76
2020,CB2020,061,1,Manhattan,10022012000,615,362,253,2.77
2020,CB2020,061,1,Manhattan,10022012001,698,367,331,5.18
2020,CB2020,061,1,Manhattan,10022013000,0,0,0,5.22
2020,CB2020,061,1,Manhattan,10022013001,1226,545,681,4.45
2020,CB2020,061,1,Manhattan,10022014000,65,30,35,3.29
2020,CB2020,061,1,Manhattan,10022014001,2473,1098,1375,10.6
2020,CB2020,061,1,Manhattan,10022021000,1218,574,644,4.84
2020,CB2020,061,1,Manhattan,10022021001,938,474,464,4.67
2020,CB2020,061,1,Manhattan,10022021002,332,185,147,3.05
2020,CB2020,061,1,Manhattan,10022021003,0,0,0,1.3
2020,CB2020,061,1,Manhattan,10024000001,0,0,0,0
2020,CB2020,061,1,Manhattan,10024001000,1278,540,738,9.37
2020,CB2020,061,1,Manhattan,10024001001,0,0,0,0.86
2020,CB2020,061,1,Manhattan,10024001002,614,264,350,3.16
2020,CB2020,061,1,Manhattan,10024002000,35,23,12,16.97
2020,CB2020,061,1,Manhattan,10024002001,0,0,0,0.89
2020,CB2020,061,1,Manhattan,10024002002,0,0,0,0.71
2020,CB2020,061,1,Manhattan,10024003000,1409,552,857,7.27
2020,CB2020,061,1,Manhattan,10024003001,1182,502,680,5.83
2020,CB2020,061,1,Manhattan,10025000001,0,0,0,0
2020,CB2020,061,1,Manhattan,10025001000,781,332,449,5.83
2020,CB2020,061,1,Manhattan,10025001001,0,0,0,3.05
2020,CB2020,061,1,Manhattan,10025002000,441,199,242,6.36
2020,CB2020,061,1,Manhattan,10025003000,820,353,467,4.35
2020,CB2020,061,1,Manhattan,10025003001,419,184,235,2.44
2020,CB2020,061,1,Manhattan,10025003002,0,0,0,0.33
2020,CB2020,061,1,Manhattan,10025003003,0,0,0,0.87
2020,CB2020,061,1,Manhattan,10025003004,0,0,0,0.69
2020,CB2020,061,1,Manhattan,10025003005,0,0,0,1.29
2020,CB2020,061,1,Manhattan,10025004000,999,435,564,4.41
2020,CB2020,061,1,Manhattan,10025004001,774,336,438,1.87
2020,CB2020,061,1,Manhattan,10025004002,396,158,238,0.99
2020,CB2020,061,1,Manhattan,10026011000,550,223,327,4.44
2020,CB2020,061,1,Manhattan,10026011001,437,232,205,4.38
2020,CB2020,061,1,Manhattan,10026011002,858,491,367,4.36
2020,CB2020,061,1,Manhattan,10026012000,829,412,417,8.7
2020,CB2020,061,1,Manhattan,10026012001,935,439,496,4.32
2020,CB2020,061,1,Manhattan,10026021000,489,235,254,4.3
2020,CB2020,061,1,Manhattan,10026021001,750,342,408,4.41
2020,CB2020,061,1,Manhattan,10026021002,938,459,479,4.18
2020,CB2020,061,1,Manhattan,10026022000,1117,496,621,4.13
2020,CB2020,061,1,Manhattan,10026023000,872,485,387,4.26
2020,CB2020,061,1,Manhattan,10026023001,650,293,357,4.36
2020,CB2020,061,1,Manhattan,10027001000,12,4,8,0.56
2020,CB2020,061,1,Manhattan,10027001001,102,58,44,1.85
2020,CB2020,061,1,Manhattan,10027001002,0,0,0,1.49
2020,CB2020,061,1,Manhattan,10027001003,362,173,189,2.17
2020,CB2020,061,1,Manhattan,10027001004,45,24,21,0.94
2020,CB2020,061,1,Manhattan,10027001005,779,350,429,5.63
2020,CB2020,061,1,Manhattan,10027001006,70,39,31,0.88
2020,CB2020,061,1,Manhattan,10027001007,0,0,0,1.12
2020,CB2020,061,1,Manhattan,10028001000,891,386,505,4.93
2020,CB2020,061,1,Manhattan,10028002000,1009,451,558,4.65
2020,CB2020,061,1,Manhattan,10028002001,678,343,335,4.55
2020,CB2020,061,1,Manhattan,10028003000,1035,482,553,4.29
2020,CB2020,061,1,Manhattan,10028003001,827,394,433,4.21
2020,CB2020,061,1,Manhattan,10028004000,0,0,0,5.05
2020,CB2020,061,1,Manhattan,10028004001,697,284,413,4.67
2020,CB2020,061,1,Manhattan,10028004002,304,145,159,2.45
2020,CB2020,061,1,Manhattan,10028004003,585,246,339,2.35
2020,CB2020,061,1,Manhattan,10028004004,793,413,380,4.29
2020,CB2020,061,1,Manhattan,10028004005,0,0,0,3.91
2020,CB2020,061,1,Manhattan,10029011000,0,0,0,3.68
2020,CB2020,061,1,Manhattan,10029011001,8,6,2,2.99
2020,CB2020,061,1,Manhattan,10029011002,767,752,15,2.27
2020,CB2020,061,1,Manhattan,10029012000,11,9,2,6.89
2020,CB2020,061,1,Manhattan,10029012001,0,0,0,4.84
2020,CB2020,061,1,Manhattan,10029012002,11,5,6,3.76
2020,CB2020,061,1,Manhattan,10029012003,0,0,0,2.9
2020,CB2020,061,1,Manhattan,10029013000,5,5,0,0.72
2020,CB2020,061,1,Manhattan,10029013001,121,37,84,1.86
2020,CB2020,061,1,Manhattan,10029013002,173,171,2,3.41
2020,CB2020,061,1,Manhattan,10029013003,0,0,0,2.52
2020,CB2020,061,1,Manhattan,10029021000,0,0,0,0.26
2020,CB2020,061,1,Manhattan,10029021001,719,342,377,2.67
2020,CB2020,061,1,Manhattan,10029021002,419,195,224,2.75
2020,CB2020,061,1,Manhattan,10029022000,388,184,204,3.08
2020,CB2020,061,1,Manhattan,10029022001,350,167,183,2.59
2020,CB2020,061,1,Manhattan,10029022002,748,344,404,2.47
2020,CB2020,061,1,Manhattan,10029022003,381,203,178,2.58
2020,CB2020,061,1,Manhattan,10029022004,92,39,53,1.06
2020,CB2020,061,1,Manhattan,10029023000,588,277,311,2.59
2020,CB2020,061,1,Manhattan,10029024000,0,0,0,3.76
2020,CB2020,061,1,Manhattan,10029025000,286,122,164,1.49
2020,CB2020,061,1,Manhattan,10029025001,388,191,197,4.76
2020,CB2020,061,1,Manhattan,10029025002,0,0,0,0.53
2020,CB2020,061,1,Manhattan,10030011000,554,258,296,2.77
2020,CB2020,061,1,Manhattan,10030011001,439,231,208,2.46
2020,CB2020,061,1,Manhattan,10030011002,264,137,127,2.14
2020,CB2020,061,1,Manhattan,10030011003,0,0,0,0.33
2020,CB2020,061,1,Manhattan,10030012000,500,231,269,2.52
2020,CB2020,061,1,Manhattan,10030012001,513,250,263,2.34
2020,CB2020,061,1,Manhattan,10030012002,317,151,166,1.56
2020,CB2020,061,1,Manhattan,10030012003,0,0,0,0.67
2020,CB2020,061,1,Manhattan,10030013000,535,261,274,2.82
2020,CB2020,061,1,Manhattan,10030013001,570,299,271,2.79
2020,CB2020,061,1,Manhattan,10030013002,0,0,0,2.64
2020,CB2020,061,1,Manhattan,10030014000,573,291,282,2.59
2020,CB2020,061,1,Manhattan,10030014001,0,0,0,2.59
2020,CB2020,061,1,Manhattan,10030014002,398,194,204,2.44
2020,CB2020,061,1,Manhattan,10030021000,1021,492,529,4.55
2020,CB2020,061,1,Manhattan,10030021001,613,276,337,2.92
2020,CB2020,061,1,Manhattan,10030021002,263,147,116,1.7
2020,CB2020,061,1,Manhattan,10030022000,491,198,293,4.3
2020,CB2020,061,1,Manhattan,10030022001,542,264,278,4.46
2020,CB2020,061,1,Manhattan,10030022002,0,0,0,1.12
2020,CB2020,061,1,Manhattan,10030022003,105,43,62,0.36
2020,CB2020,061,1,Manhattan,10031001000,12,6,6,1.62
2020,CB2020,061,1,Manhattan,10031001001,37,22,15,1.59
2020,CB2020,061,1,Manhattan,10031001002,12,8,4,1
2020,CB2020,061,1,Manhattan,10031001003,12,1,11,1.56
2020,CB2020,061,1,Manhattan,10031001004,217,145,72,1.71
2020,CB2020,061,1,Manhattan,10031001005,39,21,18,1.35
2020,CB2020,061,1,Manhattan,10031001006,371,198,173,1.2
2020,CB2020,061,1,Manhattan,10031001007,1274,512,762,1.58
2020,CB2020,061,1,Manhattan,10031001008,192,108,84,2.73
2020,CB2020,061,1,Manhattan,10031001009,71,37,34,1.16
2020,CB2020,061,1,Manhattan,10031001010,676,307,369,1.64
2020,CB2020,061,1,Manhattan,10031001011,0,0,0,1.69
2020,CB2020,061,1,Manhattan,10031001012,0,0,0,3.04
2020,CB2020,061,1,Manhattan,10031002000,6,5,1,6.31
2020,CB2020,061,1,Manhattan,10031002001,8,2,6,1.19
2020,CB2020,061,1,Manhattan,10031002002,0,0,0,2.52
2020,CB2020,061,1,Manhattan,10031002003,49,26,23,2.43
2020,CB2020,061,1,Manhattan,10031002004,0,0,0,1.79
2020,CB2020,061,1,Manhattan,10031002005,0,0,0,0.72
2020,CB2020,061,1,Manhattan,10031002006,0,0,0,0.23
2020,CB2020,061,1,Manhattan,10031002007,0,0,0,1.27
2020,CB2020,061,1,Manhattan,10031002008,13,7,6,7.75
2020,CB2020,061,1,Manhattan,10031002009,0,0,0,4.19
2020,CB2020,061,1,Manhattan,10031002010,0,0,0,0.4
2020,CB2020,061,1,Manhattan,10032001000,933,420,513,3.99
2020,CB2020,061,1,Manhattan,10032001001,875,416,459,4.11
2020,CB2020,061,1,Manhattan,10032002000,760,385,375,3.9
2020,CB2020,061,1,Manhattan,10032003000,763,362,401,4.11
2020,CB2020,061,1,Manhattan,10032003001,920,388,532,3.99
2020,CB2020,061,1,Manhattan,10032004000,678,322,356,4.16
2020,CB2020,061,1,Manhattan,10032005000,680,339,341,4.31
2020,CB2020,061,1,Manhattan,10032006000,729,366,363,4.3
2020,CB2020,061,1,Manhattan,10032006001,1147,563,584,4.22
2020,CB2020,061,1,Manhattan,10032007000,0,0,0,4.12
2020,CB2020,061,1,Manhattan,10032007001,21,17,4,8.5
2020,CB2020,061,1,Manhattan,10032007002,866,438,428,4.08
2020,CB2020,061,1,Manhattan,10033001000,44,27,17,2.53
2020,CB2020,061,1,Manhattan,10033001001,0,0,0,1.9
2020,CB2020,061,1,Manhattan,10033001002,0,0,0,0.46
2020,CB2020,061,1,Manhattan,10033001003,65,31,34,1.37
2020,CB2020,061,1,Manhattan,10033001004,0,0,0,1.1
2020,CB2020,061,1,Manhattan,10033001005,0,0,0,0.31
2020,CB2020,061,1,Manhattan,10033001006,139,66,73,2.07
2020,CB2020,061,1,Manhattan,10033001007,53,28,25,2.38
2020,CB2020,061,1,Manhattan,10033001008,222,121,101,1.84
2020,CB2020,061,1,Manhattan,10033001009,26,9,17,0.61
2020,CB2020,061,1,Manhattan,10033001010,0,0,0,2.19
2020,CB2020,061,1,Manhattan,10033001011,208,94,114,2.17
2020,CB2020,061,1,Manhattan,10033001012,208,117,91,2.29
2020,CB2020,061,1,Manhattan,10033002000,0,0,0,1.13
2020,CB2020,061,1,Manhattan,10033002001,0,0,0,5.66
2020,CB2020,061,1,Manhattan,10033002002,0,0,0,1.85
2020,CB2020,061,1,Manhattan,10033002003,252,131,121,2.31
2020,CB2020,061,1,Manhattan,10033002004,80,49,31,2.35
2020,CB2020,061,1,Manhattan,10033002005,0,0,0,1.1
2020,CB2020,061,1,Manhattan,10033002006,0,0,0,0.31
2020,CB2020,061,1,Manhattan,10033002007,105,35,70,1.04
2020,CB2020,061,1,Manhattan,10033002008,83,40,43,0.81
2020,CB2020,061,1,Manhattan,10033002009,0,0,0,0.87
2020,CB2020,061,1,Manhattan,10033002010,378,195,183,2.77
2020,CB2020,061,1,Manhattan,10033002011,112,42,70,1.32
2020,CB2020,061,1,Manhattan,10033002012,75,53,22,1.06
2020,CB2020,061,1,Manhattan,10033002013,338,170,168,2.73
2020,CB2020,061,1,Manhattan,10033002014,194,112,82,2.29
2020,CB2020,061,1,Manhattan,10033002015,10,3,7,0.57
2020,CB2020,061,1,Manhattan,10033002016,292,137,155,2.91
2020,CB2020,061,1,Manhattan,10033002017,0,0,0,2.01
2020,CB2020,061,1,Manhattan,10033002018,152,72,80,1.51
2020,CB2020,061,1,Manhattan,10033002019,80,36,44,1
2020,CB2020,061,1,Manhattan,10033003000,1000,483,517,3.3
2020,CB2020,061,1,Manhattan,10033003001,27,21,6,2.89
2020,CB2020,061,1,Manhattan,10033003002,0,0,0,0.86
2020,CB2020,061,1,Manhattan,10033003003,127,57,70,2.98
2020,CB2020,061,1,Manhattan,10033003004,616,311,305,1.98
2020,CB2020,061,1,Manhattan,10033004000,131,67,64,2.25
2020,CB2020,061,1,Manhattan,10033004001,208,93,115,3.24
2020,CB2020,061,1,Manhattan,10033004002,386,214,172,3.5
2020,CB2020,061,1,Manhattan,10033004003,230,86,144,2.16
2020,CB2020,061,1,Manhattan,10033004004,163,74,89,1.16
2020,CB2020,061,1,Manhattan,10033004005,454,271,183,3.32
2020,CB2020,061,1,Manhattan,10034001000,1042,504,538,5.02
2020,CB2020,061,1,Manhattan,10034001001,875,445,430,4.5
2020,CB2020,061,1,Manhattan,10034002000,744,378,366,4.5
2020,CB2020,061,1,Manhattan,10034002001,832,420,412,4.23
2020,CB2020,061,1,Manhattan,10034003000,283,174,109,4.3
2020,CB2020,061,1,Manhattan,10034003001,854,433,421,4.04
2020,CB2020,061,1,Manhattan,10034003002,722,386,336,3.94
2020,CB2020,061,1,Manhattan,10034004000,593,321,272,4.78
2020,CB2020,061,1,Manhattan,10034004001,1067,545,522,4.29
2020,CB2020,061,1,Manhattan,10036011000,370,163,207,2.62
2020,CB2020,061,1,Manhattan,10036011001,501,235,266,2.45
2020,CB2020,061,1,Manhattan,10036012000,366,167,199,2.92
2020,CB2020,061,1,Manhattan,10036012001,595,291,304,2.7
2020,CB2020,061,1,Manhattan,10036013000,0,0,0,4.73
2020,CB2020,061,1,Manhattan,10036013001,884,449,435,5.08
2020,CB2020,061,1,Manhattan,10036013002,797,613,184,4.17
2020,CB2020,061,1,Manhattan,10036021000,648,311,337,4.65
2020,CB2020,061,1,Manhattan,10036021001,687,335,352,4.73
2020,CB2020,061,1,Manhattan,10036022000,184,84,100,3.61
2020,CB2020,061,1,Manhattan,10036022001,789,418,371,3.17
2020,CB2020,061,1,Manhattan,10036022002,434,218,216,2.61
2020,CB2020,061,1,Manhattan,10036022003,258,148,110,3.23
2020,CB2020,061,1,Manhattan,10037000001,0,0,0,0
2020,CB2020,061,1,Manhattan,10037000002,0,0,0,0
2020,CB2020,061,1,Manhattan,10037000003,0,0,0,0
2020,CB2020,061,1,Manhattan,10037000004,0,0,0,0
2020,CB2020,061,1,Manhattan,10037001000,0,0,0,2.57
2020,CB2020,061,1,Manhattan,10037001001,0,0,0,2.6
2020,CB2020,061,1,Manhattan,10037001002,17,11,6,7.71
2020,CB2020,061,1,Manhattan,10037001003,0,0,0,1.1
2020,CB2020,061,1,Manhattan,10037001004,0,0,0,3.74
2020,CB2020,061,1,Manhattan,10037001005,0,0,0,2.04
2020,CB2020,061,1,Manhattan,10037001006,0,0,0,3.22
2020,CB2020,061,1,Manhattan,10037001007,0,0,0,0.29
2020,CB2020,061,1,Manhattan,10037001008,0,0,0,0.2
2020,CB2020,061,1,Manhattan,10037001009,0,0,0,1.13
2020,CB2020,061,1,Manhattan,10037001010,173,85,88,1.89
2020,CB2020,061,1,Manhattan,10037001011,322,150,172,2.49
2020,CB2020,061,1,Manhattan,10037001012,57,25,32,3.02
2020,CB2020,061,1,Manhattan,10037001013,75,48,27,1.9
2020,CB2020,061,1,Manhattan,10037001014,0,0,0,2.6
2020,CB2020,061,1,Manhattan,10037001015,55,36,19,0.71
2020,CB2020,061,1,Manhattan,10037001016,24,16,8,2.79
2020,CB2020,061,1,Manhattan,10037001017,425,190,235,3.43
2020,CB2020,061,1,Manhattan,10037001018,0,0,0,0.44
2020,CB2020,061,1,Manhattan,10037002000,64,41,23,1.02
2020,CB2020,061,1,Manhattan,10037002001,0,0,0,0.25
2020,CB2020,061,1,Manhattan,10037002002,279,123,156,3.81
2020,CB2020,061,1,Manhattan,10037002003,5,1,4,3.03
2020,CB2020,061,1,Manhattan,10037002004,0,0,0,3.02
2020,CB2020,061,1,Manhattan,10037002005,350,167,183,3.72
2020,CB2020,061,1,Manhattan,10037002006,117,46,71,0.86
2020,CB2020,061,1,Manhattan,10037003000,0,0,0,0.3
2020,CB2020,061,1,Manhattan,10037003001,355,173,182,3.43
2020,CB2020,061,1,Manhattan,10037003002,192,97,95,3.03
2020,CB2020,061,1,Manhattan,10037003003,0,0,0,3.18
2020,CB2020,061,1,Manhattan,10037003004,55,24,31,3.28
2020,CB2020,061,1,Manhattan,10037003005,13,6,7,0.66
2020,CB2020,061,1,Manhattan,10037003006,34,24,10,1.89
2020,CB2020,061,1,Manhattan,10037003007,37,8,29,1.97
2020,CB2020,061,1,Manhattan,10037003008,12,8,4,0.74
2020,CB2020,061,1,Manhattan,10037003009,0,0,0,1.08
2020,CB2020,061,1,Manhattan,10037003010,106,41,65,1.52
2020,CB2020,061,1,Manhattan,10037003011,84,49,35,1.91
2020,CB2020,061,1,Manhattan,10037003012,0,0,0,0.45
2020,CB2020,061,1,Manhattan,10037003013,106,55,51,2.13
2020,CB2020,061,1,Manhattan,10037003014,0,0,0,2.88
2020,CB2020,061,1,Manhattan,10037003015,0,0,0,2.72
2020,CB2020,061,1,Manhattan,10037003016,126,71,55,1.89
2020,CB2020,061,1,Manhattan,10037003017,9,6,3,2.15
2020,CB2020,061,1,Manhattan,10038001000,477,268,209,4
2020,CB2020,061,1,Manhattan,10038001001,740,351,389,4.2
2020,CB2020,061,1,Manhattan,10038001002,18,11,7,0.98
2020,CB2020,061,1,Manhattan,10038001003,390,186,204,2.98
2020,CB2020,061,1,Manhattan,10038002000,819,343,476,4.21
2020,CB2020,061,1,Manhattan,10038003000,752,322,430,4.04
2020,CB2020,061,1,Manhattan,10038003001,580,308,272,3.74
2020,CB2020,061,1,Manhattan,10038004000,1260,612,648,4.39
2020,CB2020,061,1,Manhattan,10038005000,1058,528,530,4.38
2020,CB2020,061,1,Manhattan,10038005001,559,266,293,4.29
2020,CB2020,061,1,Manhattan,10038006000,831,418,413,4.16
2020,CB2020,061,1,Manhattan,10038007000,754,344,410,4.27
2020,CB2020,061,1,Manhattan,10038007001,832,436,396,4.38
2020,CB2020,061,1,Manhattan,10039000001,0,0,0,0
2020,CB2020,061,1,Manhattan,10039000002,0,0,0,0
2020,CB2020,061,1,Manhattan,10039001000,0,0,0,0.69
2020,CB2020,061,1,Manhattan,10039001001,0,0,0,0.6
2020,CB2020,061,1,Manhattan,10039001002,343,194,149,2.07
2020,CB2020,061,1,Manhattan,10039001003,154,80,74,1.28
2020,CB2020,061,1,Manhattan,10039001004,58,34,24,0.49
2020,CB2020,061,1,Manhattan,10039001005,0,0,0,0.54
2020,CB2020,061,1,Manhattan,10039001006,137,59,78,2.06
2020,CB2020,061,1,Manhattan,10039001007,80,38,42,1.24
2020,CB2020,061,1,Manhattan,10039001008,257,128,129,1.56
2020,CB2020,061,1,Manhattan,10039001009,0,0,0,0.62
2020,CB2020,061,1,Manhattan,10039001010,0,0,0,2.5
2020,CB2020,061,1,Manhattan,10039001011,0,0,0,0.32
2020,CB2020,061,1,Manhattan,10039001012,127,52,75,1.65
2020,CB2020,061,1,Manhattan,10039001013,179,84,95,1.59
2020,CB2020,061,1,Manhattan,10039001014,65,31,34,1.23
2020,CB2020,061,1,Manhattan,10039001015,200,91,109,2.37
2020,CB2020,061,1,Manhattan,10039001016,302,157,145,2.39
2020,CB2020,061,1,Manhattan,10039001017,152,52,100,1.24
2020,CB2020,061,1,Manhattan,10039001018,154,75,79,1.23
2020,CB2020,061,1,Manhattan,10039001019,309,193,116,1.71
2020,CB2020,061,1,Manhattan,10039001020,221,111,110,1.13
2020,CB2020,061,1,Manhattan,10039001021,158,82,76,1.27
2020,CB2020,061,1,Manhattan,10039002000,0,0,0,1.15
2020,CB2020,061,1,Manhattan,10039002001,0,0,0,10.3
2020,CB2020,061,1,Manhattan,10039002002,0,0,0,0.78
2020,CB2020,061,1,Manhattan,10039002003,1555,657,898,5.69
2020,CB2020,061,1,Manhattan,10039002004,20,10,10,5.7
2020,CB2020,061,1,Manhattan,10039003000,150,86,64,1.41
2020,CB2020,061,1,Manhattan,10039003001,84,48,36,1.26
2020,CB2020,061,1,Manhattan,10039003002,352,176,176,2.44
2020,CB2020,061,1,Manhattan,10039003003,154,55,99,2.48
2020,CB2020,061,1,Manhattan,10039003004,102,41,61,2.44
2020,CB2020,061,1,Manhattan,10039003005,103,56,47,0.89
2020,CB2020,061,1,Manhattan,10039003006,208,119,89,1.73
2020,CB2020,061,1,Manhattan,10039003007,189,75,114,1.63
2020,CB2020,061,1,Manhattan,10039003008,128,61,67,0.88
2020,CB2020,061,1,Manhattan,10039003009,0,0,0,0.38
2020,CB2020,061,1,Manhattan,10039003010,198,123,75,2.82
2020,CB2020,061,1,Manhattan,10039004000,897,376,521,10.04
2020,CB2020,061,1,Manhattan,10040011000,914,480,434,4.2
2020,CB2020,061,1,Manhattan,10040012000,330,159,171,4.99
2020,CB2020,061,1,Manhattan,10040012001,928,477,451,4.58
2020,CB2020,061,1,Manhattan,10040013000,344,179,165,4.59
2020,CB2020,061,1,Manhattan,10040013001,1227,606,621,4.31
2020,CB2020,061,1,Manhattan,10040021000,1024,534,490,4.34
2020,CB2020,061,1,Manhattan,10040022000,1169,573,596,4.67
2020,CB2020,061,1,Manhattan,10040023000,549,280,269,3.11
2020,CB2020,061,1,Manhattan,10040023001,966,412,554,1.24
2020,CB2020,061,1,Manhattan,10040024000,437,202,235,4.08
2020,CB2020,061,1,Manhattan,10040024001,627,302,325,1.99
2020,CB2020,061,1,Manhattan,10040024002,318,155,163,1.97
2020,CB2020,061,1,Manhattan,10041001000,202,103,99,1.58
2020,CB2020,061,1,Manhattan,10041001001,347,146,201,1.44
2020,CB2020,061,1,Manhattan,10041001002,147,75,72,0.91
2020,CB2020,061,1,Manhattan,10041001003,33,21,12,1.44
2020,CB2020,061,1,Manhattan,10041001004,66,32,34,0.45
2020,CB2020,061,1,Manhattan,10041001005,150,75,75,0.61
2020,CB2020,061,1,Manhattan,10041002000,248,119,129,2.56
2020,CB2020,061,1,Manhattan,10041002001,760,248,512,2.83
2020,CB2020,061,1,Manhattan,10041002002,227,105,122,2.69
2020,CB2020,061,1,Manhattan,10041003000,602,295,307,2.3
2020,CB2020,061,1,Manhattan,10041003001,571,244,327,2.53
2020,CB2020,061,1,Manhattan,10041003002,217,98,119,2.32
2020,CB2020,061,1,Manhattan,10041004000,536,252,284,2.51
2020,CB2020,061,1,Manhattan,10041004001,549,265,284,2.68
2020,CB2020,061,1,Manhattan,10041004002,347,166,181,2.46
2020,CB2020,061,1,Manhattan,10041005000,254,127,127,2
2020,CB2020,061,1,Manhattan,10041005001,94,36,58,1.29
2020,CB2020,061,1,Manhattan,10041005002,132,62,70,1.9
2020,CB2020,061,1,Manhattan,10041005003,376,194,182,2.55
2020,CB2020,061,1,Manhattan,10041005004,315,159,156,2.27
2020,CB2020,061,1,Manhattan,10041005005,76,41,35,1.63
2020,CB2020,061,1,Manhattan,10041006000,116,63,53,1.63
2020,CB2020,061,1,Manhattan,10041006001,309,162,147,1.8
2020,CB2020,061,1,Manhattan,10041006002,122,48,74,0.61
2020,CB2020,061,1,Manhattan,10041006003,428,129,299,0.8
2020,CB2020,061,1,Manhattan,10041006004,185,80,105,0.9
2020,CB2020,061,1,Manhattan,10041006005,114,38,76,0.6
2020,CB2020,061,1,Manhattan,10042001000,365,172,193,2.67
2020,CB2020,061,1,Manhattan,10042001001,529,269,260,2.11
2020,CB2020,061,1,Manhattan,10042001002,0,0,0,1.62
2020,CB2020,061,1,Manhattan,10042001003,2,0,2,1.3
2020,CB2020,061,1,Manhattan,10042001004,25,9,16,1.06
2020,CB2020,061,1,Manhattan,10042002000,873,437,436,3.94
2020,CB2020,061,1,Manhattan,10042002001,390,206,184,2.58
2020,CB2020,061,1,Manhattan,10042002002,743,400,343,0.79
2020,CB2020,061,1,Manhattan,10042003000,171,84,87,1.13
2020,CB2020,061,1,Manhattan,10042003001,1006,454,552,1.96
2020,CB2020,061,1,Manhattan,10042003002,1112,484,628,1.99
2020,CB2020,061,1,Manhattan,10043001000,396,205,191,4.06
2020,CB2020,061,1,Manhattan,10043001001,833,457,376,3.36
2020,CB2020,061,1,Manhattan,10043001002,306,150,156,3.39
2020,CB2020,061,1,Manhattan,10043001003,16,9,7,1.13
2020,CB2020,061,1,Manhattan,10043001004,165,99,66,1.43
2020,CB2020,061,1,Manhattan,10043002000,456,214,242,3.45
2020,CB2020,061,1,Manhattan,10043002001,502,248,254,2.89
2020,CB2020,061,1,Manhattan,10043003000,52,11,41,0.89
2020,CB2020,061,1,Manhattan,10043003001,37,5,32,3.28
2020,CB2020,061,1,Manhattan,10043003002,57,26,31,1.1
2020,CB2020,061,1,Manhattan,10043003003,79,53,26,2.42
2020,CB2020,061,1,Manhattan,10043003004,87,41,46,3.2
2020,CB2020,061,1,Manhattan,10043003005,622,329,293,3.24
2020,CB2020,061,1,Manhattan,10043003006,550,282,268,3.05
2020,CB2020,061,1,Manhattan,10044000001,0,0,0,0
2020,CB2020,061,1,Manhattan,10044001000,1157,512,645,3.13
2020,CB2020,061,1,Manhattan,10044001001,545,236,309,2.83
2020,CB2020,061,1,Manhattan,10044001002,1280,546,734,4.58
2020,CB2020,061,1,Manhattan,10044002000,0,0,0,4.71
2020,CB2020,061,1,Manhattan,10044002001,0,0,0,1.64
2020,CB2020,061,1,Manhattan,10044002002,36,16,20,21.59
2020,CB2020,061,1,Manhattan,10044003000,1636,749,887,9.21
2020,CB2020,061,1,Manhattan,10044004000,1516,682,834,7.43
2020,CB2020,061,1,Manhattan,10044004001,1387,614,773,5.85
2020,CB2020,061,1,Manhattan,10044005000,1173,517,656,4.64
2020,CB2020,061,1,Manhattan,10044005001,577,249,328,2.33
2020,CB2020,061,1,Manhattan,10044006000,0,0,0,0.84
2020,CB2020,061,1,Manhattan,10044006001,0,0,0,0.48
2020,CB2020,061,1,Manhattan,10044006002,0,0,0,0.4
2020,CB2020,061,1,Manhattan,10044006003,0,0,0,0.42
2020,CB2020,061,1,Manhattan,10044006004,1551,693,858,5.52
2020,CB2020,061,1,Manhattan,10044007000,1361,568,793,5.6
2020,CB2020,061,1,Manhattan,10044007001,926,409,517,3.39
2020,CB2020,061,1,Manhattan,10044008000,1978,893,1085,8.16
2020,CB2020,061,1,Manhattan,10044009000,2099,931,1168,8.55
2020,CB2020,061,1,Manhattan,10045001000,0,0,0,0.4
2020,CB2020,061,1,Manhattan,10045001001,275,146,129,3.3
2020,CB2020,061,1,Manhattan,10045001002,123,64,59,3.25
2020,CB2020,061,1,Manhattan,10045001003,105,49,56,2.56
2020,CB2020,061,1,Manhattan,10045001004,315,159,156,2.65
2020,CB2020,061,1,Manhattan,10045001005,18,13,5,1.78
2020,CB2020,061,1,Manhattan,10045001006,14,3,11,0.73
2020,CB2020,061,1,Manhattan,10045001007,80,50,30,2.35
2020,CB2020,061,1,Manhattan,10045001008,58,26,32,1.61
2020,CB2020,061,1,Manhattan,10045001009,33,10,23,2.26
2020,CB2020,061,1,Manhattan,10045001010,22,13,9,3.34
2020,CB2020,061,1,Manhattan,10045001011,50,25,25,1.7
2020,CB2020,061,1,Manhattan,10047001000,70,34,36,1.62
2020,CB2020,061,1,Manhattan,10047001001,499,223,276,2.96
2020,CB2020,061,1,Manhattan,10047001002,250,145,105,2.74
2020,CB2020,061,1,Manhattan,10047001003,125,52,73,3.25
2020,CB2020,061,1,Manhattan,10047002000,127,53,74,1
2020,CB2020,061,1,Manhattan,10047002001,132,44,88,1.48
2020,CB2020,061,1,Manhattan,10047002002,118,45,73,1.85
2020,CB2020,061,1,Manhattan,10047002003,0,0,0,0.26
2020,CB2020,061,1,Manhattan,10047002004,30,14,16,2.43
2020,CB2020,061,1,Manhattan,10047002005,22,14,8,1
2020,CB2020,061,1,Manhattan,10047002006,123,55,68,2.43
2020,CB2020,061,1,Manhattan,10047002007,151,75,76,2.36
2020,CB2020,061,1,Manhattan,10047002008,109,77,32,2.32
2020,CB2020,061,1,Manhattan,10047002009,169,96,73,2.48
2020,CB2020,061,1,Manhattan,10047002010,57,40,17,2.39
2020,CB2020,061,1,Manhattan,10047002011,199,110,89,3.22
2020,CB2020,061,1,Manhattan,10047002012,125,78,47,2.97
2020,CB2020,061,1,Manhattan,10047002013,288,163,125,2.83
2020,CB2020,061,1,Manhattan,10047002014,50,12,38,1.3
2020,CB2020,061,1,Manhattan,10048001000,1264,538,726,3.97
2020,CB2020,061,1,Manhattan,10048002000,984,514,470,3.97
2020,CB2020,061,1,Manhattan,10048003000,279,134,145,2.56
2020,CB2020,061,1,Manhattan,10048003001,444,200,244,2.79
2020,CB2020,061,1,Manhattan,10048004000,1587,708,879,4.66
2020,CB2020,061,1,Manhattan,10048005000,22,13,9,2.9
2020,CB2020,061,1,Manhattan,10048005001,92,49,43,3.13
2020,CB2020,061,1,Manhattan,10048005002,1066,509,557,4.93
2020,CB2020,061,1,Manhattan,10048006000,793,348,445,4.34
2020,CB2020,061,1,Manhattan,10048006001,404,178,226,4.25
2020,CB2020,061,1,Manhattan,10048007000,0,0,0,2.96
2020,CB2020,061,1,Manhattan,10048007001,20,7,13,2.97
2020,CB2020,061,1,Manhattan,10049001000,215,97,118,3.04
2020,CB2020,061,1,Manhattan,10049001001,189,115,74,2.89
2020,CB2020,061,1,Manhattan,10049001002,169,91,78,2.88
2020,CB2020,061,1,Manhattan,10049001003,133,60,73,3.12
2020,CB2020,061,1,Manhattan,10049001004,168,79,89,3.19
2020,CB2020,061,1,Manhattan,10049001005,199,86,113,3.02
2020,CB2020,061,1,Manhattan,10049001006,224,127,97,3.02
2020,CB2020,061,1,Manhattan,10049001007,220,97,123,3.19
2020,CB2020,061,1,Manhattan,10049001008,134,52,82,2.57
2020,CB2020,061,1,Manhattan,10049001009,178,120,58,3.06
2020,CB2020,061,1,Manhattan,10049001010,155,85,70,3.25
2020,CB2020,061,1,Manhattan,10049001011,37,19,18,0.52
2020,CB2020,061,1,Manhattan,10049002000,198,106,92,1.21
2020,CB2020,061,1,Manhattan,10049002001,353,153,200,1.93
2020,CB2020,061,1,Manhattan,10049002002,520,209,311,3.06
2020,CB2020,061,1,Manhattan,10049002003,374,156,218,2.78
2020,CB2020,061,1,Manhattan,10049003000,523,242,281,2.91
2020,CB2020,061,1,Manhattan,10049003001,435,191,244,2.88
2020,CB2020,061,1,Manhattan,10049003002,353,162,191,2.7
2020,CB2020,061,1,Manhattan,10050001000,543,240,303,2.86
2020,CB2020,061,1,Manhattan,10050001001,152,72,80,2.87
2020,CB2020,061,1,Manhattan,10050001002,144,78,66,2.89
2020,CB2020,061,1,Manhattan,10050002000,255,108,147,2.89
2020,CB2020,061,1,Manhattan,10050002001,108,54,54,3.15
2020,CB2020,061,1,Manhattan,10050002002,838,405,433,2.94
2020,CB2020,061,1,Manhattan,10050003000,693,330,363,3.1
2020,CB2020,061,1,Manhattan,10050003001,15,4,11,3.34
2020,CB2020,061,1,Manhattan,10050004000,768,337,431,2.84
2020,CB2020,061,1,Manhattan,10050004001,471,180,291,2.85
2020,CB2020,061,1,Manhattan,10050005000,153,75,78,0.75
2020,CB2020,061,1,Manhattan,10050005001,11,2,9,2.57
2020,CB2020,061,1,Manhattan,10050005002,113,70,43,1.57
2020,CB2020,061,1,Manhattan,10050005003,95,42,53,0.83
2020,CB2020,061,1,Manhattan,10050005004,474,196,278,2.85
2020,CB2020,061,1,Manhattan,10050005005,390,184,206,2.84
2020,CB2020,061,1,Manhattan,10052001000,536,299,237,3.83
2020,CB2020,061,1,Manhattan,10052001001,193,93,100,3.41
2020,CB2020,061,1,Manhattan,10052001002,166,98,68,2.95
2020,CB2020,061,1,Manhattan,10052001003,74,19,55,2.53
2020,CB2020,061,1,Manhattan,10052001004,26,18,8,7.18
2020,CB2020,061,1,Manhattan,10052001005,0,0,0,0.75
2020,CB2020,061,1,Manhattan,10052002000,63,28,35,1.66
2020,CB2020,061,1,Manhattan,10052002001,154,86,68,2.53
2020,CB2020,061,1,Manhattan,10052002002,38,22,16,2.74
2020,CB2020,061,1,Manhattan,10052002003,305,188,117,3.14
2020,CB2020,061,1,Manhattan,10052002004,287,134,153,3.39
2020,CB2020,061,1,Manhattan,10052002005,939,326,613,3.69
2020,CB2020,061,1,Manhattan,10052002006,1027,468,559,3.93
2020,CB2020,061,1,Manhattan,10054001000,159,88,71,3.12
2020,CB2020,061,1,Manhattan,10054001001,111,54,57,2.6
2020,CB2020,061,1,Manhattan,10054001002,407,218,189,5.73
2020,CB2020,061,1,Manhattan,10054001003,174,101,73,5.68
2020,CB2020,061,1,Manhattan,10054001004,479,214,265,5.73
2020,CB2020,061,1,Manhattan,10054001005,612,322,290,5.72
2020,CB2020,061,1,Manhattan,10054002000,1252,611,641,6.24
2020,CB2020,061,1,Manhattan,10054003000,1715,781,934,6.68
2020,CB2020,061,1,Manhattan,10055011000,0,0,0,1.61
2020,CB2020,061,1,Manhattan,10055011001,22,13,9,3.12
2020,CB2020,061,1,Manhattan,10055011002,387,179,208,1.62
2020,CB2020,061,1,Manhattan,10055011003,553,238,315,1.54
2020,CB2020,061,1,Manhattan,10055011004,491,244,247,1.88
2020,CB2020,061,1,Manhattan,10055011005,146,77,69,1.05
2020,CB2020,061,1,Manhattan,10055011006,83,38,45,0.88
2020,CB2020,061,1,Manhattan,10055011007,0,0,0,1.04
2020,CB2020,061,1,Manhattan,10055012000,891,433,458,6.35
2020,CB2020,061,1,Manhattan,10055012001,980,469,511,3.08
2020,CB2020,061,1,Manhattan,10055013000,1011,516,495,8.58
2020,CB2020,061,1,Manhattan,10055021000,73,29,44,1.47
2020,CB2020,061,1,Manhattan,10055021001,67,46,21,1.8
2020,CB2020,061,1,Manhattan,10055021002,235,129,106,4
2020,CB2020,061,1,Manhattan,10055021003,233,140,93,3.69
2020,CB2020,061,1,Manhattan,10055022000,160,86,74,2.11
2020,CB2020,061,1,Manhattan,10055022001,78,47,31,1.19
2020,CB2020,061,1,Manhattan,10055022002,44,13,31,1.11
2020,CB2020,061,1,Manhattan,10055022003,94,37,57,1.9
2020,CB2020,061,1,Manhattan,10055022004,72,35,37,0.73
2020,CB2020,061,1,Manhattan,10055022005,42,8,34,2.61
2020,CB2020,061,1,Manhattan,10055022006,38,23,15,1.24
2020,CB2020,061,1,Manhattan,10055022007,22,9,13,0.75
2020,CB2020,061,1,Manhattan,10055022008,175,90,85,1.77
2020,CB2020,061,1,Manhattan,10055022009,450,216,234,1.87
2020,CB2020,061,1,Manhattan,10055022010,173,93,80,2.31
2020,CB2020,061,1,Manhattan,10056001000,452,241,211,3.03
2020,CB2020,061,1,Manhattan,10056001001,1114,590,524,2.99
2020,CB2020,061,1,Manhattan,10056001002,386,170,216,2.99
2020,CB2020,061,1,Manhattan,10056001003,0,0,0,3.03
2020,CB2020,061,1,Manhattan,10056001004,136,74,62,3.06
2020,CB2020,061,1,Manhattan,10056001005,0,0,0,3.06
2020,CB2020,061,1,Manhattan,10056001006,21,16,5,3.24
2020,CB2020,061,1,Manhattan,10056002000,79,37,42,8.48
2020,CB2020,061,1,Manhattan,10056002001,0,0,0,0.66
2020,CB2020,061,1,Manhattan,10056002002,0,0,0,1.15
2020,CB2020,061,1,Manhattan,10056002003,1095,525,570,5.36
2020,CB2020,061,1,Manhattan,10056003000,925,441,484,4.52
2020,CB2020,061,1,Manhattan,10056003001,73,40,33,1.51
2020,CB2020,061,1,Manhattan,10057001000,611,270,341,2.22
2020,CB2020,061,1,Manhattan,10057001001,6,4,2,2.34
2020,CB2020,061,1,Manhattan,10057001002,0,0,0,0.42
2020,CB2020,061,1,Manhattan,10057001003,0,0,0,0.26
2020,CB2020,061,1,Manhattan,10057001004,301,157,144,1.48
2020,CB2020,061,1,Manhattan,10057002000,1381,675,706,2.61
2020,CB2020,061,1,Manhattan,10057002001,0,0,0,1.51
2020,CB2020,061,1,Manhattan,10057002002,22,11,11,1.58
2020,CB2020,061,1,Manhattan,10057002003,160,73,87,2.78
2020,CB2020,061,1,Manhattan,10057002004,71,47,24,1.39
2020,CB2020,061,1,Manhattan,10057002005,71,29,42,2.57
2020,CB2020,061,1,Manhattan,10057002006,98,56,42,2.05
2020,CB2020,061,1,Manhattan,10057002007,62,14,48,1.93
2020,CB2020,061,1,Manhattan,10057002008,215,122,93,3.57
2020,CB2020,061,1,Manhattan,10058001000,85,49,36,2.39
2020,CB2020,061,1,Manhattan,10058001001,449,242,207,3.65
2020,CB2020,061,1,Manhattan,10058001002,1108,553,555,2.87
2020,CB2020,061,1,Manhattan,10058001003,0,0,0,1.8
2020,CB2020,061,1,Manhattan,10058001004,35,18,17,1.33
2020,CB2020,061,1,Manhattan,10058002000,135,64,71,1.27
2020,CB2020,061,1,Manhattan,10058002001,739,344,395,4.85
2020,CB2020,061,1,Manhattan,10058002002,863,447,416,5.39
2020,CB2020,061,1,Manhattan,10058002003,0,0,0,0.72
2020,CB2020,061,1,Manhattan,10058003000,101,58,43,6.36
2020,CB2020,061,1,Manhattan,10058003001,787,392,395,6.53
2020,CB2020,061,1,Manhattan,10058003002,807,399,408,6.01
2020,CB2020,061,1,Manhattan,10059001000,457,205,252,2.94
2020,CB2020,061,1,Manhattan,10059001001,835,385,450,2.86
2020,CB2020,061,1,Manhattan,10059002000,343,157,186,1.87
2020,CB2020,061,1,Manhattan,10059002001,117,64,53,2.2
2020,CB2020,061,1,Manhattan,10059003000,583,290,293,2.35
2020,CB2020,061,1,Manhattan,10059003001,942,384,558,2.17
2020,CB2020,061,1,Manhattan,10059003002,19,6,13,1.41
2020,CB2020,061,1,Manhattan,10059003003,120,63,57,1.43
2020,CB2020,061,1,Manhattan,10059003004,189,99,90,1.48
2020,CB2020,061,1,Manhattan,10059003005,261,87,174,1.49
2020,CB2020,061,1,Manhattan,10059004000,798,378,420,4.3
2020,CB2020,061,1,Manhattan,10059005000,1043,491,552,4.21
2020,CB2020,061,1,Manhattan,10060000001,0,0,0,0
2020,CB2020,061,1,Manhattan,10060001000,0,0,0,2.65
2020,CB2020,061,1,Manhattan,10060001001,0,0,0,0.94
2020,CB2020,061,1,Manhattan,10060001002,0,0,0,0.55
2020,CB2020,061,1,Manhattan,10060001003,1736,824,912,8.27
2020,CB2020,061,1,Manhattan,10060002000,2030,938,1092,9.31
2020,CB2020,061,1,Manhattan,10060003000,1511,684,827,6.84
2020,CB2020,061,1,Manhattan,10060003001,0,0,0,0.41
2020,CB2020,061,1,Manhattan,10060003002,13,6,7,0.42
2020,CB2020,061,1,Manhattan,10061001000,321,175,146,3.95
2020,CB2020,061,1,Manhattan,10061001001,326,150,176,3.52
2020,CB2020,061,1,Manhattan,10061001002,572,274,298,3.42
2020,CB2020,061,1,Manhattan,10061001003,912,371,541,0.81
2020,CB2020,061,1,Manhattan,10061001004,246,109,137,2.27
2020,CB2020,061,1,Manhattan,10061002000,391,192,199,3.62
2020,CB2020,061,1,Manhattan,10061002001,1224,546,678,3.98
2020,CB2020,061,1,Manhattan,10061003000,284,152,132,2.09
2020,CB2020,061,1,Manhattan,10061003001,75,40,35,2.44
2020,CB2020,061,1,Manhattan,10061003002,463,225,238,2.9
2020,CB2020,061,1,Manhattan,10061003003,252,98,154,2.1
2020,CB2020,061,1,Manhattan,10061003004,428,222,206,4.03
2020,CB2020,061,1,Manhattan,10062000001,0,0,0,0
2020,CB2020,061,1,Manhattan,10062001000,695,469,226,12.57
2020,CB2020,061,1,Manhattan,10062001001,39,26,13,8.42
2020,CB2020,061,1,Manhattan,10062001002,159,145,14,11.08
2020,CB2020,061,1,Manhattan,10062001003,42,16,26,5.29
2020,CB2020,061,1,Manhattan,10062001004,18,13,5,9.05
2020,CB2020,061,1,Manhattan,10062001005,0,0,0,3.16
2020,CB2020,061,1,Manhattan,10062002000,2733,1217,1516,14.37
2020,CB2020,061,1,Manhattan,10062002001,0,0,0,1.88
2020,CB2020,061,1,Manhattan,10062002002,0,0,0,0.27
2020,CB2020,061,1,Manhattan,10062002003,0,0,0,3.04
2020,CB2020,061,1,Manhattan,10062002004,0,0,0,2.09
2020,CB2020,061,1,Manhattan,10062002005,0,0,0,0.47
2020,CB2020,061,1,Manhattan,10062003000,0,0,0,0.86
2020,CB2020,061,1,Manhattan,10063001000,1053,437,616,6.75
2020,CB2020,061,1,Manhattan,10063001001,1160,574,586,6.23
2020,CB2020,061,1,Manhattan,10063002000,621,320,301,6.25
2020,CB2020,061,1,Manhattan,10063002001,761,361,400,5.88
2020,CB2020,061,1,Manhattan,10063003000,924,451,473,3.02
2020,CB2020,061,1,Manhattan,10063003001,475,217,258,2.71
2020,CB2020,061,1,Manhattan,10063004000,871,434,437,5.73
2020,CB2020,061,1,Manhattan,10063005000,591,266,325,4.09
2020,CB2020,061,1,Manhattan,10063005001,251,142,109,3.38
2020,CB2020,061,1,Manhattan,10064001000,1328,554,774,4.52
2020,CB2020,061,1,Manhattan,10064001001,818,401,417,4.52
2020,CB2020,061,1,Manhattan,10064002000,1189,499,690,4.2
2020,CB2020,061,1,Manhattan,10064002001,393,157,236,2.33
2020,CB2020,061,1,Manhattan,10064002002,143,65,78,1.63
2020,CB2020,061,1,Manhattan,10064003000,897,383,514,3.99
2020,CB2020,061,1,Manhattan,10064004000,942,435,507,4.67
2020,CB2020,061,1,Manhattan,10064004001,101,51,50,4.38
2020,CB2020,061,1,Manhattan,10064004002,384,175,209,4.23
2020,CB2020,061,1,Manhattan,10064005000,1391,640,751,4.74
2020,CB2020,061,1,Manhattan,10064006000,1158,513,645,5.08
2020,CB2020,061,1,Manhattan,10065001000,399,202,197,2.75
2020,CB2020,061,1,Manhattan,10065001001,20,12,8,11.67
2020,CB2020,061,1,Manhattan,10065001002,59,26,33,1.54
2020,CB2020,061,1,Manhattan,10065001003,967,409,558,1.97
2020,CB2020,061,1,Manhattan,10065001004,97,53,44,0.67
2020,CB2020,061,1,Manhattan,10065001005,254,123,131,2.34
2020,CB2020,061,1,Manhattan,10065001006,14,10,4,0.31
2020,CB2020,061,1,Manhattan,10065001007,14,9,5,1.53
2020,CB2020,061,1,Manhattan,10065001008,23,9,14,1.47
2020,CB2020,061,1,Manhattan,10065002000,124,72,52,1.8
2020,CB2020,061,1,Manhattan,10065002001,371,206,165,0.55
2020,CB2020,061,1,Manhattan,10065002002,681,380,301,2.59
2020,CB2020,061,1,Manhattan,10065003000,108,60,48,0.48
2020,CB2020,061,1,Manhattan,10065003001,119,52,67,0.72
2020,CB2020,061,1,Manhattan,10065003002,385,197,188,1.8
2020,CB2020,061,1,Manhattan,10065003003,219,93,126,2.49
2020,CB2020,061,1,Manhattan,10065003004,141,60,81,0.6
2020,CB2020,061,1,Manhattan,10065003005,216,109,107,2.82
2020,CB2020,061,1,Manhattan,10065004000,771,341,430,2.82
2020,CB2020,061,1,Manhattan,10065004001,487,216,271,2.68
2020,CB2020,061,1,Manhattan,10065005000,592,292,300,3.15
2020,CB2020,061,1,Manhattan,10065005001,660,317,343,2.97
2020,CB2020,061,1,Manhattan,10066001000,1330,579,751,4.19
2020,CB2020,061,1,Manhattan,10066002000,1234,541,693,4.26
2020,CB2020,061,1,Manhattan,10066003000,1297,548,749,3.04
2020,CB2020,061,1,Manhattan,10066003001,244,114,130,1.13
2020,CB2020,061,1,Manhattan,10066004000,1238,522,716,4.2
2020,CB2020,061,1,Manhattan,10066005000,1341,687,654,4.21
2020,CB2020,061,1,Manhattan,10066006000,1211,544,667,4.43
2020,CB2020,061,1,Manhattan,10066007000,1602,715,887,4.44
2020,CB2020,061,1,Manhattan,10066008000,548,249,299,1.9
2020,CB2020,061,1,Manhattan,10066008001,635,297,338,2.44
2020,CB2020,061,1,Manhattan,10066008002,328,161,167,2.48
2020,CB2020,061,1,Manhattan,10066008003,0,0,0,1.96
2020,CB2020,061,1,Manhattan,10066009000,1333,554,779,4.5
2020,CB2020,061,1,Manhattan,10067001000,495,224,271,2.47
2020,CB2020,061,1,Manhattan,10067001001,670,333,337,2.88
2020,CB2020,061,1,Manhattan,10067001002,414,216,198,3.24
2020,CB2020,061,1,Manhattan,10067002000,0,0,0,0.58
2020,CB2020,061,1,Manhattan,10067002001,336,152,184,2.15
2020,CB2020,061,1,Manhattan,10067002002,316,118,198,2.03
2020,CB2020,061,1,Manhattan,10067002003,614,293,321,2.73
2020,CB2020,061,1,Manhattan,10067002004,365,162,203,2.49
2020,CB2020,061,1,Manhattan,10067003000,164,64,100,1.15
2020,CB2020,061,1,Manhattan,10067003001,270,142,128,2.26
2020,CB2020,061,1,Manhattan,10067003002,152,76,76,1.38
2020,CB2020,061,1,Manhattan,10067003003,358,147,211,2.41
2020,CB2020,061,1,Manhattan,10067004000,171,79,92,1.17
2020,CB2020,061,1,Manhattan,10067004001,80,51,29,0.47
2020,CB2020,061,1,Manhattan,10067004002,536,244,292,3.01
2020,CB2020,061,1,Manhattan,10067004003,106,55,51,1.14
2020,CB2020,061,1,Manhattan,10067004004,449,228,221,3.61
2020,CB2020,061,1,Manhattan,10067004005,51,16,35,3.45
2020,CB2020,061,1,Manhattan,10067004006,0,0,0,3.02
2020,CB2020,061,1,Manhattan,10068001000,179,69,110,3.03
2020,CB2020,061,1,Manhattan,10068001001,376,192,184,3.03
2020,CB2020,061,1,Manhattan,10068001002,13,12,1,3.03
2020,CB2020,061,1,Manhattan,10068001003,569,304,265,3.03
2020,CB2020,061,1,Manhattan,10068002000,467,222,245,3.27
2020,CB2020,061,1,Manhattan,10068002001,379,159,220,3.26
2020,CB2020,061,1,Manhattan,10068003000,922,408,514,2.99
2020,CB2020,061,1,Manhattan,10068003001,564,257,307,3.04
2020,CB2020,061,1,Manhattan,10068004000,1736,782,954,3.23
2020,CB2020,061,1,Manhattan,10068004001,350,162,188,1.75
2020,CB2020,061,1,Manhattan,10068004002,0,0,0,1.48
2020,CB2020,061,1,Manhattan,10068005000,264,120,144,0.9
2020,CB2020,061,1,Manhattan,10068005001,0,0,0,1.27
2020,CB2020,061,1,Manhattan,10068005002,158,87,71,0.83
2020,CB2020,061,1,Manhattan,10068005003,16,6,10,2.13
2020,CB2020,061,1,Manhattan,10068005004,258,120,138,0.86
2020,CB2020,061,1,Manhattan,10068006000,808,361,447,3
2020,CB2020,061,1,Manhattan,10068006001,455,203,252,2.17
2020,CB2020,061,1,Manhattan,10068006002,192,90,102,0.83
2020,CB2020,061,1,Manhattan,10069000001,0,0,0,0
2020,CB2020,061,1,Manhattan,10069000002,0,0,0,0
2020,CB2020,061,1,Manhattan,10069001000,95,44,51,3.25
2020,CB2020,061,1,Manhattan,10069001001,726,358,368,2.19
2020,CB2020,061,1,Manhattan,10069001002,379,124,255,1.61
2020,CB2020,061,1,Manhattan,10069001003,111,63,48,2.09
2020,CB2020,061,1,Manhattan,10069001004,23,18,5,2.22
2020,CB2020,061,1,Manhattan,10069001005,86,51,35,1.52
2020,CB2020,061,1,Manhattan,10069002000,273,157,116,2.06
2020,CB2020,061,1,Manhattan,10069002001,325,176,149,2.45
2020,CB2020,061,1,Manhattan,10069002002,431,209,222,2.34
2020,CB2020,061,1,Manhattan,10069002003,99,53,46,2.25
2020,CB2020,061,1,Manhattan,10069002004,0,0,0,1.44
2020,CB2020,061,1,Manhattan,10069002005,251,144,107,2.38
2020,CB2020,061,1,Manhattan,10069003000,0,0,0,2.49
2020,CB2020,061,1,Manhattan,10069003001,0,0,0,1.33
2020,CB2020,061,1,Manhattan,10069003002,0,0,0,2.09
2020,CB2020,061,1,Manhattan,10069004000,0,0,0,1.27
2020,CB2020,061,1,Manhattan,10069004001,0,0,0,20.64
2020,CB2020,061,1,Manhattan,10069004002,0,0,0,0.36
2020,CB2020,061,1,Manhattan,10069004003,0,0,0,0.5
2020,CB2020,061,1,Manhattan,10070011000,833,323,510,4.49
2020,CB2020,061,1,Manhattan,10070012000,1792,865,927,4.87
2020,CB2020,061,1,Manhattan,10070013000,1053,473,580,7.51
2020,CB2020,061,1,Manhattan,10070014000,872,399,473,5.3
2020,CB2020,061,1,Manhattan,10070021000,1318,665,653,4.59
2020,CB2020,061,1,Manhattan,10070022000,986,433,553,4.27
2020,CB2020,061,1,Manhattan,10070023000,767,360,407,4.31
2020,CB2020,061,1,Manhattan,10070023001,668,329,339,4.25
2020,CB2020,061,1,Manhattan,10070024000,1126,495,631,4.23
2020,CB2020,061,1,Manhattan,10071001000,961,527,434,5.93
2020,CB2020,061,1,Manhattan,10071002000,1232,598,634,5.47
2020,CB2020,061,1,Manhattan,10071003000,603,304,299,5.55
2020,CB2020,061,1,Manhattan,10071003001,380,184,196,5.37
2020,CB2020,061,1,Manhattan,10071003002,0,0,0,1.35
2020,CB2020,061,1,Manhattan,10071003003,0,0,0,0.25
2020,CB2020,061,1,Manhattan,10071004000,34,23,11,0.67
2020,CB2020,061,1,Manhattan,10071004001,66,46,20,0.85
2020,CB2020,061,1,Manhattan,10071004002,293,158,135,1.75
2020,CB2020,061,1,Manhattan,10071004003,571,286,285,2.06
2020,CB2020,061,1,Manhattan,10071004004,485,237,248,2.28
2020,CB2020,061,1,Manhattan,10071005000,99,67,32,1.78
2020,CB2020,061,1,Manhattan,10071005001,196,102,94,0.95
2020,CB2020,061,1,Manhattan,10071005002,654,305,349,3.8
2020,CB2020,061,1,Manhattan,10071005003,15,7,8,0.25
2020,CB2020,061,1,Manhattan,10071005004,0,0,0,0.44
2020,CB2020,061,1,Manhattan,10071005005,262,116,146,2
2020,CB2020,061,1,Manhattan,10072001000,1076,452,624,3.22
2020,CB2020,061,1,Manhattan,10072002000,701,299,402,3.43
2020,CB2020,061,1,Manhattan,10072002001,39,22,17,3.04
2020,CB2020,061,1,Manhattan,10072002002,467,257,210,3.02
2020,CB2020,061,1,Manhattan,10072003000,538,275,263,3.03
2020,CB2020,061,1,Manhattan,10072003001,568,217,351,3.02
2020,CB2020,061,1,Manhattan,10072003002,319,162,157,3.03
2020,CB2020,061,1,Manhattan,10072004000,614,358,256,3
2020,CB2020,061,1,Manhattan,10072004001,991,422,569,3
2020,CB2020,061,1,Manhattan,10072004002,445,198,247,3
2020,CB2020,061,1,Manhattan,10072005000,556,263,293,2.99
2020,CB2020,061,1,Manhattan,10072005001,1215,509,706,2.99
2020,CB2020,061,1,Manhattan,10072006000,908,380,528,3.24
2020,CB2020,061,1,Manhattan,10072007000,921,346,575,3.23
2020,CB2020,061,1,Manhattan,10073001000,255,134,121,1.58
2020,CB2020,061,1,Manhattan,10073001001,238,129,109,2.01
2020,CB2020,061,1,Manhattan,10073001002,390,191,199,2.49
2020,CB2020,061,1,Manhattan,10073002000,739,348,391,2.97
2020,CB2020,061,1,Manhattan,10073003000,544,248,296,2.38
2020,CB2020,061,1,Manhattan,10073003001,77,42,35,1.32
2020,CB2020,061,1,Manhattan,10073003002,374,173,201,2.26
2020,CB2020,061,1,Manhattan,10073003003,342,181,161,2.48
2020,CB2020,061,1,Manhattan,10073004000,587,305,282,2.49
2020,CB2020,061,1,Manhattan,10073004001,383,192,191,2.58
2020,CB2020,061,1,Manhattan,10073004002,204,102,102,1.23
2020,CB2020,061,1,Manhattan,10073004003,29,18,11,0.89
2020,CB2020,061,1,Manhattan,10073004004,219,106,113,1.44
2020,CB2020,061,1,Manhattan,10073005000,388,200,188,2.49
2020,CB2020,061,1,Manhattan,10073005001,235,133,102,2.48
2020,CB2020,061,1,Manhattan,10073006000,195,96,99,2.45
2020,CB2020,061,1,Manhattan,10073006001,397,178,219,2.44
2020,CB2020,061,1,Manhattan,10073006002,129,65,64,1.37
2020,CB2020,061,1,Manhattan,10073006003,153,107,46,1.09
2020,CB2020,061,1,Manhattan,10073006004,284,141,143,2.05
2020,CB2020,061,1,Manhattan,10073006005,18,9,9,0.37
2020,CB2020,061,1,Manhattan,10074001000,991,217,774,3.31
2020,CB2020,061,1,Manhattan,10074001001,153,68,85,3.03
2020,CB2020,061,1,Manhattan,10074001002,272,125,147,3.02
2020,CB2020,061,1,Manhattan,10074002000,399,176,223,3.03
2020,CB2020,061,1,Manhattan,10074002001,235,114,121,3.02
2020,CB2020,061,1,Manhattan,10074002002,195,86,109,3.03
2020,CB2020,061,1,Manhattan,10074003000,435,191,244,2.99
2020,CB2020,061,1,Manhattan,10074003001,327,175,152,3
2020,CB2020,061,1,Manhattan,10074003002,579,298,281,3.01
2020,CB2020,061,1,Manhattan,10074004000,720,346,374,3.12
2020,CB2020,061,1,Manhattan,10074005000,0,0,0,3.22
2020,CB2020,061,1,Manhattan,10074005001,155,79,76,3.24
2020,CB2020,061,1,Manhattan,10074005002,1012,531,481,3.01
2020,CB2020,061,1,Manhattan,10074005003,225,98,127,2.99
2020,CB2020,061,1,Manhattan,10075000001,0,0,0,0
2020,CB2020,061,1,Manhattan,10075001000,321,135,186,2.21
2020,CB2020,061,1,Manhattan,10075001001,96,79,17,1.21
2020,CB2020,061,1,Manhattan,10075001002,0,0,0,1.77
2020,CB2020,061,1,Manhattan,10075001003,0,0,0,7.25
2020,CB2020,061,1,Manhattan,10075001004,272,155,117,2.57
2020,CB2020,061,1,Manhattan,10075001005,295,166,129,2.01
2020,CB2020,061,1,Manhattan,10075001006,155,74,81,1.95
2020,CB2020,061,1,Manhattan,10075001007,382,181,201,2.14
2020,CB2020,061,1,Manhattan,10075001008,31,19,12,0.65
2020,CB2020,061,1,Manhattan,10075001009,131,69,62,1.45
2020,CB2020,061,1,Manhattan,10075002000,482,231,251,2.58
2020,CB2020,061,1,Manhattan,10075002001,415,209,206,2.57
2020,CB2020,061,1,Manhattan,10075002002,411,211,200,2.63
2020,CB2020,061,1,Manhattan,10075002003,267,140,127,2.46
2020,CB2020,061,1,Manhattan,10075003000,128,75,53,1.28
2020,CB2020,061,1,Manhattan,10075003001,129,47,82,1.41
2020,CB2020,061,1,Manhattan,10075003002,182,72,110,1.49
2020,CB2020,061,1,Manhattan,10075003003,159,94,65,1.6
2020,CB2020,061,1,Manhattan,10075003004,144,79,65,1.73
2020,CB2020,061,1,Manhattan,10076001000,50,33,17,6.51
2020,CB2020,061,1,Manhattan,10076001001,1170,474,696,6.29
2020,CB2020,061,1,Manhattan,10076001002,15,0,15,0.86
2020,CB2020,061,1,Manhattan,10076001003,393,128,265,5.27
2020,CB2020,061,1,Manhattan,10076001004,584,213,371,4.72
2020,CB2020,061,1,Manhattan,10076001005,16,7,9,1.31
2020,CB2020,061,1,Manhattan,10076002000,220,118,102,4.12
2020,CB2020,061,1,Manhattan,10076002001,21,11,10,1.89
2020,CB2020,061,1,Manhattan,10076002002,65,16,49,2.48
2020,CB2020,061,1,Manhattan,10076002003,86,62,24,3.06
2020,CB2020,061,1,Manhattan,10076002004,188,89,99,2.98
2020,CB2020,061,1,Manhattan,10076002005,113,58,55,3.58
2020,CB2020,061,1,Manhattan,10077001000,991,481,510,5.63
2020,CB2020,061,1,Manhattan,10077001001,274,133,141,3.3
2020,CB2020,061,1,Manhattan,10077001002,0,0,0,1.1
2020,CB2020,061,1,Manhattan,10077002000,0,0,0,0.74
2020,CB2020,061,1,Manhattan,10077002001,734,351,383,2.2
2020,CB2020,061,1,Manhattan,10077002002,433,214,219,2.42
2020,CB2020,061,1,Manhattan,10077003000,730,386,344,5.07
2020,CB2020,061,1,Manhattan,10077003001,42,26,16,1.08
2020,CB2020,061,1,Manhattan,10077003002,0,0,0,2.42
2020,CB2020,061,1,Manhattan,10077003003,65,35,30,0.75
2020,CB2020,061,1,Manhattan,10077003004,445,266,179,2.48
2020,CB2020,061,1,Manhattan,10077003005,280,112,168,1.55
2020,CB2020,061,1,Manhattan,10077003006,0,0,0,0.82
2020,CB2020,061,1,Manhattan,10077004000,93,28,65,0.95
2020,CB2020,061,1,Manhattan,10077004001,691,338,353,2.77
2020,CB2020,061,1,Manhattan,10077004002,382,180,202,2.53
2020,CB2020,061,1,Manhattan,10077004003,58,40,18,1.47
2020,CB2020,061,1,Manhattan,10077005000,381,191,190,3.19
2020,CB2020,061,1,Manhattan,10077005001,392,176,216,2.5
2020,CB2020,061,1,Manhattan,10077005002,201,103,98,1.19
2020,CB2020,061,1,Manhattan,10078001000,1255,607,648,2.6
2020,CB2020,061,1,Manhattan,10078001001,166,71,95,1.62
2020,CB2020,061,1,Manhattan,10078002000,141,56,85,2.57
2020,CB2020,061,1,Manhattan,10078002001,393,191,202,1.63
2020,CB2020,061,1,Manhattan,10078002002,223,97,126,2.76
2020,CB2020,061,1,Manhattan,10078002003,348,150,198,1.41
2020,CB2020,061,1,Manhattan,10078003000,729,334,395,2.61
2020,CB2020,061,1,Manhattan,10078004000,596,290,306,1.6
2020,CB2020,061,1,Manhattan,10078004001,130,67,63,1.62
2020,CB2020,061,1,Manhattan,10078004002,832,363,469,2.9
2020,CB2020,061,1,Manhattan,10078005000,0,0,0,3.25
2020,CB2020,061,1,Manhattan,10078005001,0,0,0,1.2
2020,CB2020,061,1,Manhattan,10078005002,0,0,0,1.31
2020,CB2020,061,1,Manhattan,10078005003,681,300,381,3.47
2020,CB2020,061,1,Manhattan,10078006000,1571,764,807,2.75
2020,CB2020,061,1,Manhattan,10078006001,411,220,191,1.61
2020,CB2020,061,1,Manhattan,10078006002,0,0,0,4.52
2020,CB2020,061,1,Manhattan,10078007000,792,413,379,2.83
2020,CB2020,061,1,Manhattan,10078007001,841,395,446,1.6
2020,CB2020,061,1,Manhattan,10079000001,0,0,0,0
2020,CB2020,061,1,Manhattan,10079000002,0,0,0,0
2020,CB2020,061,1,Manhattan,10079000003,0,0,0,0
2020,CB2020,061,1,Manhattan,10079001000,10,1,9,3.36
2020,CB2020,061,1,Manhattan,10079001001,0,0,0,2.61
2020,CB2020,061,1,Manhattan,10079001002,0,0,0,1.53
2020,CB2020,061,1,Manhattan,10079001003,0,0,0,1.3
2020,CB2020,061,1,Manhattan,10079001004,0,0,0,8.6
2020,CB2020,061,1,Manhattan,10079001005,0,0,0,4.72
2020,CB2020,061,1,Manhattan,10079001006,0,0,0,0.28
2020,CB2020,061,1,Manhattan,10079001007,25,17,8,0.3
2020,CB2020,061,1,Manhattan,10079001008,618,329,289,2.39
2020,CB2020,061,1,Manhattan,10079001009,24,11,13,3.59
2020,CB2020,061,1,Manhattan,10079001010,0,0,0,2.18
2020,CB2020,061,1,Manhattan,10079001011,27,17,10,3.11
2020,CB2020,061,1,Manhattan,10079001012,0,0,0,2.22
2020,CB2020,061,1,Manhattan,10079001013,0,0,0,0.36
2020,CB2020,061,1,Manhattan,10079001014,378,191,187,2.1
2020,CB2020,061,1,Manhattan,10079001015,0,0,0,1.31
2020,CB2020,061,1,Manhattan,10079002000,329,174,155,2.24
2020,CB2020,061,1,Manhattan,10079002001,344,172,172,2.21
2020,CB2020,061,1,Manhattan,10079002002,535,228,307,3.2
2020,CB2020,061,1,Manhattan,10079003000,149,84,65,2.38
2020,CB2020,061,1,Manhattan,10079003001,260,134,126,2.38
2020,CB2020,061,1,Manhattan,10079003002,163,68,95,2.32
2020,CB2020,061,1,Manhattan,10079003003,182,74,108,2.39
2020,CB2020,061,1,Manhattan,10079003004,399,203,196,2.57
2020,CB2020,061,1,Manhattan,10079004000,26,7,19,0.81
2020,CB2020,061,1,Manhattan,10079004001,0,0,0,1.37
2020,CB2020,061,1,Manhattan,10079004002,106,53,53,1.68
2020,CB2020,061,1,Manhattan,10079004003,451,219,232,1.31
2020,CB2020,061,1,Manhattan,10079004004,104,45,59,1.14
2020,CB2020,061,1,Manhattan,10079004005,177,93,84,1.03
2020,CB2020,061,1,Manhattan,10079004006,135,79,56,0.76
2020,CB2020,061,1,Manhattan,10080001000,0,0,0,3.23
2020,CB2020,061,1,Manhattan,10080001001,0,0,0,2.99
2020,CB2020,061,1,Manhattan,10080001002,219,97,122,3
2020,CB2020,061,1,Manhattan,10080001003,1116,641,475,3
2020,CB2020,061,1,Manhattan,10080002000,716,315,401,2.99
2020,CB2020,061,1,Manhattan,10080003000,663,313,350,2.99
2020,CB2020,061,1,Manhattan,10080003001,737,297,440,3
2020,CB2020,061,1,Manhattan,10080004000,632,314,318,3.03
2020,CB2020,061,1,Manhattan,10080004001,564,278,286,3.02
2020,CB2020,061,1,Manhattan,10080005000,0,0,0,3.26
2020,CB2020,061,1,Manhattan,10080005001,23,7,16,3.04
2020,CB2020,061,1,Manhattan,10080006000,135,49,86,3.04
2020,CB2020,061,1,Manhattan,10080006001,458,206,252,3.03
2020,CB2020,061,1,Manhattan,10080006002,643,273,370,3.03
2020,CB2020,061,1,Manhattan,10081001000,753,377,376,5.05
2020,CB2020,061,1,Manhattan,10081001001,952,486,466,5.05
2020,CB2020,061,1,Manhattan,10081002000,617,314,303,5.04
2020,CB2020,061,1,Manhattan,10081002001,1018,558,460,5.06
2020,CB2020,061,1,Manhattan,10081003000,820,427,393,5.52
2020,CB2020,061,1,Manhattan,10081004000,1269,657,612,5.92
2020,CB2020,061,1,Manhattan,10081005000,1450,761,689,5.5
2020,CB2020,061,1,Manhattan,10081006000,974,523,451,5.94
2020,CB2020,061,1,Manhattan,10082001000,9,4,5,3.03
2020,CB2020,061,1,Manhattan,10082001001,442,204,238,3.03
2020,CB2020,061,1,Manhattan,10082001002,333,164,169,3.02
2020,CB2020,061,1,Manhattan,10082002000,20,16,4,3.23
2020,CB2020,061,1,Manhattan,10082002001,24,22,2,3.22
2020,CB2020,061,1,Manhattan,10082002002,0,0,0,3
2020,CB2020,061,1,Manhattan,10082002003,225,100,125,3
2020,CB2020,061,1,Manhattan,10082002004,243,131,112,3
2020,CB2020,061,1,Manhattan,10082002005,220,97,123,2.99
2020,CB2020,061,1,Manhattan,10082002006,383,168,215,2.99
2020,CB2020,061,1,Manhattan,10082002007,242,114,128,3
2020,CB2020,061,1,Manhattan,10082002008,23,9,14,3.02
2020,CB2020,061,1,Manhattan,10082003000,336,145,191,3.03
2020,CB2020,061,1,Manhattan,10082003001,914,374,540,3.02
2020,CB2020,061,1,Manhattan,10083001000,378,205,173,5.03
2020,CB2020,061,1,Manhattan,10083001001,528,272,256,5.07
2020,CB2020,061,1,Manhattan,10083002000,0,0,0,5.49
2020,CB2020,061,1,Manhattan,10083002001,496,243,253,3.53
2020,CB2020,061,1,Manhattan,10083002002,345,173,172,2.31
2020,CB2020,061,1,Manhattan,10083003000,665,298,367,5.04
2020,CB2020,061,1,Manhattan,10083003001,1396,646,750,5.05
2020,CB2020,061,1,Manhattan,10083003002,0,0,0,5.45
2020,CB2020,061,1,Manhattan,10083003003,45,25,20,6.06
2020,CB2020,061,1,Manhattan,10084001000,33,14,19,12.54
2020,CB2020,061,1,Manhattan,10084002000,323,166,157,6.03
2020,CB2020,061,1,Manhattan,10084002001,28,19,9,6.04
2020,CB2020,061,1,Manhattan,10084002002,617,307,310,6.03
2020,CB2020,061,1,Manhattan,10084002003,430,213,217,6.04
2020,CB2020,061,1,Manhattan,10084002004,554,277,277,6.09
2020,CB2020,061,1,Manhattan,10086010001,0,0,0,0
2020,CB2020,061,1,Manhattan,10086010002,0,0,0,0
2020,CB2020,061,1,Manhattan,10086010003,0,0,0,0
2020,CB2020,061,1,Manhattan,10086010004,0,0,0,0
2020,CB2020,061,1,Manhattan,10086011000,1684,822,862,2.63
2020,CB2020,061,1,Manhattan,10086011001,0,0,0,0.7
2020,CB2020,061,1,Manhattan,10086011002,0,0,0,2.5
2020,CB2020,061,1,Manhattan,10086011003,1395,715,680,2.76
2020,CB2020,061,1,Manhattan,10086012000,0,0,0,0.03
2020,CB2020,061,1,Manhattan,10086013000,0,0,0,0.6
2020,CB2020,061,1,Manhattan,10086013001,0,0,0,0.59
2020,CB2020,061,1,Manhattan,10086013002,0,0,0,0.57
2020,CB2020,061,1,Manhattan,10086013003,0,0,0,1.69
2020,CB2020,061,1,Manhattan,10086013004,89,39,50,2.13
2020,CB2020,061,1,Manhattan,10086013005,0,0,0,1.33
2020,CB2020,061,1,Manhattan,10086013006,36,20,16,4.74
2020,CB2020,061,1,Manhattan,10086013007,0,0,0,0.74
2020,CB2020,061,1,Manhattan,10086013008,0,0,0,0.3
2020,CB2020,061,1,Manhattan,10086013009,699,338,361,1.84
2020,CB2020,061,1,Manhattan,10086013010,0,0,0,0.8
2020,CB2020,061,1,Manhattan,10086013011,0,0,0,1.03
2020,CB2020,061,1,Manhattan,10086013012,0,0,0,3.39
2020,CB2020,061,1,Manhattan,10086013013,0,0,0,0.13
2020,CB2020,061,1,Manhattan,10086013014,0,0,0,0.23
2020,CB2020,061,1,Manhattan,10086013015,950,481,469,2.24
2020,CB2020,061,1,Manhattan,10086020001,0,0,0,0
2020,CB2020,061,1,Manhattan,10086021000,0,0,0,0.16
2020,CB2020,061,1,Manhattan,10086021001,0,0,0,1.72
2020,CB2020,061,1,Manhattan,10086021002,0,0,0,20.28
2020,CB2020,061,1,Manhattan,10086021003,0,0,0,0.45
2020,CB2020,061,1,Manhattan,10086021004,0,0,0,0.29
2020,CB2020,061,1,Manhattan,10086021005,0,0,0,0.4
2020,CB2020,061,1,Manhattan,10086021006,0,0,0,0.26
2020,CB2020,061,1,Manhattan,10086021007,0,0,0,0.28
2020,CB2020,061,1,Manhattan,10086021008,0,0,0,2.49
2020,CB2020,061,1,Manhattan,10086030001,0,0,0,0
2020,CB2020,061,1,Manhattan,10086031000,0,0,0,0.38
2020,CB2020,061,1,Manhattan,10086031001,1960,954,1006,4.26
2020,CB2020,061,1,Manhattan,10086032000,0,0,0,0.68
2020,CB2020,061,1,Manhattan,10086032001,985,441,544,4.69
2020,CB2020,061,1,Manhattan,10086032002,0,0,0,0.73
2020,CB2020,061,1,Manhattan,10086033000,871,387,484,4.4
2020,CB2020,061,1,Manhattan,10086034000,102,38,64,3.01
2020,CB2020,061,1,Manhattan,10086034001,605,255,350,2.56
2020,CB2020,061,1,Manhattan,10086034002,277,112,165,1.41
2020,CB2020,061,1,Manhattan,10086034003,138,72,66,0.71
2020,CB2020,061,1,Manhattan,10086034004,0,0,0,0.46
2020,CB2020,061,1,Manhattan,10086034005,409,209,200,3.24
2020,CB2020,061,1,Manhattan,10086034006,0,0,0,0.45
2020,CB2020,061,1,Manhattan,10086034007,0,0,0,0.96
2020,CB2020,061,1,Manhattan,10086034008,0,0,0,0.41
2020,CB2020,061,1,Manhattan,10086034009,0,0,0,0.54
2020,CB2020,061,1,Manhattan,10087001000,942,516,426,5.04
2020,CB2020,061,1,Manhattan,10087002000,898,445,453,5.04
2020,CB2020,061,1,Manhattan,10087003000,1064,541,523,5.34
2020,CB2020,061,1,Manhattan,10087004000,903,456,447,5.03
2020,CB2020,061,1,Manhattan,10087005000,707,356,351,5.06
2020,CB2020,061,1,Manhattan,10087005001,358,195,163,5.03
2020,CB2020,061,1,Manhattan,10087006000,815,394,421,5.31
2020,CB2020,061,1,Manhattan,10087006001,823,462,361,5.03
2020,CB2020,061,1,Manhattan,10088001000,741,379,362,4.25
2020,CB2020,061,1,Manhattan,10088001001,31,22,9,4.58
2020,CB2020,061,1,Manhattan,10088001002,31,4,27,4.53
2020,CB2020,061,1,Manhattan,10088001003,18,8,10,1.62
2020,CB2020,061,1,Manhattan,10088001004,97,41,56,1.62
2020,CB2020,061,1,Manhattan,10088001005,125,44,81,3.6
2020,CB2020,061,1,Manhattan,10088001006,444,227,217,1.13
2020,CB2020,061,1,Manhattan,10088002000,978,458,520,2.57
2020,CB2020,061,1,Manhattan,10088002001,1071,529,542,2.58
2020,CB2020,061,1,Manhattan,10088003000,748,364,384,1.85
2020,CB2020,061,1,Manhattan,10088003001,559,219,340,1.41
2020,CB2020,061,1,Manhattan,10088004000,72,35,37,2.84
2020,CB2020,061,1,Manhattan,10088004001,914,432,482,1.61
2020,CB2020,061,1,Manhattan,10088005000,966,441,525,4.44
2020,CB2020,061,1,Manhattan,10088006000,757,341,416,3.62
2020,CB2020,061,1,Manhattan,10088006001,421,170,251,0.93
2020,CB2020,061,1,Manhattan,10088007000,879,401,478,1.13
2020,CB2020,061,1,Manhattan,10089001000,661,352,309,5.04
2020,CB2020,061,1,Manhattan,10089002000,743,386,357,5.04
2020,CB2020,061,1,Manhattan,10089002001,549,316,233,5.04
2020,CB2020,061,1,Manhattan,10089003000,608,333,275,5.04
2020,CB2020,061,1,Manhattan,10089003001,1304,609,695,5.04
2020,CB2020,061,1,Manhattan,10089004000,616,334,282,5.34
2020,CB2020,061,1,Manhattan,10089004001,291,142,149,5.04
2020,CB2020,061,1,Manhattan,10089005000,1185,634,551,5.34
2020,CB2020,061,1,Manhattan,10090001000,348,141,207,4.59
2020,CB2020,061,1,Manhattan,10090002000,1942,917,1025,4.46
2020,CB2020,061,1,Manhattan,10090003000,1088,575,513,4.25
2020,CB2020,061,1,Manhattan,10090003001,364,169,195,4.3
2020,CB2020,061,1,Manhattan,10090004000,1462,669,793,4.3
2020,CB2020,061,1,Manhattan,10090005000,492,206,286,4.25
2020,CB2020,061,1,Manhattan,10090005001,315,161,154,4.26
2020,CB2020,061,1,Manhattan,10090006000,1546,770,776,4.23
2020,CB2020,061,1,Manhattan,10090007000,399,138,261,4.27
2020,CB2020,061,1,Manhattan,10090007001,874,387,487,4.26
2020,CB2020,061,1,Manhattan,10091001000,1135,497,638,5.38
2020,CB2020,061,1,Manhattan,10091002000,903,521,382,5.69
2020,CB2020,061,1,Manhattan,10091003000,876,436,440,5.73
2020,CB2020,061,1,Manhattan,10091004000,767,370,397,5.73
2020,CB2020,061,1,Manhattan,10091004001,1004,556,448,5.74
2020,CB2020,061,1,Manhattan,10091005000,623,359,264,5.32
2020,CB2020,061,1,Manhattan,10091005001,161,102,59,2.48
2020,CB2020,061,1,Manhattan,10091005002,461,244,217,2.85
2020,CB2020,061,1,Manhattan,10091006000,1432,687,745,5.35
2020,CB2020,061,1,Manhattan,10092001000,300,140,160,3.04
2020,CB2020,061,1,Manhattan,10092001001,114,38,76,3.04
2020,CB2020,061,1,Manhattan,10092001002,497,264,233,3.03
2020,CB2020,061,1,Manhattan,10092001003,17,12,5,3.27
2020,CB2020,061,1,Manhattan,10092002000,17,7,10,3.08
2020,CB2020,061,1,Manhattan,10092002001,0,0,0,3.07
2020,CB2020,061,1,Manhattan,10092002002,0,0,0,3.06
2020,CB2020,061,1,Manhattan,10092002003,0,0,0,1.12
2020,CB2020,061,1,Manhattan,10092002004,0,0,0,1.33
2020,CB2020,061,1,Manhattan,10092002005,0,0,0,1.33
2020,CB2020,061,1,Manhattan,10092002006,30,29,1,5.01
2020,CB2020,061,1,Manhattan,10092002007,4,4,0,1.08
2020,CB2020,061,1,Manhattan,10092002008,40,17,23,6.16
2020,CB2020,061,1,Manhattan,10092002009,0,0,0,1.97
2020,CB2020,061,1,Manhattan,10092003000,433,216,217,3.04
2020,CB2020,061,1,Manhattan,10092003001,403,217,186,3.04
2020,CB2020,061,1,Manhattan,10092003002,11,1,10,3.03
2020,CB2020,061,1,Manhattan,10093001000,591,223,368,5.4
2020,CB2020,061,1,Manhattan,10093001001,636,283,353,3.42
2020,CB2020,061,1,Manhattan,10093001002,739,356,383,3.41
2020,CB2020,061,1,Manhattan,10093002000,420,189,231,4.17
2020,CB2020,061,1,Manhattan,10093002001,974,562,412,5.73
2020,CB2020,061,1,Manhattan,10093003000,984,547,437,2.3
2020,CB2020,061,1,Manhattan,10093004000,1167,648,519,3.38
2020,CB2020,061,1,Manhattan,10093005000,491,257,234,3.19
2020,CB2020,061,1,Manhattan,10093005001,470,264,206,2.13
2020,CB2020,061,1,Manhattan,10093006000,1353,647,706,2.33
2020,CB2020,061,1,Manhattan,10093006001,655,246,409,3.05
2020,CB2020,061,1,Manhattan,10093007000,845,455,390,5.74
2020,CB2020,061,1,Manhattan,10094001000,0,0,0,3.06
2020,CB2020,061,1,Manhattan,10094001001,43,16,27,3.05
2020,CB2020,061,1,Manhattan,10094001002,0,0,0,3.04
2020,CB2020,061,1,Manhattan,10094001003,7,0,7,3.05
2020,CB2020,061,1,Manhattan,10094001004,39,23,16,3.04
2020,CB2020,061,1,Manhattan,10094001005,2,2,0,3.04
2020,CB2020,061,1,Manhattan,10094001006,0,0,0,3.3
2020,CB2020,061,1,Manhattan,10094002000,3,0,3,3.05
2020,CB2020,061,1,Manhattan,10094002001,5,4,1,3.05
2020,CB2020,061,1,Manhattan,10094002002,0,0,0,1.71
2020,CB2020,061,1,Manhattan,10094002003,0,0,0,1.34
2020,CB2020,061,1,Manhattan,10094002004,5,3,2,1.71
2020,CB2020,061,1,Manhattan,10094002005,2,0,2,1.72
2020,CB2020,061,1,Manhattan,10094002006,0,0,0,1.69
2020,CB2020,061,1,Manhattan,10094002007,3,3,0,1.88
2020,CB2020,061,1,Manhattan,10095001000,520,274,246,5.3
2020,CB2020,061,1,Manhattan,10095001001,381,126,255,5.33
2020,CB2020,061,1,Manhattan,10095001002,301,177,124,5.32
2020,CB2020,061,1,Manhattan,10095001003,654,316,338,5.31
2020,CB2020,061,1,Manhattan,10095002000,334,184,150,5.3
2020,CB2020,061,1,Manhattan,10095002001,244,125,119,5.3
2020,CB2020,061,1,Manhattan,10095002002,30,17,13,5.32
2020,CB2020,061,1,Manhattan,10095002003,305,156,149,2.8
2020,CB2020,061,1,Manhattan,10095002004,1123,169,954,2.51
2020,CB2020,061,1,Manhattan,10096001000,13,7,6,6.09
2020,CB2020,061,1,Manhattan,10096001001,29,14,15,6.12
2020,CB2020,061,1,Manhattan,10096001002,125,16,109,6.12
2020,CB2020,061,1,Manhattan,10096001003,14,10,4,6.6
2020,CB2020,061,1,Manhattan,10096002000,0,0,0,6.11
2020,CB2020,061,1,Manhattan,10096002001,107,44,63,6.12
2020,CB2020,061,1,Manhattan,10096002002,320,299,21,6.16
2020,CB2020,061,1,Manhattan,10097001000,597,268,329,3.91
2020,CB2020,061,1,Manhattan,10097001001,1113,527,586,2.69
2020,CB2020,061,1,Manhattan,10097001002,630,267,363,3.55
2020,CB2020,061,1,Manhattan,10097002000,0,0,0,5.44
2020,CB2020,061,1,Manhattan,10097002001,51,30,21,5.26
2020,CB2020,061,1,Manhattan,10097002002,899,360,539,10.66
2020,CB2020,061,1,Manhattan,10097003000,626,295,331,5.72
2020,CB2020,061,1,Manhattan,10097004000,1155,607,548,5.5
2020,CB2020,061,1,Manhattan,10098001000,848,430,418,4.22
2020,CB2020,061,1,Manhattan,10098002000,406,179,227,4.26
2020,CB2020,061,1,Manhattan,10098002001,583,285,298,4.27
2020,CB2020,061,1,Manhattan,10098003000,496,230,266,4.25
2020,CB2020,061,1,Manhattan,10098003001,231,86,145,2.23
2020,CB2020,061,1,Manhattan,10098003002,377,201,176,2.03
2020,CB2020,061,1,Manhattan,10098004000,460,220,240,2.49
2020,CB2020,061,1,Manhattan,10098004001,517,233,284,2.03
2020,CB2020,061,1,Manhattan,10098005000,952,444,508,4.5
2020,CB2020,061,1,Manhattan,10098006000,951,439,512,4.51
2020,CB2020,061,1,Manhattan,10098006001,1106,512,594,4.5
2020,CB2020,061,1,Manhattan,10098007000,1151,517,634,4.47
2020,CB2020,061,1,Manhattan,10099010001,0,0,0,0
2020,CB2020,061,1,Manhattan,10099011000,16,13,3,5.28
2020,CB2020,061,1,Manhattan,10099011001,41,33,8,5.36
2020,CB2020,061,1,Manhattan,10099011002,1053,559,494,5.74
2020,CB2020,061,1,Manhattan,10099011003,495,289,206,5.58
2020,CB2020,061,1,Manhattan,10099011004,106,62,44,5.11
2020,CB2020,061,1,Manhattan,10099011005,108,49,59,4.39
2020,CB2020,061,1,Manhattan,10099011006,110,39,71,3.86
2020,CB2020,061,1,Manhattan,10099011007,76,31,45,3.34
2020,CB2020,061,1,Manhattan,10099011008,13,11,2,2.81
2020,CB2020,061,1,Manhattan,10099012000,11,8,3,7.42
2020,CB2020,061,1,Manhattan,10099012001,0,0,0,0.87
2020,CB2020,061,1,Manhattan,10099012002,64,40,24,31.81
2020,CB2020,061,1,Manhattan,10099012003,0,0,0,0.33
2020,CB2020,061,1,Manhattan,10099012004,0,0,0,1.82
2020,CB2020,061,1,Manhattan,10099012005,0,0,0,0.31
2020,CB2020,061,1,Manhattan,10099012006,0,0,0,0.48
2020,CB2020,061,1,Manhattan,10099012007,0,0,0,3.72
2020,CB2020,061,1,Manhattan,10099012008,0,0,0,0.47
2020,CB2020,061,1,Manhattan,10099012009,0,0,0,0.33
2020,CB2020,061,1,Manhattan,10099012010,0,0,0,1.32
2020,CB2020,061,1,Manhattan,10099012011,0,0,0,0.81
2020,CB2020,061,1,Manhattan,10099012012,0,0,0,1.91
2020,CB2020,061,1,Manhattan,10099012013,0,0,0,2.29
2020,CB2020,061,1,Manhattan,10099012014,0,0,0,1.35
2020,CB2020,061,1,Manhattan,10099020001,0,0,0,0
2020,CB2020,061,1,Manhattan,10099021000,1625,881,744,5.31
2020,CB2020,061,1,Manhattan,10099021001,0,0,0,5.25
2020,CB2020,061,1,Manhattan,10099021002,1673,838,835,5.32
2020,CB2020,061,1,Manhattan,10099021003,462,261,201,5.33
2020,CB2020,061,1,Manhattan,10099021004,48,38,10,5.32
2020,CB2020,061,1,Manhattan,10099022000,0,0,0,0.4
2020,CB2020,061,1,Manhattan,10099022001,0,0,0,4.43
2020,CB2020,061,1,Manhattan,10099022002,0,0,0,0.99
2020,CB2020,061,1,Manhattan,10099022003,0,0,0,4.98
2020,CB2020,061,1,Manhattan,10099022004,0,0,0,4.75
2020,CB2020,061,1,Manhattan,10099022005,40,22,18,4.24
2020,CB2020,061,1,Manhattan,10099030001,0,0,0,0
2020,CB2020,061,1,Manhattan,10099030002,0,0,0,0
2020,CB2020,061,1,Manhattan,10099031000,14,13,1,22.75
2020,CB2020,061,1,Manhattan,10099032000,0,0,0,11.06
2020,CB2020,061,1,Manhattan,10099032001,0,0,0,1.77
2020,CB2020,061,1,Manhattan,10099032002,0,0,0,0.73
2020,CB2020,061,1,Manhattan,10099032003,0,0,0,5.67
2020,CB2020,061,1,Manhattan,10099032004,0,0,0,8.53
2020,CB2020,061,1,Manhattan,10099032005,0,0,0,7.4
2020,CB2020,061,1,Manhattan,10099032006,0,0,0,0.92
2020,CB2020,061,1,Manhattan,10099032007,0,0,0,1.52
2020,CB2020,061,1,Manhattan,10099032008,0,0,0,3.91
2020,CB2020,061,1,Manhattan,10099032009,60,50,10,5.74
2020,CB2020,061,1,Manhattan,10099032010,0,0,0,5.74
2020,CB2020,061,1,Manhattan,10099032011,0,0,0,1.6
2020,CB2020,061,1,Manhattan,10099032012,0,0,0,2.22
2020,CB2020,061,1,Manhattan,10099032013,0,0,0,2.57
2020,CB2020,061,1,Manhattan,10099032014,1496,811,685,2.8
2020,CB2020,061,1,Manhattan,10099032015,340,186,154,3.19
2020,CB2020,061,1,Manhattan,10099032016,18,15,3,3.67
2020,CB2020,061,1,Manhattan,10099032017,452,248,204,12.07
2020,CB2020,061,1,Manhattan,10100001000,207,98,109,3.07
2020,CB2020,061,1,Manhattan,10100001001,327,153,174,3.07
2020,CB2020,061,1,Manhattan,10100001002,5,4,1,3.07
2020,CB2020,061,1,Manhattan,10100001003,48,15,33,3.07
2020,CB2020,061,1,Manhattan,10100001004,0,0,0,3.06
2020,CB2020,061,1,Manhattan,10100001005,205,192,13,3.08
2020,CB2020,061,1,Manhattan,10100001006,7,6,1,3.07
2020,CB2020,061,1,Manhattan,10100002000,565,244,321,3.04
2020,CB2020,061,1,Manhattan,10100002001,368,157,211,3.01
2020,CB2020,061,1,Manhattan,10100002002,27,19,8,3.04
2020,CB2020,061,1,Manhattan,10100002003,124,66,58,3.03
2020,CB2020,061,1,Manhattan,10100002004,65,39,26,3.03
2020,CB2020,061,1,Manhattan,10100002005,124,46,78,3.03
2020,CB2020,061,1,Manhattan,10100002006,98,45,53,3.06
2020,CB2020,061,1,Manhattan,10101001000,111,82,29,5.63
2020,CB2020,061,1,Manhattan,10101001001,87,59,28,5.76
2020,CB2020,061,1,Manhattan,10101001002,10,3,7,4.89
2020,CB2020,061,1,Manhattan,10101001003,57,43,14,5.64
2020,CB2020,061,1,Manhattan,10101001004,127,65,62,5.39
2020,CB2020,061,1,Manhattan,10101001005,794,394,400,5.38
2020,CB2020,061,1,Manhattan,10101001006,1371,707,664,5.28
2020,CB2020,061,1,Manhattan,10101001007,39,38,1,5.34
2020,CB2020,061,1,Manhattan,10101001008,0,0,0,0.07
2020,CB2020,061,1,Manhattan,10102001000,9,6,3,3.05
2020,CB2020,061,1,Manhattan,10102001001,23,14,9,3.07
2020,CB2020,061,1,Manhattan,10102001002,4,0,4,3.05
2020,CB2020,061,1,Manhattan,10102001003,0,0,0,3.06
2020,CB2020,061,1,Manhattan,10102001004,0,0,0,3.05
2020,CB2020,061,1,Manhattan,10102001005,0,0,0,3.06
2020,CB2020,061,1,Manhattan,10102001006,0,0,0,3.05
2020,CB2020,061,1,Manhattan,10102002000,0,0,0,3.05
2020,CB2020,061,1,Manhattan,10102002001,23,12,11,3.05
2020,CB2020,061,1,Manhattan,10102002002,3,2,1,3.04
2020,CB2020,061,1,Manhattan,10102002003,7,2,5,3.06
2020,CB2020,061,1,Manhattan,10102002004,195,101,94,3.04
2020,CB2020,061,1,Manhattan,10102002005,19,15,4,3.06
2020,CB2020,061,1,Manhattan,10102002006,0,0,0,3.05
2020,CB2020,061,1,Manhattan,10103001000,519,284,235,3.59
2020,CB2020,061,1,Manhattan,10103001001,0,0,0,0.25
2020,CB2020,061,1,Manhattan,10103001002,0,0,0,1.89
2020,CB2020,061,1,Manhattan,10103001003,0,0,0,3.9
2020,CB2020,061,1,Manhattan,10103001004,0,0,0,1.5
2020,CB2020,061,1,Manhattan,10103001005,11,1,10,0.67
2020,CB2020,061,1,Manhattan,10103001006,0,0,0,0.52
2020,CB2020,061,1,Manhattan,10103001007,0,0,0,0.35
2020,CB2020,061,1,Manhattan,10103001008,0,0,0,3.12
2020,CB2020,061,1,Manhattan,10103001009,2197,740,1457,3.38
2020,CB2020,061,1,Manhattan,10103001010,16,9,7,1.34
2020,CB2020,061,1,Manhattan,10103001011,30,10,20,1.12
2020,CB2020,061,1,Manhattan,10103001012,495,256,239,5.03
2020,CB2020,061,1,Manhattan,10103002000,756,361,395,5.74
2020,CB2020,061,1,Manhattan,10103002001,42,15,27,5
2020,CB2020,061,1,Manhattan,10103002002,29,14,15,5.72
2020,CB2020,061,1,Manhattan,10104001000,552,264,288,6.09
2020,CB2020,061,1,Manhattan,10104001001,253,135,118,6.14
2020,CB2020,061,1,Manhattan,10104001002,145,62,83,6.1
2020,CB2020,061,1,Manhattan,10104001003,10,2,8,6.12
2020,CB2020,061,1,Manhattan,10104001004,12,9,3,6.1
2020,CB2020,061,1,Manhattan,10104001005,6,3,3,6.12
2020,CB2020,061,1,Manhattan,10104001006,5,1,4,6.14
2020,CB2020,061,1,Manhattan,10106010001,0,0,0,0
2020,CB2020,061,1,Manhattan,10106011000,1309,626,683,4.31
2020,CB2020,061,1,Manhattan,10106012000,1209,571,638,4.58
2020,CB2020,061,1,Manhattan,10106013000,1490,613,877,4.59
2020,CB2020,061,1,Manhattan,10106014000,1396,586,810,4.3
2020,CB2020,061,1,Manhattan,10106015000,1620,689,931,4.2
2020,CB2020,061,1,Manhattan,10106016000,0,0,0,0.84
2020,CB2020,061,1,Manhattan,10106016001,0,0,0,1.01
2020,CB2020,061,1,Manhattan,10106016002,966,456,510,4.73
2020,CB2020,061,1,Manhattan,10106016003,266,102,164,1.31
2020,CB2020,061,1,Manhattan,10106016004,0,0,0,0.26
2020,CB2020,061,1,Manhattan,10106020001,0,0,0,0
2020,CB2020,061,1,Manhattan,10106020002,0,0,0,0
2020,CB2020,061,1,Manhattan,10106021000,1669,719,950,4.23
2020,CB2020,061,1,Manhattan,10106022000,0,0,0,0.33
2020,CB2020,061,1,Manhattan,10106022001,1059,534,525,1.69
2020,CB2020,061,1,Manhattan,10106022002,0,0,0,1.27
2020,CB2020,061,1,Manhattan,10106022003,0,0,0,0.35
2020,CB2020,061,1,Manhattan,10106022004,0,0,0,0.63
2020,CB2020,061,1,Manhattan,10106022005,0,0,0,1.59
2020,CB2020,061,1,Manhattan,10106022006,0,0,0,0.45
2020,CB2020,061,1,Manhattan,10106022007,0,0,0,0.28
2020,CB2020,061,1,Manhattan,10106022008,0,0,0,0.92
2020,CB2020,061,1,Manhattan,10106022009,0,0,0,1.17
2020,CB2020,061,1,Manhattan,10106022010,0,0,0,0.15
2020,CB2020,061,1,Manhattan,10106022011,0,0,0,0.72
2020,CB2020,061,1,Manhattan,10106023000,274,143,131,4.29
2020,CB2020,061,1,Manhattan,10106023001,416,196,220,1.5
2020,CB2020,061,1,Manhattan,10106023002,585,285,300,2.78
2020,CB2020,061,1,Manhattan,10106023003,291,285,6,1.53
2020,CB2020,061,1,Manhattan,10106023004,0,0,0,0.49
2020,CB2020,061,1,Manhattan,10106023005,8,8,0,2.19
2020,CB2020,061,1,Manhattan,10106024000,1187,555,632,4.31
2020,CB2020,061,1,Manhattan,10108011000,197,92,105,4.25
2020,CB2020,061,1,Manhattan,10108011001,842,398,444,4.24
2020,CB2020,061,1,Manhattan,10108012000,971,438,533,4.5
2020,CB2020,061,1,Manhattan,10108013000,1287,588,699,4.51
2020,CB2020,061,1,Manhattan,10108021000,542,263,279,3.03
2020,CB2020,061,1,Manhattan,10108021001,859,395,464,3.22
2020,CB2020,061,1,Manhattan,10108022000,389,180,209,1.48
2020,CB2020,061,1,Manhattan,10108022001,523,246,277,1.62
2020,CB2020,061,1,Manhattan,10108023000,1492,671,821,4.83
2020,CB2020,061,1,Manhattan,10108031000,499,234,265,4.28
2020,CB2020,061,1,Manhattan,10108031001,1103,507,596,4.57
2020,CB2020,061,1,Manhattan,10108032000,1094,486,608,4.59
2020,CB2020,061,1,Manhattan,10109001000,13,6,7,2.3
2020,CB2020,061,1,Manhattan,10109001001,0,0,0,3.04
2020,CB2020,061,1,Manhattan,10109001002,10,3,7,5.32
2020,CB2020,061,1,Manhattan,10109001003,209,90,119,5.29
2020,CB2020,061,1,Manhattan,10109001004,7,5,2,5.32
2020,CB2020,061,1,Manhattan,10109001005,65,62,3,5.73
2020,CB2020,061,1,Manhattan,10109001006,81,81,0,5.1
2020,CB2020,061,1,Manhattan,10109001007,0,0,0,4.14
2020,CB2020,061,1,Manhattan,10109001008,22,18,4,3.54
2020,CB2020,061,1,Manhattan,10109001009,0,0,0,1.76
2020,CB2020,061,1,Manhattan,10109001010,0,0,0,1.21
2020,CB2020,061,1,Manhattan,10109001011,0,0,0,0.66
2020,CB2020,061,1,Manhattan,10110001000,1558,676,882,4.23
2020,CB2020,061,1,Manhattan,10110002000,983,423,560,4.25
2020,CB2020,061,1,Manhattan,10110003000,471,223,248,4.25
2020,CB2020,061,1,Manhattan,10110003001,528,235,293,4.26
2020,CB2020,061,1,Manhattan,10110003002,556,250,306,4.27
2020,CB2020,061,1,Manhattan,10110004000,1309,572,737,4.47
2020,CB2020,061,1,Manhattan,10110005000,543,240,303,2.64
2020,CB2020,061,1,Manhattan,10110005001,200,74,126,1.86
2020,CB2020,061,1,Manhattan,10110006000,855,375,480,4.49
2020,CB2020,061,1,Manhattan,10110006001,292,139,153,2.81
2020,CB2020,061,1,Manhattan,10110006002,376,179,197,1.62
2020,CB2020,061,1,Manhattan,10110006003,0,0,0,4.46
2020,CB2020,061,1,Manhattan,10111001000,1327,654,673,5.31
2020,CB2020,061,1,Manhattan,10111001001,895,531,364,5.24
2020,CB2020,061,1,Manhattan,10111001002,697,502,195,3.65
2020,CB2020,061,1,Manhattan,10111001003,108,53,55,1.74
2020,CB2020,061,1,Manhattan,10111001004,60,32,28,5.73
2020,CB2020,061,1,Manhattan,10111002000,264,146,118,2.04
2020,CB2020,061,1,Manhattan,10111002001,0,0,0,0.51
2020,CB2020,061,1,Manhattan,10111002002,191,78,113,1.29
2020,CB2020,061,1,Manhattan,10111002003,112,72,40,1.14
2020,CB2020,061,1,Manhattan,10111002004,23,9,14,0.3
2020,CB2020,061,1,Manhattan,10111002005,258,16,242,2.67
2020,CB2020,061,1,Manhattan,10111002006,385,213,172,1.05
2020,CB2020,061,1,Manhattan,10111002007,0,0,0,0.22
2020,CB2020,061,1,Manhattan,10111002008,295,158,137,1.84
2020,CB2020,061,1,Manhattan,10111003000,32,27,5,0.99
2020,CB2020,061,1,Manhattan,10111003001,0,0,0,0.33
2020,CB2020,061,1,Manhattan,10111003002,0,0,0,1.08
2020,CB2020,061,1,Manhattan,10111003003,901,446,455,2.9
2020,CB2020,061,1,Manhattan,10111003004,237,141,96,2.94
2020,CB2020,061,1,Manhattan,10111003005,0,0,0,0.4
2020,CB2020,061,1,Manhattan,10111003006,0,0,0,0.77
2020,CB2020,061,1,Manhattan,10111003007,353,172,181,1.21
2020,CB2020,061,1,Manhattan,10112011000,14,6,8,1.2
2020,CB2020,061,1,Manhattan,10112011001,661,285,376,5.07
2020,CB2020,061,1,Manhattan,10112011002,197,104,93,6.79
2020,CB2020,061,1,Manhattan,10112011003,361,167,194,6.6
2020,CB2020,061,1,Manhattan,10112021000,208,90,118,3.05
2020,CB2020,061,1,Manhattan,10112021001,0,0,0,3.03
2020,CB2020,061,1,Manhattan,10112021002,7,2,5,3.33
2020,CB2020,061,1,Manhattan,10112021003,129,74,55,3.28
2020,CB2020,061,1,Manhattan,10112021004,77,38,39,3.28
2020,CB2020,061,1,Manhattan,10112021005,79,36,43,3.3
2020,CB2020,061,1,Manhattan,10112031000,79,44,35,3.04
2020,CB2020,061,1,Manhattan,10112031001,458,177,281,3.26
2020,CB2020,061,1,Manhattan,10112031002,343,166,177,3.28
2020,CB2020,061,1,Manhattan,10112032000,45,18,27,3.07
2020,CB2020,061,1,Manhattan,10112032001,400,182,218,3.31
2020,CB2020,061,1,Manhattan,10112032002,95,47,48,3.31
2020,CB2020,061,1,Manhattan,10113001000,8,4,4,4.35
2020,CB2020,061,1,Manhattan,10113001001,0,0,0,1.37
2020,CB2020,061,1,Manhattan,10113001002,6,3,3,5.73
2020,CB2020,061,1,Manhattan,10113001003,0,0,0,5.31
2020,CB2020,061,1,Manhattan,10113001004,58,36,22,5.32
2020,CB2020,061,1,Manhattan,10113001005,25,13,12,5.33
2020,CB2020,061,1,Manhattan,10113001006,0,0,0,2.54
2020,CB2020,061,1,Manhattan,10113001007,0,0,0,2.12
2020,CB2020,061,1,Manhattan,10113001008,27,15,12,1.72
2020,CB2020,061,1,Manhattan,10113001009,2,0,2,3.63
2020,CB2020,061,1,Manhattan,10113001010,2,1,1,3.19
2020,CB2020,061,1,Manhattan,10113001011,88,45,43,2.78
2020,CB2020,061,1,Manhattan,10114011000,224,100,124,3.05
2020,CB2020,061,1,Manhattan,10114011001,189,93,96,3.05
2020,CB2020,061,1,Manhattan,10114011002,183,84,99,3.03
2020,CB2020,061,1,Manhattan,10114011003,180,75,105,3.07
2020,CB2020,061,1,Manhattan,10114012000,115,55,60,3.04
2020,CB2020,061,1,Manhattan,10114012001,326,163,163,3.03
2020,CB2020,061,1,Manhattan,10114012002,11,8,3,3.03
2020,CB2020,061,1,Manhattan,10114012003,133,64,69,3.04
2020,CB2020,061,1,Manhattan,10114021000,522,249,273,3.04
2020,CB2020,061,1,Manhattan,10114021001,332,149,183,3.04
2020,CB2020,061,1,Manhattan,10114021002,575,242,333,3.04
2020,CB2020,061,1,Manhattan,10114021003,20,16,4,3.04
2020,CB2020,061,1,Manhattan,10114022000,380,177,203,3.06
2020,CB2020,061,1,Manhattan,10114022001,234,105,129,3.07
2020,CB2020,061,1,Manhattan,10114022002,192,82,110,2.09
2020,CB2020,061,1,Manhattan,10114022003,39,14,25,0.95
2020,CB2020,061,1,Manhattan,10114022004,326,142,184,3.09
2020,CB2020,061,1,Manhattan,10115001000,902,518,384,5.46
2020,CB2020,061,1,Manhattan,10115001001,0,0,0,5.57
2020,CB2020,061,1,Manhattan,10115001002,356,182,174,5.33
2020,CB2020,061,1,Manhattan,10115001003,546,296,250,5.34
2020,CB2020,061,1,Manhattan,10115002000,497,237,260,2.38
2020,CB2020,061,1,Manhattan,10115002001,1029,557,472,2.9
2020,CB2020,061,1,Manhattan,10115002002,123,61,62,3.14
2020,CB2020,061,1,Manhattan,10115002003,111,49,62,2.65
2020,CB2020,061,1,Manhattan,10115002004,134,99,35,2.35
2020,CB2020,061,1,Manhattan,10115002005,0,0,0,2.85
2020,CB2020,061,1,Manhattan,10115002006,0,0,0,1.14
2020,CB2020,061,1,Manhattan,10115002007,165,78,87,1.56
2020,CB2020,061,1,Manhattan,10115002008,0,0,0,2.72
2020,CB2020,061,1,Manhattan,10116000001,0,0,0,0
2020,CB2020,061,1,Manhattan,10116001000,0,0,0,0.45
2020,CB2020,061,1,Manhattan,10116001001,0,0,0,0.38
2020,CB2020,061,1,Manhattan,10116001002,16,6,10,7.87
2020,CB2020,061,1,Manhattan,10116001003,30,8,22,2.71
2020,CB2020,061,1,Manhattan,10116001004,224,116,108,1.56
2020,CB2020,061,1,Manhattan,10116001005,19,5,14,4.26
2020,CB2020,061,1,Manhattan,10116001006,678,326,352,4.25
2020,CB2020,061,1,Manhattan,10116001007,117,71,46,15.53
2020,CB2020,061,1,Manhattan,10116001008,0,0,0,1.21
2020,CB2020,061,1,Manhattan,10116001009,0,0,0,1.32
2020,CB2020,061,1,Manhattan,10116001010,0,0,0,0.24
2020,CB2020,061,1,Manhattan,10116002000,1235,511,724,4.27
2020,CB2020,061,1,Manhattan,10116003000,333,164,169,2.14
2020,CB2020,061,1,Manhattan,10116003001,611,292,319,2.14
2020,CB2020,061,1,Manhattan,10117000001,0,0,0,0
2020,CB2020,061,1,Manhattan,10117000002,0,0,0,0
2020,CB2020,061,1,Manhattan,10117000003,0,0,0,0
2020,CB2020,061,1,Manhattan,10117001000,805,467,338,1.7
2020,CB2020,061,1,Manhattan,10117001001,20,12,8,3.99
2020,CB2020,061,1,Manhattan,10117001002,31,14,17,3.47
2020,CB2020,061,1,Manhattan,10117001003,844,448,396,1.98
2020,CB2020,061,1,Manhattan,10117001004,0,0,0,3.8
2020,CB2020,061,1,Manhattan,10117001005,0,0,0,1.38
2020,CB2020,061,1,Manhattan,10117001006,0,0,0,0.74
2020,CB2020,061,1,Manhattan,10117001007,0,0,0,3.7
2020,CB2020,061,1,Manhattan,10117001008,73,18,55,0.77
2020,CB2020,061,1,Manhattan,10117002000,3416,1767,1649,5.66
2020,CB2020,061,1,Manhattan,10117003000,0,0,0,0.45
2020,CB2020,061,1,Manhattan,10117003001,7,7,0,3.74
2020,CB2020,061,1,Manhattan,10117003002,0,0,0,0.42
2020,CB2020,061,1,Manhattan,10117003003,0,0,0,0.7
2020,CB2020,061,1,Manhattan,10117003004,0,0,0,0.19
2020,CB2020,061,1,Manhattan,10117003005,0,0,0,0.27
2020,CB2020,061,1,Manhattan,10117003006,0,0,0,3.93
2020,CB2020,061,1,Manhattan,10117003007,0,0,0,5.31
2020,CB2020,061,1,Manhattan,10117003008,0,0,0,0.79
2020,CB2020,061,1,Manhattan,10117003009,0,0,0,0.22
2020,CB2020,061,1,Manhattan,10117003010,52,26,26,3.41
2020,CB2020,061,1,Manhattan,10117003011,8,3,5,0.65
2020,CB2020,061,1,Manhattan,10117003012,0,0,0,1.32
2020,CB2020,061,1,Manhattan,10118001000,1384,617,767,4.33
2020,CB2020,061,1,Manhattan,10118002000,1095,473,622,3.11
2020,CB2020,061,1,Manhattan,10118002001,344,146,198,1.14
2020,CB2020,061,1,Manhattan,10118003000,819,367,452,4.25
2020,CB2020,061,1,Manhattan,10118004000,904,388,516,4.49
2020,CB2020,061,1,Manhattan,10118004001,0,0,0,4.48
2020,CB2020,061,1,Manhattan,10118004002,1060,434,626,4.5
2020,CB2020,061,1,Manhattan,10118005000,836,346,490,4.47
2020,CB2020,061,1,Manhattan,10118006000,1536,683,853,4.51
2020,CB2020,061,1,Manhattan,10118007000,976,463,513,4.15
2020,CB2020,061,1,Manhattan,10118008000,734,360,374,4.26
2020,CB2020,061,1,Manhattan,10119001000,47,24,23,5.34
2020,CB2020,061,1,Manhattan,10119001001,14,8,6,5.24
2020,CB2020,061,1,Manhattan,10119001002,19,12,7,0.65
2020,CB2020,061,1,Manhattan,10119001003,553,425,128,4.91
2020,CB2020,061,1,Manhattan,10119001004,0,0,0,4.91
2020,CB2020,061,1,Manhattan,10119001005,0,0,0,0.87
2020,CB2020,061,1,Manhattan,10119002000,0,0,0,0.22
2020,CB2020,061,1,Manhattan,10119002001,10,7,3,5.18
2020,CB2020,061,1,Manhattan,10119002002,453,175,278,5.39
2020,CB2020,061,1,Manhattan,10119002003,570,395,175,5.36
2020,CB2020,061,1,Manhattan,10119002004,0,0,0,5.8
2020,CB2020,061,1,Manhattan,10120001000,373,142,231,2.2
2020,CB2020,061,1,Manhattan,10120001001,0,0,0,0.84
2020,CB2020,061,1,Manhattan,10120001002,475,232,243,3.09
2020,CB2020,061,1,Manhattan,10120002000,201,90,111,2.98
2020,CB2020,061,1,Manhattan,10120002001,345,151,194,3.04
2020,CB2020,061,1,Manhattan,10120002002,337,162,175,3.03
2020,CB2020,061,1,Manhattan,10120003000,211,97,114,3.07
2020,CB2020,061,1,Manhattan,10120003001,280,138,142,3.07
2020,CB2020,061,1,Manhattan,10120003002,257,113,144,3.06
2020,CB2020,061,1,Manhattan,10120004000,411,186,225,3.04
2020,CB2020,061,1,Manhattan,10120004001,205,102,103,3.07
2020,CB2020,061,1,Manhattan,10120004002,0,0,0,3.07
2020,CB2020,061,1,Manhattan,10120004003,0,0,0,1
2020,CB2020,061,1,Manhattan,10120004004,240,104,136,2.07
2020,CB2020,061,1,Manhattan,10120004005,53,13,40,3.07
2020,CB2020,061,1,Manhattan,10120004006,517,204,313,3.05
2020,CB2020,061,1,Manhattan,10121011000,333,200,133,5.39
2020,CB2020,061,1,Manhattan,10121011001,1232,659,573,5.8
2020,CB2020,061,1,Manhattan,10121012000,1248,745,503,5.43
2020,CB2020,061,1,Manhattan,10121012001,595,324,271,5.38
2020,CB2020,061,1,Manhattan,10121021000,845,497,348,5.39
2020,CB2020,061,1,Manhattan,10121021001,1280,630,650,1.44
2020,CB2020,061,1,Manhattan,10121022000,1289,630,659,4.35
2020,CB2020,061,1,Manhattan,10121023000,900,520,380,5.38
2020,CB2020,061,1,Manhattan,10121024000,922,580,342,5.46
2020,CB2020,061,1,Manhattan,10122001000,274,133,141,3.06
2020,CB2020,061,1,Manhattan,10122001001,41,26,15,0.83
2020,CB2020,061,1,Manhattan,10122001002,41,14,27,2.22
2020,CB2020,061,1,Manhattan,10122001003,159,69,90,3.05
2020,CB2020,061,1,Manhattan,10122001004,334,138,196,3.05
2020,CB2020,061,1,Manhattan,10122002000,370,160,210,3.04
2020,CB2020,061,1,Manhattan,10122002001,308,114,194,3.05
2020,CB2020,061,1,Manhattan,10122002002,217,116,101,3.05
2020,CB2020,061,1,Manhattan,10122003000,221,90,131,3.05
2020,CB2020,061,1,Manhattan,10122003001,34,25,9,3.04
2020,CB2020,061,1,Manhattan,10122003002,89,41,48,3.05
2020,CB2020,061,1,Manhattan,10122003003,159,70,89,3.04
2020,CB2020,061,1,Manhattan,10122004000,405,168,237,3.04
2020,CB2020,061,1,Manhattan,10122004001,364,152,212,3.01
2020,CB2020,061,1,Manhattan,10122004002,409,193,216,3.05
2020,CB2020,061,1,Manhattan,10124000001,0,0,0,0
2020,CB2020,061,1,Manhattan,10124001000,0,0,0,0.21
2020,CB2020,061,1,Manhattan,10124001001,413,160,253,4.62
2020,CB2020,061,1,Manhattan,10124001002,1408,593,815,4.33
2020,CB2020,061,1,Manhattan,10124001003,0,0,0,0.34
2020,CB2020,061,1,Manhattan,10124002000,1079,508,571,2.62
2020,CB2020,061,1,Manhattan,10124002001,656,246,410,2.03
2020,CB2020,061,1,Manhattan,10124003000,1692,743,949,4.68
2020,CB2020,061,1,Manhattan,10124004000,1738,827,911,4.25
2020,CB2020,061,1,Manhattan,10124005000,562,243,319,3.38
2020,CB2020,061,1,Manhattan,10124005001,311,151,160,0.89
2020,CB2020,061,1,Manhattan,10124006000,1614,727,887,4.83
2020,CB2020,061,1,Manhattan,10124006001,0,0,0,0.2
2020,CB2020,061,1,Manhattan,10124006002,0,0,0,0.26
2020,CB2020,061,1,Manhattan,10124007000,0,0,0,0.24
2020,CB2020,061,1,Manhattan,10124007001,754,309,445,4.69
2020,CB2020,061,1,Manhattan,10124007002,0,0,0,0.26
2020,CB2020,061,1,Manhattan,10124008000,0,0,0,0.24
2020,CB2020,061,1,Manhattan,10124008001,618,240,378,4.1
2020,CB2020,061,1,Manhattan,10124008002,0,0,0,0.23
2020,CB2020,061,1,Manhattan,10125001000,0,0,0,5.45
2020,CB2020,061,1,Manhattan,10125001001,81,47,34,5.32
2020,CB2020,061,1,Manhattan,10125001002,202,172,30,5.4
2020,CB2020,061,1,Manhattan,10125001003,182,101,81,5.37
2020,CB2020,061,1,Manhattan,10125002000,7,5,2,1.46
2020,CB2020,061,1,Manhattan,10125002001,845,398,447,3.96
2020,CB2020,061,1,Manhattan,10125002002,101,47,54,1.28
2020,CB2020,061,1,Manhattan,10125002003,0,0,0,1.02
2020,CB2020,061,1,Manhattan,10125002004,0,0,0,0.63
2020,CB2020,061,1,Manhattan,10125003000,690,343,347,4.06
2020,CB2020,061,1,Manhattan,10125004000,506,246,260,4.41
2020,CB2020,061,1,Manhattan,10125004001,287,145,142,4.68
2020,CB2020,061,1,Manhattan,10126011000,1539,687,852,4.9
2020,CB2020,061,1,Manhattan,10126012000,1250,551,699,4.55
2020,CB2020,061,1,Manhattan,10126013000,1302,563,739,4.49
2020,CB2020,061,1,Manhattan,10126014000,1137,461,676,3.25
2020,CB2020,061,1,Manhattan,10126014001,439,189,250,1.24
2020,CB2020,061,1,Manhattan,10126015000,1770,735,1035,4.88
2020,CB2020,061,1,Manhattan,10126021000,1131,504,627,4.31
2020,CB2020,061,1,Manhattan,10126021001,1268,477,791,4.63
2020,CB2020,061,1,Manhattan,10126022000,1230,495,735,4.65
2020,CB2020,061,1,Manhattan,10126023000,1295,560,735,4.23
2020,CB2020,061,1,Manhattan,10126024000,1476,625,851,4.25
2020,CB2020,061,1,Manhattan,10127001000,878,514,364,3.56
2020,CB2020,061,1,Manhattan,10127001001,305,147,158,1.82
2020,CB2020,061,1,Manhattan,10127002000,1033,561,472,5.42
2020,CB2020,061,1,Manhattan,10127002001,689,396,293,5.3
2020,CB2020,061,1,Manhattan,10127003000,698,438,260,5.38
2020,CB2020,061,1,Manhattan,10127003001,1129,638,491,5.33
2020,CB2020,061,1,Manhattan,10127004000,493,322,171,5.39
2020,CB2020,061,1,Manhattan,10127004001,738,444,294,3.32
2020,CB2020,061,1,Manhattan,10127004002,427,255,172,2.07
2020,CB2020,061,1,Manhattan,10127005000,892,499,393,5.4
2020,CB2020,061,1,Manhattan,10128001000,572,267,305,1.84
2020,CB2020,061,1,Manhattan,10128001001,310,110,200,1.24
2020,CB2020,061,1,Manhattan,10128001002,506,238,268,3.08
2020,CB2020,061,1,Manhattan,10128001003,676,331,345,3.07
2020,CB2020,061,1,Manhattan,10128002000,442,201,241,3.34
2020,CB2020,061,1,Manhattan,10128002001,374,173,201,3.03
2020,CB2020,061,1,Manhattan,10128003000,357,161,196,3.34
2020,CB2020,061,1,Manhattan,10128003001,560,243,317,3.33
2020,CB2020,061,1,Manhattan,10128003002,227,106,121,3.08
2020,CB2020,061,1,Manhattan,10128004000,20,8,12,3.11
2020,CB2020,061,1,Manhattan,10128004001,503,221,282,3.11
2020,CB2020,061,1,Manhattan,10128004002,420,205,215,3.11
2020,CB2020,061,1,Manhattan,10128004003,272,130,142,3.11
2020,CB2020,061,1,Manhattan,10128005000,619,277,342,3.07
2020,CB2020,061,1,Manhattan,10128005001,687,295,392,3.31
2020,CB2020,061,1,Manhattan,10129010001,0,0,0,0
2020,CB2020,061,1,Manhattan,10129010002,0,0,0,0
2020,CB2020,061,1,Manhattan,10129011000,817,427,390,1.5
2020,CB2020,061,1,Manhattan,10129011001,1692,876,816,4.31
2020,CB2020,061,1,Manhattan,10129012000,155,81,74,1.39
2020,CB2020,061,1,Manhattan,10129012001,206,106,100,4.03
2020,CB2020,061,1,Manhattan,10129012002,2049,1111,938,4.01
2020,CB2020,061,1,Manhattan,10129012003,32,21,11,1.41
2020,CB2020,061,1,Manhattan,10129012004,158,92,66,1.37
2020,CB2020,061,1,Manhattan,10129012005,689,360,329,4
2020,CB2020,061,1,Manhattan,10129012006,28,10,18,4.49
2020,CB2020,061,1,Manhattan,10129012007,2067,1107,960,5.31
2020,CB2020,061,1,Manhattan,10129013000,31,16,15,3.88
2020,CB2020,061,1,Manhattan,10129013001,35,23,12,3.93
2020,CB2020,061,1,Manhattan,10129014000,0,0,0,12.83
2020,CB2020,061,1,Manhattan,10129014001,0,0,0,0.8
2020,CB2020,061,1,Manhattan,10129014002,0,0,0,0.91
2020,CB2020,061,1,Manhattan,10129020001,0,0,0,0
2020,CB2020,061,1,Manhattan,10129020002,0,0,0,0
2020,CB2020,061,1,Manhattan,10129021000,1090,764,326,5.4
2020,CB2020,061,1,Manhattan,10129021001,468,298,170,4.03
2020,CB2020,061,1,Manhattan,10129021002,0,0,0,1.37
2020,CB2020,061,1,Manhattan,10129022000,0,0,0,3.9
2020,CB2020,061,1,Manhattan,10129022001,34,18,16,3.82
2020,CB2020,061,1,Manhattan,10129022002,21,10,11,3.87
2020,CB2020,061,1,Manhattan,10129022003,0,0,0,3.84
2020,CB2020,061,1,Manhattan,10129022004,438,286,152,4.04
2020,CB2020,061,1,Manhattan,10129022005,531,311,220,4.03
2020,CB2020,061,1,Manhattan,10129022006,201,119,82,1.36
2020,CB2020,061,1,Manhattan,10129022007,361,191,170,1.33
2020,CB2020,061,1,Manhattan,10129023000,0,0,0,12.74
2020,CB2020,061,1,Manhattan,10129023001,0,0,0,0.39
2020,CB2020,061,1,Manhattan,10129023002,0,0,0,0.41
2020,CB2020,061,1,Manhattan,10129023003,0,0,0,0.81
2020,CB2020,061,1,Manhattan,10130001000,243,108,135,2.19
2020,CB2020,061,1,Manhattan,10130001001,111,53,58,0.9
2020,CB2020,061,1,Manhattan,10130001002,326,138,188,3.1
2020,CB2020,061,1,Manhattan,10130001003,225,113,112,3.09
2020,CB2020,061,1,Manhattan,10130002000,315,110,205,3.09
2020,CB2020,061,1,Manhattan,10130002001,304,140,164,3.33
2020,CB2020,061,1,Manhattan,10130002002,332,141,191,3.33
2020,CB2020,061,1,Manhattan,10130002003,324,150,174,3.05
2020,CB2020,061,1,Manhattan,10130003000,301,145,156,3.08
2020,CB2020,061,1,Manhattan,10130003001,271,104,167,3.31
2020,CB2020,061,1,Manhattan,10130003002,314,134,180,3.32
2020,CB2020,061,1,Manhattan,10130003003,33,20,13,3.03
2020,CB2020,061,1,Manhattan,10130004000,151,81,70,3.07
2020,CB2020,061,1,Manhattan,10130004001,267,108,159,3.08
2020,CB2020,061,1,Manhattan,10130004002,394,188,206,3.07
2020,CB2020,061,1,Manhattan,10131001000,48,32,16,1.7
2020,CB2020,061,1,Manhattan,10131001001,981,529,452,3.71
2020,CB2020,061,1,Manhattan,10131001002,548,247,301,3.79
2020,CB2020,061,1,Manhattan,10131001003,341,160,181,3.86
2020,CB2020,061,1,Manhattan,10131001004,0,0,0,1.52
2020,CB2020,061,1,Manhattan,10131001005,317,136,181,1.59
2020,CB2020,061,1,Manhattan,10131002000,436,224,212,5.38
2020,CB2020,061,1,Manhattan,10131002001,157,86,71,5.37
2020,CB2020,061,1,Manhattan,10131002002,0,0,0,5.36
2020,CB2020,061,1,Manhattan,10131002003,360,183,177,5.37
2020,CB2020,061,1,Manhattan,10131003000,206,120,86,1.86
2020,CB2020,061,1,Manhattan,10131003001,568,289,279,3.51
2020,CB2020,061,1,Manhattan,10132010001,0,0,0,0
2020,CB2020,061,1,Manhattan,10132011000,942,412,530,4.33
2020,CB2020,061,1,Manhattan,10132012000,1174,491,683,4.34
2020,CB2020,061,1,Manhattan,10132013000,0,0,0,0.23
2020,CB2020,061,1,Manhattan,10132013001,809,380,429,4.78
2020,CB2020,061,1,Manhattan,10132013002,221,82,139,4.68
2020,CB2020,061,1,Manhattan,10132013003,0,0,0,0.21
2020,CB2020,061,1,Manhattan,10132013004,0,0,0,0.71
2020,CB2020,061,1,Manhattan,10132021000,0,0,0,0.82
2020,CB2020,061,1,Manhattan,10132021001,0,0,0,0.4
2020,CB2020,061,1,Manhattan,10132021002,1814,840,974,6.96
2020,CB2020,061,1,Manhattan,10132021003,609,270,339,2.8
2020,CB2020,061,1,Manhattan,10132022000,1087,447,640,2.93
2020,CB2020,061,1,Manhattan,10132023000,727,287,440,2.6
2020,CB2020,061,1,Manhattan,10132023001,0,0,0,0.21
2020,CB2020,061,1,Manhattan,10132023002,0,0,0,0.29
2020,CB2020,061,1,Manhattan,10132031000,974,427,547,4.33
2020,CB2020,061,1,Manhattan,10132032000,1688,708,980,4.66
2020,CB2020,061,1,Manhattan,10132033000,829,326,503,2.81
2020,CB2020,061,1,Manhattan,10132033001,256,134,122,1.52
2020,CB2020,061,1,Manhattan,10133001000,758,433,325,2.93
2020,CB2020,061,1,Manhattan,10133002000,868,495,373,5.4
2020,CB2020,061,1,Manhattan,10133002001,724,402,322,2.45
2020,CB2020,061,1,Manhattan,10133003000,923,503,420,5.39
2020,CB2020,061,1,Manhattan,10133003001,811,500,311,5.38
2020,CB2020,061,1,Manhattan,10133004000,757,396,361,5.39
2020,CB2020,061,1,Manhattan,10133004001,680,346,334,5.39
2020,CB2020,061,1,Manhattan,10133005000,463,228,235,5.36
2020,CB2020,061,1,Manhattan,10133005001,798,425,373,5.39
2020,CB2020,061,1,Manhattan,10134001000,1090,464,626,4.3
2020,CB2020,061,1,Manhattan,10134002000,359,152,207,2.95
2020,CB2020,061,1,Manhattan,10134002001,526,229,297,1.34
2020,CB2020,061,1,Manhattan,10134003000,1796,814,982,4.9
2020,CB2020,061,1,Manhattan,10134004000,1086,479,607,4.64
2020,CB2020,061,1,Manhattan,10134005000,580,236,344,2.32
2020,CB2020,061,1,Manhattan,10134005001,619,293,326,2.23
2020,CB2020,061,1,Manhattan,10134006000,503,205,298,4.3
2020,CB2020,061,1,Manhattan,10134006001,935,397,538,4.3
2020,CB2020,061,1,Manhattan,10134007000,654,265,389,1.36
2020,CB2020,061,1,Manhattan,10134007001,807,312,495,3.18
2020,CB2020,061,1,Manhattan,10134008000,1876,893,983,4.55
2020,CB2020,061,1,Manhattan,10134009000,1051,432,619,4.54
2020,CB2020,061,1,Manhattan,10135010001,0,0,0,0
2020,CB2020,061,1,Manhattan,10135010002,0,0,0,0
2020,CB2020,061,1,Manhattan,10135011000,1076,499,577,4.31
2020,CB2020,061,1,Manhattan,10135011001,73,36,37,3.91
2020,CB2020,061,1,Manhattan,10135011002,0,0,0,3.82
2020,CB2020,061,1,Manhattan,10135011003,30,19,11,4.3
2020,CB2020,061,1,Manhattan,10135011004,742,346,396,1.08
2020,CB2020,061,1,Manhattan,10135012000,1963,1060,903,5.39
2020,CB2020,061,1,Manhattan,10135012001,152,72,80,1.08
2020,CB2020,061,1,Manhattan,10135013000,0,0,0,1.41
2020,CB2020,061,1,Manhattan,10135013001,1458,784,674,3.98
2020,CB2020,061,1,Manhattan,10135013002,10,6,4,7.74
2020,CB2020,061,1,Manhattan,10135014000,0,0,0,0.82
2020,CB2020,061,1,Manhattan,10135014001,0,0,0,11.03
2020,CB2020,061,1,Manhattan,10135014002,0,0,0,0.42
2020,CB2020,061,1,Manhattan,10135014003,0,0,0,0.39
2020,CB2020,061,1,Manhattan,10135020001,0,0,0,0
2020,CB2020,061,1,Manhattan,10135020002,0,0,0,0
2020,CB2020,061,1,Manhattan,10135021000,576,273,303,1.68
2020,CB2020,061,1,Manhattan,10135021001,892,414,478,3.7
2020,CB2020,061,1,Manhattan,10135022000,171,97,74,5.82
2020,CB2020,061,1,Manhattan,10135022001,107,77,30,5.8
2020,CB2020,061,1,Manhattan,10135022002,0,0,0,3.16
2020,CB2020,061,1,Manhattan,10135022003,1034,471,563,2.24
2020,CB2020,061,1,Manhattan,10135023000,1931,925,1006,5.85
2020,CB2020,061,1,Manhattan,10135023001,1620,795,825,5.46
2020,CB2020,061,1,Manhattan,10135024000,0,0,0,4.44
2020,CB2020,061,1,Manhattan,10135024001,27,11,16,3.97
2020,CB2020,061,1,Manhattan,10135025000,0,0,0,1.34
2020,CB2020,061,1,Manhattan,10135025001,0,0,0,12.83
2020,CB2020,061,1,Manhattan,10135025002,0,0,0,0.48
2020,CB2020,061,1,Manhattan,10135025003,0,0,0,0.39
2020,CB2020,061,1,Manhattan,10136010001,0,0,0,0
2020,CB2020,061,1,Manhattan,10136011000,0,0,0,0.87
2020,CB2020,061,1,Manhattan,10136011001,0,0,0,0.37
2020,CB2020,061,1,Manhattan,10136011002,601,269,332,2.35
2020,CB2020,061,1,Manhattan,10136011003,1092,465,627,3.31
2020,CB2020,061,1,Manhattan,10136011004,269,113,156,1.94
2020,CB2020,061,1,Manhattan,10136011005,0,0,0,0.44
2020,CB2020,061,1,Manhattan,10136021000,1854,841,1013,4.87
2020,CB2020,061,1,Manhattan,10136022000,890,397,493,3.5
2020,CB2020,061,1,Manhattan,10136022001,650,277,373,1.04
2020,CB2020,061,1,Manhattan,10136023000,1386,621,765,2.87
2020,CB2020,061,1,Manhattan,10136023001,290,157,133,1.65
2020,CB2020,061,1,Manhattan,10136031000,1091,467,624,4.65
2020,CB2020,061,1,Manhattan,10136032000,1626,702,924,4.33
2020,CB2020,061,1,Manhattan,10136033000,411,174,237,2.1
2020,CB2020,061,1,Manhattan,10136033001,1259,561,698,2.22
2020,CB2020,061,1,Manhattan,10136041000,1140,480,660,4.32
2020,CB2020,061,1,Manhattan,10136042000,1271,529,742,4.54
2020,CB2020,061,1,Manhattan,10136043000,1251,544,707,4.33
2020,CB2020,061,1,Manhattan,10136044000,1395,607,788,4.52
2020,CB2020,061,1,Manhattan,10137001000,1170,507,663,5.77
2020,CB2020,061,1,Manhattan,10137002000,764,357,407,5.8
2020,CB2020,061,1,Manhattan,10137002001,647,332,315,5.83
2020,CB2020,061,1,Manhattan,10137003000,1273,602,671,5.35
2020,CB2020,061,1,Manhattan,10137003001,509,331,178,5.4
2020,CB2020,061,1,Manhattan,10137004000,933,435,498,4.75
2020,CB2020,061,1,Manhattan,10137004001,16,4,12,0.66
2020,CB2020,061,1,Manhattan,10137004002,25,17,8,1.74
2020,CB2020,061,1,Manhattan,10137004003,256,123,133,4.06
2020,CB2020,061,1,Manhattan,10137005000,538,254,284,3.36
2020,CB2020,061,1,Manhattan,10137005001,484,256,228,2.46
2020,CB2020,061,1,Manhattan,10137006000,0,0,0,2.55
2020,CB2020,061,1,Manhattan,10137006001,214,120,94,2.84
2020,CB2020,061,1,Manhattan,10137006002,338,164,174,3.23
2020,CB2020,061,1,Manhattan,10137006003,141,77,64,2.14
2020,CB2020,061,1,Manhattan,10138001000,970,414,556,4.32
2020,CB2020,061,1,Manhattan,10138002000,1594,655,939,4.31
2020,CB2020,061,1,Manhattan,10138003000,516,253,263,2.69
2020,CB2020,061,1,Manhattan,10138003001,642,282,360,1.62
2020,CB2020,061,1,Manhattan,10138004000,698,281,417,4.54
2020,CB2020,061,1,Manhattan,10138004001,722,293,429,4.29
2020,CB2020,061,1,Manhattan,10138005000,1331,616,715,4.55
2020,CB2020,061,1,Manhattan,10138006000,1631,720,911,4.55
2020,CB2020,061,1,Manhattan,10138007000,381,196,185,2.11
2020,CB2020,061,1,Manhattan,10138007001,849,363,486,2.45
2020,CB2020,061,1,Manhattan,10138008000,1978,850,1128,4.9
2020,CB2020,061,1,Manhattan,10138009000,1797,759,1038,4.64
2020,CB2020,061,1,Manhattan,10139001000,1648,888,760,5.84
2020,CB2020,061,1,Manhattan,10139002000,1342,847,495,5.81
2020,CB2020,061,1,Manhattan,10139003000,536,289,247,5.38
2020,CB2020,061,1,Manhattan,10139003001,806,460,346,5.42
2020,CB2020,061,1,Manhattan,10139004000,985,528,457,2.97
2020,CB2020,061,1,Manhattan,10139004001,202,91,111,1.34
2020,CB2020,061,1,Manhattan,10139004002,283,141,142,1.1
2020,CB2020,061,1,Manhattan,10139005000,1462,752,710,5.38
2020,CB2020,061,1,Manhattan,10139006000,1316,606,710,5.78
2020,CB2020,061,1,Manhattan,10139007000,1408,654,754,5.86
2020,CB2020,061,1,Manhattan,10140001000,1063,429,634,3.08
2020,CB2020,061,1,Manhattan,10140001001,534,288,246,3.07
2020,CB2020,061,1,Manhattan,10140002000,855,385,470,3.08
2020,CB2020,061,1,Manhattan,10140002001,385,174,211,3.07
2020,CB2020,061,1,Manhattan,10140002002,751,333,418,3.31
2020,CB2020,061,1,Manhattan,10140003000,630,275,355,3.31
2020,CB2020,061,1,Manhattan,10140003001,468,218,250,3.08
2020,CB2020,061,1,Manhattan,10140004000,445,212,233,3.35
2020,CB2020,061,1,Manhattan,10140004001,268,131,137,3.11
2020,CB2020,061,1,Manhattan,10140005000,470,237,233,3.11
2020,CB2020,061,1,Manhattan,10140005001,412,181,231,1.54
2020,CB2020,061,1,Manhattan,10140005002,243,112,131,1.57
2020,CB2020,061,1,Manhattan,10140005003,325,162,163,3.34
2020,CB2020,061,1,Manhattan,10140006000,587,266,321,3.11
2020,CB2020,061,1,Manhattan,10140006001,614,285,329,3.11
2020,CB2020,061,1,Manhattan,10142001000,148,77,71,3.1
2020,CB2020,061,1,Manhattan,10142001001,374,179,195,3.09
2020,CB2020,061,1,Manhattan,10142002000,218,83,135,3.1
2020,CB2020,061,1,Manhattan,10142002001,338,179,159,2.11
2020,CB2020,061,1,Manhattan,10142002002,117,68,49,0.98
2020,CB2020,061,1,Manhattan,10142002003,409,180,229,3.33
2020,CB2020,061,1,Manhattan,10142003000,373,171,202,3.33
2020,CB2020,061,1,Manhattan,10142003001,429,183,246,3.1
2020,CB2020,061,1,Manhattan,10142004000,319,134,185,3.31
2020,CB2020,061,1,Manhattan,10142004001,63,28,35,3.32
2020,CB2020,061,1,Manhattan,10142004002,171,79,92,3.07
2020,CB2020,061,1,Manhattan,10142005000,237,105,132,3.08
2020,CB2020,061,1,Manhattan,10142005001,212,109,103,2.02
2020,CB2020,061,1,Manhattan,10142005002,183,80,103,1.05
2020,CB2020,061,1,Manhattan,10142006000,420,199,221,3.14
2020,CB2020,061,1,Manhattan,10142006001,452,188,264,3.08
2020,CB2020,061,1,Manhattan,10143001000,0,0,0,0.28
2020,CB2020,061,1,Manhattan,10143001001,5,5,0,66.56
2020,CB2020,061,1,Manhattan,10143001002,0,0,0,27.17
2020,CB2020,061,1,Manhattan,10143001003,29,28,1,51.59
2020,CB2020,061,1,Manhattan,10143001004,0,0,0,0.2
2020,CB2020,061,1,Manhattan,10143001005,0,0,0,1.72
2020,CB2020,061,1,Manhattan,10143001006,0,0,0,12.08
2020,CB2020,061,1,Manhattan,10143001007,62,55,7,55.76
2020,CB2020,061,1,Manhattan,10143001008,0,0,0,54.05
2020,CB2020,061,1,Manhattan,10143001009,0,0,0,12.99
2020,CB2020,061,1,Manhattan,10143001010,0,0,0,63
2020,CB2020,061,1,Manhattan,10143001011,7,5,2,23.77
2020,CB2020,061,1,Manhattan,10143001012,0,0,0,8.26
2020,CB2020,061,1,Manhattan,10143001013,0,0,0,15.07
2020,CB2020,061,1,Manhattan,10143001014,0,0,0,1.87
2020,CB2020,061,1,Manhattan,10143001015,0,0,0,26.62
2020,CB2020,061,1,Manhattan,10143001016,0,0,0,1.75
2020,CB2020,061,1,Manhattan,10143001017,0,0,0,56.94
2020,CB2020,061,1,Manhattan,10143001018,0,0,0,16.53
2020,CB2020,061,1,Manhattan,10143001019,0,0,0,29.32
2020,CB2020,061,1,Manhattan,10143001020,0,0,0,23.87
2020,CB2020,061,1,Manhattan,10143001021,0,0,0,8.64
2020,CB2020,061,1,Manhattan,10143001022,0,0,0,34.76
2020,CB2020,061,1,Manhattan,10143001023,0,0,0,6.3
2020,CB2020,061,1,Manhattan,10143001024,0,0,0,14.5
2020,CB2020,061,1,Manhattan,10143001025,0,0,0,1.23
2020,CB2020,061,1,Manhattan,10143001026,15,12,3,22.29
2020,CB2020,061,1,Manhattan,10143001027,0,0,0,32.22
2020,CB2020,061,1,Manhattan,10143001028,0,0,0,27.55
2020,CB2020,061,1,Manhattan,10143001029,0,0,0,2.21
2020,CB2020,061,1,Manhattan,10143001030,0,0,0,22.33
2020,CB2020,061,1,Manhattan,10143001031,0,0,0,1.2
2020,CB2020,061,1,Manhattan,10143001032,11,7,4,14.76
2020,CB2020,061,1,Manhattan,10143001033,0,0,0,2
2020,CB2020,061,1,Manhattan,10144011000,1042,473,569,4.88
2020,CB2020,061,1,Manhattan,10144012000,1659,738,921,4.65
2020,CB2020,061,1,Manhattan,10144013000,1210,534,676,4.51
2020,CB2020,061,1,Manhattan,10144014000,1129,464,665,4.33
2020,CB2020,061,1,Manhattan,10144021000,1296,559,737,4.62
2020,CB2020,061,1,Manhattan,10144022000,859,361,498,4.28
2020,CB2020,061,1,Manhattan,10144023000,1617,708,909,4.28
2020,CB2020,061,1,Manhattan,10144024000,73,30,43,0.85
2020,CB2020,061,1,Manhattan,10144024001,271,119,152,1.78
2020,CB2020,061,1,Manhattan,10144024002,607,281,326,2.18
2020,CB2020,061,1,Manhattan,10144025000,1329,607,722,4.47
2020,CB2020,061,1,Manhattan,10144026000,1073,476,597,4.47
2020,CB2020,061,1,Manhattan,10144027000,0,0,0,2.14
2020,CB2020,061,1,Manhattan,10144027001,0,0,0,1.3
2020,CB2020,061,1,Manhattan,10144027002,26,12,14,13.34
2020,CB2020,061,1,Manhattan,10145001000,1716,614,1102,8.9
2020,CB2020,061,1,Manhattan,10145001001,979,464,515,1.78
2020,CB2020,061,1,Manhattan,10145001002,972,493,479,5.45
2020,CB2020,061,1,Manhattan,10145002000,1158,538,620,5.36
2020,CB2020,061,1,Manhattan,10145003000,313,136,177,2.11
2020,CB2020,061,1,Manhattan,10145003001,423,173,250,2.17
2020,CB2020,061,1,Manhattan,10145003002,167,96,71,5.23
2020,CB2020,061,1,Manhattan,10145004000,745,382,363,3.82
2020,CB2020,061,1,Manhattan,10145004001,213,81,132,2.06
2020,CB2020,061,1,Manhattan,10145004002,0,0,0,1.4
2020,CB2020,061,1,Manhattan,10145005000,290,131,159,2.55
2020,CB2020,061,1,Manhattan,10145005001,556,258,298,2.9
2020,CB2020,061,1,Manhattan,10146011000,1195,557,638,4.63
2020,CB2020,061,1,Manhattan,10146012000,867,380,487,4.89
2020,CB2020,061,1,Manhattan,10146013000,916,395,521,4.31
2020,CB2020,061,1,Manhattan,10146014000,1503,660,843,4.54
2020,CB2020,061,1,Manhattan,10146021000,1730,783,947,4.27
2020,CB2020,061,1,Manhattan,10146022000,1102,474,628,2.8
2020,CB2020,061,1,Manhattan,10146022001,650,298,352,1.79
2020,CB2020,061,1,Manhattan,10146023000,1283,576,707,4.5
2020,CB2020,061,1,Manhattan,10146024000,1310,586,724,4.27
2020,CB2020,061,1,Manhattan,10146025000,1020,446,574,4.5
2020,CB2020,061,1,Manhattan,10146026000,1782,769,1013,3.25
2020,CB2020,061,1,Manhattan,10146026001,184,99,85,1.61
2020,CB2020,061,1,Manhattan,10147001000,1132,572,560,5.34
2020,CB2020,061,1,Manhattan,10147002000,12,5,7,5.37
2020,CB2020,061,1,Manhattan,10147003000,1843,906,937,5.46
2020,CB2020,061,1,Manhattan,10148011000,1021,463,558,3.08
2020,CB2020,061,1,Manhattan,10148011001,525,217,308,3.11
2020,CB2020,061,1,Manhattan,10148012000,1136,512,624,3.31
2020,CB2020,061,1,Manhattan,10148012001,539,237,302,3.35
2020,CB2020,061,1,Manhattan,10148021000,902,411,491,3.02
2020,CB2020,061,1,Manhattan,10148021001,830,375,455,3.04
2020,CB2020,061,1,Manhattan,10148022000,527,226,301,3.04
2020,CB2020,061,1,Manhattan,10148022001,601,274,327,3.05
2020,CB2020,061,1,Manhattan,10148022002,690,326,364,1.1
2020,CB2020,061,1,Manhattan,10148022003,52,30,22,2.17
2020,CB2020,061,1,Manhattan,10148023000,632,298,334,3.08
2020,CB2020,061,1,Manhattan,10148023001,1004,466,538,3.08
2020,CB2020,061,1,Manhattan,10148024000,678,255,423,3.07
2020,CB2020,061,1,Manhattan,10148024001,741,360,381,3.07
2020,CB2020,061,1,Manhattan,10148025000,837,368,469,3.31
2020,CB2020,061,1,Manhattan,10149001000,5,2,3,0.74
2020,CB2020,061,1,Manhattan,10149001001,397,163,234,4.15
2020,CB2020,061,1,Manhattan,10149001002,510,234,276,0.59
2020,CB2020,061,1,Manhattan,10149001003,11,10,1,15.54
2020,CB2020,061,1,Manhattan,10149001004,334,152,182,2.07
2020,CB2020,061,1,Manhattan,10149002000,1088,514,574,5.47
2020,CB2020,061,1,Manhattan,10149003000,1207,534,673,5.54
2020,CB2020,061,1,Manhattan,10149004000,1189,550,639,4.31
2020,CB2020,061,1,Manhattan,10149004001,0,0,0,1.16
2020,CB2020,061,1,Manhattan,10149005000,1610,740,870,3.43
2020,CB2020,061,1,Manhattan,10150011000,799,354,445,3.33
2020,CB2020,061,1,Manhattan,10150011001,329,150,179,3.09
2020,CB2020,061,1,Manhattan,10150012000,767,363,404,3.32
2020,CB2020,061,1,Manhattan,10150012001,426,170,256,3.02
2020,CB2020,061,1,Manhattan,10150021000,484,248,236,3.06
2020,CB2020,061,1,Manhattan,10150021001,733,334,399,3.06
2020,CB2020,061,1,Manhattan,10150021002,898,381,517,3.07
2020,CB2020,061,1,Manhattan,10150022000,713,290,423,3.06
2020,CB2020,061,1,Manhattan,10150022001,70,40,30,0.93
2020,CB2020,061,1,Manhattan,10150022002,531,251,280,2.37
2020,CB2020,061,1,Manhattan,10150023000,659,296,363,3.03
2020,CB2020,061,1,Manhattan,10150023001,734,328,406,3.29
2020,CB2020,061,1,Manhattan,10150024000,142,53,89,3.05
2020,CB2020,061,1,Manhattan,10150024001,352,164,188,3.05
2020,CB2020,061,1,Manhattan,10150024002,326,152,174,3.07
2020,CB2020,061,1,Manhattan,10151011000,1170,460,710,5.39
2020,CB2020,061,1,Manhattan,10151012000,1810,711,1099,10.69
2020,CB2020,061,1,Manhattan,10151013000,0,0,0,5.57
2020,CB2020,061,1,Manhattan,10151013001,776,320,456,5.44
2020,CB2020,061,1,Manhattan,10151020001,0,0,0,0
2020,CB2020,061,1,Manhattan,10151021000,591,266,325,5.03
2020,CB2020,061,1,Manhattan,10151021001,906,425,481,2.94
2020,CB2020,061,1,Manhattan,10151022000,554,262,292,4.18
2020,CB2020,061,1,Manhattan,10151022001,936,461,475,2.35
2020,CB2020,061,1,Manhattan,10151022002,1049,482,567,2.76
2020,CB2020,061,1,Manhattan,10151022003,889,406,483,2.96
2020,CB2020,061,1,Manhattan,10151022004,1374,626,748,1.4
2020,CB2020,061,1,Manhattan,10151023000,1931,917,1014,17.05
2020,CB2020,061,1,Manhattan,10151023001,0,0,0,2.23
2020,CB2020,061,1,Manhattan,10151023002,11,6,5,7.29
2020,CB2020,061,1,Manhattan,10151023003,0,0,0,1.55
2020,CB2020,061,1,Manhattan,10151024000,13,10,3,5.47
2020,CB2020,061,1,Manhattan,10152000001,0,0,0,0
2020,CB2020,061,1,Manhattan,10152001000,1360,544,816,6.14
2020,CB2020,061,1,Manhattan,10152002000,1532,662,870,4.03
2020,CB2020,061,1,Manhattan,10152003000,1228,579,649,4.18
2020,CB2020,061,1,Manhattan,10152004000,1148,506,642,4.39
2020,CB2020,061,1,Manhattan,10152005000,1383,619,764,4.29
2020,CB2020,061,1,Manhattan,10152006000,0,0,0,1.61
2020,CB2020,061,1,Manhattan,10152006001,0,0,0,1.35
2020,CB2020,061,1,Manhattan,10152006002,0,0,0,0.49
2020,CB2020,061,1,Manhattan,10152006003,0,0,0,4.62
2020,CB2020,061,1,Manhattan,10152006004,12,7,5,6.37
2020,CB2020,061,1,Manhattan,10152006005,1067,460,607,4.44
2020,CB2020,061,1,Manhattan,10152007000,0,0,0,4.88
2020,CB2020,061,1,Manhattan,10153011000,1211,568,643,5.38
2020,CB2020,061,1,Manhattan,10153012000,969,441,528,5.39
2020,CB2020,061,1,Manhattan,10153013000,1099,505,594,5.36
2020,CB2020,061,1,Manhattan,10153013001,405,174,231,5.32
2020,CB2020,061,1,Manhattan,10153021000,897,399,498,4.06
2020,CB2020,061,1,Manhattan,10153021001,298,146,152,1.31
2020,CB2020,061,1,Manhattan,10153022000,623,299,324,2.5
2020,CB2020,061,1,Manhattan,10153022001,459,186,273,1.23
2020,CB2020,061,1,Manhattan,10153023000,1050,514,536,2.97
2020,CB2020,061,1,Manhattan,10153024000,792,333,459,3.27
2020,CB2020,061,1,Manhattan,10153025000,1142,500,642,2.13
2020,CB2020,061,1,Manhattan,10153026000,413,195,218,2.47
2020,CB2020,061,1,Manhattan,10153026001,358,190,168,1.64
2020,CB2020,061,1,Manhattan,10154011000,1278,565,713,4.27
2020,CB2020,061,1,Manhattan,10154012000,1398,623,775,4.5
2020,CB2020,061,1,Manhattan,10154013000,1116,529,587,4.25
2020,CB2020,061,1,Manhattan,10154014000,1397,612,785,4.51
2020,CB2020,061,1,Manhattan,10154021000,1469,682,787,4.5
2020,CB2020,061,1,Manhattan,10154022000,1100,518,582,4.51
2020,CB2020,061,1,Manhattan,10154023000,1934,902,1032,4.5
2020,CB2020,061,1,Manhattan,10154031000,1772,753,1019,4.26
2020,CB2020,061,1,Manhattan,10154032000,1021,381,640,1.64
2020,CB2020,061,1,Manhattan,10154033000,1535,699,836,4.26
2020,CB2020,061,1,Manhattan,10154034000,1410,634,776,2.62
2020,CB2020,061,1,Manhattan,10155011000,5091,2189,2902,21.27
2020,CB2020,061,1,Manhattan,10155020001,0,0,0,0
2020,CB2020,061,1,Manhattan,10155021000,0,0,0,1
2020,CB2020,061,1,Manhattan,10155021001,0,0,0,2.08
2020,CB2020,061,1,Manhattan,10155021002,799,380,419,1.63
2020,CB2020,061,1,Manhattan,10155021003,926,435,491,1.62
2020,CB2020,061,1,Manhattan,10155021004,0,0,0,4.64
2020,CB2020,061,1,Manhattan,10155022000,0,0,0,1.25
2020,CB2020,061,1,Manhattan,10155022001,1432,666,766,1.73
2020,CB2020,061,1,Manhattan,10155022002,0,0,0,3.09
2020,CB2020,061,1,Manhattan,10155023000,758,303,455,1.78
2020,CB2020,061,1,Manhattan,10155024000,1127,454,673,6.57
2020,CB2020,061,1,Manhattan,10155025000,717,320,397,2.12
2020,CB2020,061,1,Manhattan,10156011000,1142,505,637,4.82
2020,CB2020,061,1,Manhattan,10156012000,801,367,434,4.49
2020,CB2020,061,1,Manhattan,10156013000,0,0,0,0.83
2020,CB2020,061,1,Manhattan,10156013001,861,412,449,4.25
2020,CB2020,061,1,Manhattan,10156014000,2764,1171,1593,3.78
2020,CB2020,061,1,Manhattan,10156021000,10,5,5,8.88
2020,CB2020,061,1,Manhattan,10156021001,949,407,542,8.35
2020,CB2020,061,1,Manhattan,10156021002,1190,535,655,4.71
2020,CB2020,061,1,Manhattan,10156021003,5,4,1,4.93
2020,CB2020,061,1,Manhattan,10157001000,1099,524,575,5.44
2020,CB2020,061,1,Manhattan,10157002000,177,82,95,1.41
2020,CB2020,061,1,Manhattan,10157002001,1566,714,852,4.46
2020,CB2020,061,1,Manhattan,10157003000,1833,838,995,5.85
2020,CB2020,061,1,Manhattan,10157004000,844,392,452,5.36
2020,CB2020,061,1,Manhattan,10157005000,1249,566,683,5.45
2020,CB2020,061,1,Manhattan,10157006000,1210,598,612,5.87
2020,CB2020,061,1,Manhattan,10157007000,1451,701,750,5.81
2020,CB2020,061,1,Manhattan,10157007001,20,7,13,0.03
2020,CB2020,061,1,Manhattan,10157008000,1748,724,1024,4.85
2020,CB2020,061,1,Manhattan,10157008001,0,0,0,0.55
2020,CB2020,061,1,Manhattan,10158011000,124,56,68,3.28
2020,CB2020,061,1,Manhattan,10158011001,757,368,389,3.04
2020,CB2020,061,1,Manhattan,10158011002,724,318,406,3.05
2020,CB2020,061,1,Manhattan,10158012000,599,261,338,3.05
2020,CB2020,061,1,Manhattan,10158012001,692,271,421,3.04
2020,CB2020,061,1,Manhattan,10158013000,636,269,367,3.08
2020,CB2020,061,1,Manhattan,10158013001,585,260,325,3.07
2020,CB2020,061,1,Manhattan,10158013002,328,163,165,3.08
2020,CB2020,061,1,Manhattan,10158014000,721,341,380,3.32
2020,CB2020,061,1,Manhattan,10158014001,434,178,256,3.07
2020,CB2020,061,1,Manhattan,10158021000,1001,326,675,0.88
2020,CB2020,061,1,Manhattan,10158021001,318,134,184,2.14
2020,CB2020,061,1,Manhattan,10158021002,822,398,424,3.1
2020,CB2020,061,1,Manhattan,10158022000,607,265,342,1.93
2020,CB2020,061,1,Manhattan,10158022001,351,158,193,1.38
2020,CB2020,061,1,Manhattan,10158023000,933,414,519,1.37
2020,CB2020,061,1,Manhattan,10158023001,333,147,186,1.1
2020,CB2020,061,1,Manhattan,10158023002,151,102,49,0.82
2020,CB2020,061,1,Manhattan,10159000001,0,0,0,0
2020,CB2020,061,1,Manhattan,10159001000,886,388,498,2.83
2020,CB2020,061,1,Manhattan,10159001001,752,368,384,2.69
2020,CB2020,061,1,Manhattan,10159002000,0,0,0,0.87
2020,CB2020,061,1,Manhattan,10159002001,304,156,148,1.1
2020,CB2020,061,1,Manhattan,10159002002,1167,533,634,4.02
2020,CB2020,061,1,Manhattan,10159003000,0,0,0,2.73
2020,CB2020,061,1,Manhattan,10159003001,0,0,0,0.48
2020,CB2020,061,1,Manhattan,10159003002,0,0,0,0.8
2020,CB2020,061,1,Manhattan,10159003003,814,406,408,1.59
2020,CB2020,061,1,Manhattan,10159003004,893,387,506,3.43
2020,CB2020,061,1,Manhattan,10159004000,113,57,56,1.38
2020,CB2020,061,1,Manhattan,10159004001,604,292,312,1.81
2020,CB2020,061,1,Manhattan,10159004002,584,244,340,2.27
2020,CB2020,061,1,Manhattan,10159005000,15,11,4,0.99
2020,CB2020,061,1,Manhattan,10159005001,1271,598,673,4.87
2020,CB2020,061,1,Manhattan,10159006000,0,0,0,0.28
2020,CB2020,061,1,Manhattan,10159006001,1050,474,576,5.63
2020,CB2020,061,1,Manhattan,10159007000,1601,732,869,5.49
2020,CB2020,061,1,Manhattan,10160011000,897,416,481,3.29
2020,CB2020,061,1,Manhattan,10160011001,0,0,0,3.06
2020,CB2020,061,1,Manhattan,10160012000,620,277,343,3.06
2020,CB2020,061,1,Manhattan,10160012001,301,143,158,3.06
2020,CB2020,061,1,Manhattan,10160012002,277,126,151,3.06
2020,CB2020,061,1,Manhattan,10160013000,309,150,159,3.02
2020,CB2020,061,1,Manhattan,10160013001,263,130,133,3.08
2020,CB2020,061,1,Manhattan,10160013002,189,72,117,3.05
2020,CB2020,061,1,Manhattan,10160014000,599,275,324,3.32
2020,CB2020,061,1,Manhattan,10160014001,397,185,212,3.03
2020,CB2020,061,1,Manhattan,10160021000,848,415,433,3.29
2020,CB2020,061,1,Manhattan,10160021001,871,366,505,3.29
2020,CB2020,061,1,Manhattan,10160022000,871,418,453,1
2020,CB2020,061,1,Manhattan,10160022001,455,205,250,2.07
2020,CB2020,061,1,Manhattan,10160022002,562,247,315,3.05
2020,CB2020,061,1,Manhattan,10161001000,513,271,242,5.34
2020,CB2020,061,1,Manhattan,10161001001,302,126,176,2.15
2020,CB2020,061,1,Manhattan,10161001002,393,182,211,3.44
2020,CB2020,061,1,Manhattan,10161002000,758,340,418,3.84
2020,CB2020,061,1,Manhattan,10161002001,267,124,143,1.87
2020,CB2020,061,1,Manhattan,10161003000,973,453,520,5.46
2020,CB2020,061,1,Manhattan,10161004000,1021,492,529,5.45
2020,CB2020,061,1,Manhattan,10161005000,1232,579,653,5.46
2020,CB2020,061,1,Manhattan,10161006000,1158,544,614,5.46
2020,CB2020,061,1,Manhattan,10162000001,0,0,0,0
2020,CB2020,061,1,Manhattan,10162000002,0,0,0,0
2020,CB2020,061,1,Manhattan,10162000003,0,0,0,0
2020,CB2020,061,1,Manhattan,10162001000,723,318,405,2.43
2020,CB2020,061,1,Manhattan,10162001001,0,0,0,1.82
2020,CB2020,061,1,Manhattan,10162001002,949,412,537,4.06
2020,CB2020,061,1,Manhattan,10162002000,1623,696,927,7.84
2020,CB2020,061,1,Manhattan,10162003000,41,23,18,5.04
2020,CB2020,061,1,Manhattan,10162003001,1346,570,776,4.68
2020,CB2020,061,1,Manhattan,10162004000,0,0,0,0.54
2020,CB2020,061,1,Manhattan,10162004001,2640,1081,1559,13.71
2020,CB2020,061,1,Manhattan,10162005000,0,0,0,2.2
2020,CB2020,061,1,Manhattan,10162005001,0,0,0,3.11
2020,CB2020,061,1,Manhattan,10162005002,0,0,0,2.75
2020,CB2020,061,1,Manhattan,10162005003,0,0,0,1.45
2020,CB2020,061,1,Manhattan,10162005004,0,0,0,1.38
2020,CB2020,061,1,Manhattan,10162005005,0,0,0,3.09
2020,CB2020,061,1,Manhattan,10162005006,1559,630,929,8.02
2020,CB2020,061,1,Manhattan,10162005007,152,52,100,3.69
2020,CB2020,061,1,Manhattan,10162005008,0,0,0,1.4
2020,CB2020,061,1,Manhattan,10163000001,0,0,0,0
2020,CB2020,061,1,Manhattan,10163001000,0,0,0,15.67
2020,CB2020,061,1,Manhattan,10163001001,0,0,0,1.62
2020,CB2020,061,1,Manhattan,10163001002,33,24,9,12.63
2020,CB2020,061,1,Manhattan,10163001003,904,450,454,3.28
2020,CB2020,061,1,Manhattan,10163001004,372,162,210,2.14
2020,CB2020,061,1,Manhattan,10163001005,225,102,123,1.33
2020,CB2020,061,1,Manhattan,10163002000,866,423,443,3.48
2020,CB2020,061,1,Manhattan,10163002001,591,251,340,3.14
2020,CB2020,061,1,Manhattan,10163003000,280,113,167,2.41
2020,CB2020,061,1,Manhattan,10163003001,480,289,191,1.98
2020,CB2020,061,1,Manhattan,10163003002,247,112,135,0.75
2020,CB2020,061,1,Manhattan,10163004000,657,302,355,3.14
2020,CB2020,061,1,Manhattan,10163004001,660,339,321,3.6
2020,CB2020,061,1,Manhattan,10163005000,823,369,454,3.03
2020,CB2020,061,1,Manhattan,10163005001,537,251,286,2.74
2020,CB2020,061,1,Manhattan,10163005002,379,158,221,2.32
2020,CB2020,061,1,Manhattan,10163005003,238,122,116,1.88
2020,CB2020,061,1,Manhattan,10164001000,550,269,281,4.5
2020,CB2020,061,1,Manhattan,10164001001,1272,549,723,4.53
2020,CB2020,061,1,Manhattan,10164002000,832,392,440,4.47
2020,CB2020,061,1,Manhattan,10164002001,671,317,354,4.54
2020,CB2020,061,1,Manhattan,10164002002,850,388,462,4.57
2020,CB2020,061,1,Manhattan,10164003000,1338,579,759,9.66
2020,CB2020,061,1,Manhattan,10164003001,299,128,171,1.54
2020,CB2020,061,1,Manhattan,10164003002,280,123,157,1.51
2020,CB2020,061,1,Manhattan,10164004000,1279,522,757,8.51
2020,CB2020,061,1,Manhattan,10165001000,1321,618,703,5.77
2020,CB2020,061,1,Manhattan,10165001001,11,5,6,22.04
2020,CB2020,061,1,Manhattan,10165002000,1773,851,922,5.87
2020,CB2020,061,1,Manhattan,10165003000,1520,698,822,5.89
2020,CB2020,061,1,Manhattan,10165004000,932,428,504,5.57
2020,CB2020,061,1,Manhattan,10165005000,1102,531,571,5.36
2020,CB2020,061,1,Manhattan,10166001000,280,140,140,3.08
2020,CB2020,061,1,Manhattan,10166001001,410,199,211,3.01
2020,CB2020,061,1,Manhattan,10166002000,621,283,338,3.08
2020,CB2020,061,1,Manhattan,10166002001,455,225,230,3.01
2020,CB2020,061,1,Manhattan,10166003000,991,445,546,3.05
2020,CB2020,061,1,Manhattan,10166003001,590,272,318,3.06
2020,CB2020,061,1,Manhattan,10166004000,950,457,493,3.09
2020,CB2020,061,1,Manhattan,10166004001,451,210,241,3.11
2020,CB2020,061,1,Manhattan,10166005000,363,163,200,3.09
2020,CB2020,061,1,Manhattan,10166005001,525,221,304,3.06
2020,CB2020,061,1,Manhattan,10166006000,408,197,211,3.13
2020,CB2020,061,1,Manhattan,10166006001,0,0,0,3.11
2020,CB2020,061,1,Manhattan,10166006002,479,193,286,3.12
2020,CB2020,061,1,Manhattan,10166006003,489,197,292,3.04
2020,CB2020,061,1,Manhattan,10167000001,34,19,15,0
2020,CB2020,061,1,Manhattan,10167001000,780,351,429,2.55
2020,CB2020,061,1,Manhattan,10167001001,0,0,0,9.01
2020,CB2020,061,1,Manhattan,10167001002,0,0,0,0.81
2020,CB2020,061,1,Manhattan,10167001003,14,14,0,5.05
2020,CB2020,061,1,Manhattan,10167001004,237,121,116,2.48
2020,CB2020,061,1,Manhattan,10167002000,558,255,303,2.88
2020,CB2020,061,1,Manhattan,10167002001,778,367,411,3.25
2020,CB2020,061,1,Manhattan,10167003000,525,235,290,2.31
2020,CB2020,061,1,Manhattan,10167003001,676,312,364,2.29
2020,CB2020,061,1,Manhattan,10167003002,300,145,155,2.45
2020,CB2020,061,1,Manhattan,10167003003,316,158,158,2.46
2020,CB2020,061,1,Manhattan,10167004000,715,314,401,3.14
2020,CB2020,061,1,Manhattan,10167004001,751,333,418,3.16
2020,CB2020,061,1,Manhattan,10167005000,745,462,283,3.43
2020,CB2020,061,1,Manhattan,10167005001,781,360,421,3.41
2020,CB2020,061,1,Manhattan,10168001000,768,337,431,6.37
2020,CB2020,061,1,Manhattan,10168001001,839,332,507,6.11
2020,CB2020,061,1,Manhattan,10168002000,1319,546,773,9.08
2020,CB2020,061,1,Manhattan,10168002001,633,283,350,3.07
2020,CB2020,061,1,Manhattan,10168002002,308,189,119,9.14
2020,CB2020,061,1,Manhattan,10168002003,0,0,0,3.04
2020,CB2020,061,1,Manhattan,10168003000,553,295,258,3.28
2020,CB2020,061,1,Manhattan,10168003001,408,209,199,3.09
2020,CB2020,061,1,Manhattan,10168003002,0,0,0,3.03
2020,CB2020,061,1,Manhattan,10168003003,136,53,83,3.04
2020,CB2020,061,1,Manhattan,10169001000,1373,658,715,5.87
2020,CB2020,061,1,Manhattan,10169002000,1194,560,634,5.46
2020,CB2020,061,1,Manhattan,10169003000,1590,747,843,5.88
2020,CB2020,061,1,Manhattan,10169003001,289,142,147,5.45
2020,CB2020,061,1,Manhattan,10169004000,532,239,293,5.45
2020,CB2020,061,1,Manhattan,10169004001,1075,562,513,5.48
2020,CB2020,061,1,Manhattan,10169005000,1075,503,572,5.44
2020,CB2020,061,1,Manhattan,10169006000,1398,657,741,5.46
2020,CB2020,061,1,Manhattan,10170001000,560,264,296,8.53
2020,CB2020,061,1,Manhattan,10170001001,1032,448,584,4.46
2020,CB2020,061,1,Manhattan,10170002000,497,233,264,4.58
2020,CB2020,061,1,Manhattan,10170002001,638,292,346,4.34
2020,CB2020,061,1,Manhattan,10170003000,843,415,428,4.85
2020,CB2020,061,1,Manhattan,10170003001,973,367,606,4.56
2020,CB2020,061,1,Manhattan,10170004000,248,93,155,1.54
2020,CB2020,061,1,Manhattan,10170004001,1057,433,624,3.7
2020,CB2020,061,1,Manhattan,10170004002,854,387,467,3.99
2020,CB2020,061,1,Manhattan,10170005000,1289,664,625,4.66
2020,CB2020,061,1,Manhattan,10171000001,0,0,0,0
2020,CB2020,061,1,Manhattan,10171001000,1123,471,652,3.14
2020,CB2020,061,1,Manhattan,10171001001,665,275,390,3.04
2020,CB2020,061,1,Manhattan,10171002000,915,415,500,3.1
2020,CB2020,061,1,Manhattan,10171002001,672,339,333,3.14
2020,CB2020,061,1,Manhattan,10171002002,216,102,114,2.35
2020,CB2020,061,1,Manhattan,10171003000,623,346,277,2.73
2020,CB2020,061,1,Manhattan,10171003001,792,375,417,2.42
2020,CB2020,061,1,Manhattan,10171003002,360,170,190,2.35
2020,CB2020,061,1,Manhattan,10171004000,1074,499,575,4.63
2020,CB2020,061,1,Manhattan,10171005000,1095,497,598,3.96
2020,CB2020,061,1,Manhattan,10171005001,798,367,431,3.18
2020,CB2020,061,1,Manhattan,10171006000,1361,644,717,5.18
2020,CB2020,061,1,Manhattan,10171006001,0,0,0,10.35
2020,CB2020,061,1,Manhattan,10171006002,0,0,0,1.25
2020,CB2020,061,1,Manhattan,10171006003,0,0,0,2.99
2020,CB2020,061,1,Manhattan,10172001000,439,220,219,3.11
2020,CB2020,061,1,Manhattan,10172001001,136,65,71,3.14
2020,CB2020,061,1,Manhattan,10172001002,400,210,190,3.13
2020,CB2020,061,1,Manhattan,10172001003,359,193,166,3.04
2020,CB2020,061,1,Manhattan,10172002000,800,331,469,3.02
2020,CB2020,061,1,Manhattan,10172002001,744,329,415,3.08
2020,CB2020,061,1,Manhattan,10172003000,283,127,156,3.1
2020,CB2020,061,1,Manhattan,10172003001,209,84,125,3.3
2020,CB2020,061,1,Manhattan,10172003002,137,80,57,3.3
2020,CB2020,061,1,Manhattan,10172004000,302,161,141,3.05
2020,CB2020,061,1,Manhattan,10172004001,422,201,221,3.28
2020,CB2020,061,1,Manhattan,10172004002,386,174,212,3.28
2020,CB2020,061,1,Manhattan,10172005000,310,120,190,3.09
2020,CB2020,061,1,Manhattan,10172005001,514,265,249,3.02
2020,CB2020,061,1,Manhattan,10173001000,1538,757,781,5.81
2020,CB2020,061,1,Manhattan,10173002000,780,346,434,5.42
2020,CB2020,061,1,Manhattan,10173003000,985,394,591,5.43
2020,CB2020,061,1,Manhattan,10173003001,972,432,540,5.4
2020,CB2020,061,1,Manhattan,10173004000,1169,531,638,5.49
2020,CB2020,061,1,Manhattan,10173005000,760,338,422,5.39
2020,CB2020,061,1,Manhattan,10173006000,986,469,517,5.41
2020,CB2020,061,1,Manhattan,10173007000,1509,661,848,5.8
2020,CB2020,061,1,Manhattan,10174011000,736,302,434,2.98
2020,CB2020,061,1,Manhattan,10174011001,35,9,26,3.07
2020,CB2020,061,1,Manhattan,10174011002,943,410,533,6.36
2020,CB2020,061,1,Manhattan,10174012000,1054,455,599,3.04
2020,CB2020,061,1,Manhattan,10174012001,1102,475,627,3.3
2020,CB2020,061,1,Manhattan,10174013000,643,298,345,3.1
2020,CB2020,061,1,Manhattan,10174013001,936,467,469,3.06
2020,CB2020,061,1,Manhattan,10174021000,40,21,19,3.16
2020,CB2020,061,1,Manhattan,10174021001,432,192,240,3.19
2020,CB2020,061,1,Manhattan,10174021002,1309,565,744,3.03
2020,CB2020,061,1,Manhattan,10174021003,495,213,282,3.15
2020,CB2020,061,1,Manhattan,10175000001,0,0,0,0
2020,CB2020,061,1,Manhattan,10175001000,866,388,478,3.74
2020,CB2020,061,1,Manhattan,10175001001,0,0,0,10.88
2020,CB2020,061,1,Manhattan,10175001002,0,0,0,1.26
2020,CB2020,061,1,Manhattan,10175001003,0,0,0,1.28
2020,CB2020,061,1,Manhattan,10175001004,1051,496,555,4.54
2020,CB2020,061,1,Manhattan,10175002000,1557,731,826,4.77
2020,CB2020,061,1,Manhattan,10175003000,2235,1115,1120,5.12
2020,CB2020,061,1,Manhattan,10175004000,709,306,403,2.7
2020,CB2020,061,1,Manhattan,10175004001,710,311,399,2.7
2020,CB2020,061,1,Manhattan,10175005000,616,300,316,2.69
2020,CB2020,061,1,Manhattan,10175005001,649,297,352,2.83
2020,CB2020,061,1,Manhattan,10175006000,719,352,367,2.7
2020,CB2020,061,1,Manhattan,10175006001,859,393,466,2.69
2020,CB2020,061,1,Manhattan,10175007000,799,436,363,2.71
2020,CB2020,061,1,Manhattan,10175007001,340,163,177,2.97
2020,CB2020,061,1,Manhattan,10177001000,265,105,160,0.64
2020,CB2020,061,1,Manhattan,10177001001,927,413,514,5.44
2020,CB2020,061,1,Manhattan,10177002000,1142,497,645,4.79
2020,CB2020,061,1,Manhattan,10177003000,460,191,269,3.11
2020,CB2020,061,1,Manhattan,10177003001,342,153,189,1.28
2020,CB2020,061,1,Manhattan,10177003002,263,118,145,2.27
2020,CB2020,061,1,Manhattan,10177004000,963,400,563,3.09
2020,CB2020,061,1,Manhattan,10177004001,398,155,243,1
2020,CB2020,061,1,Manhattan,10177005000,840,365,475,5.39
2020,CB2020,061,1,Manhattan,10177005001,401,197,204,1.17
2020,CB2020,061,1,Manhattan,10177006000,955,425,530,4.12
2020,CB2020,061,1,Manhattan,10177007000,1046,463,583,5.43
2020,CB2020,061,1,Manhattan,10177008000,1380,609,771,5.4
2020,CB2020,061,1,Manhattan,10178000001,0,0,0,0
2020,CB2020,061,1,Manhattan,10178001000,555,276,279,4.27
2020,CB2020,061,1,Manhattan,10178001001,592,285,307,4.29
2020,CB2020,061,1,Manhattan,10178002000,429,208,221,2.64
2020,CB2020,061,1,Manhattan,10178002001,389,209,180,1.97
2020,CB2020,061,1,Manhattan,10178002002,667,308,359,4.67
2020,CB2020,061,1,Manhattan,10178003000,502,232,270,12.87
2020,CB2020,061,1,Manhattan,10178003001,0,0,0,0.66
2020,CB2020,061,1,Manhattan,10178003002,0,0,0,1.05
2020,CB2020,061,1,Manhattan,10178003003,0,0,0,1.79
2020,CB2020,061,1,Manhattan,10178003004,0,0,0,0.45
2020,CB2020,061,1,Manhattan,10178003005,0,0,0,5.67
2020,CB2020,061,1,Manhattan,10178003006,692,326,366,4.18
2020,CB2020,061,1,Manhattan,10178003007,34,16,18,16.21
2020,CB2020,061,1,Manhattan,10178003008,0,0,0,0.77
2020,CB2020,061,1,Manhattan,10179000001,0,0,0,0
2020,CB2020,061,1,Manhattan,10179001000,1434,674,760,3.61
2020,CB2020,061,1,Manhattan,10179001001,0,0,0,1.92
2020,CB2020,061,1,Manhattan,10179001002,0,0,0,11.82
2020,CB2020,061,1,Manhattan,10179001003,0,0,0,1.25
2020,CB2020,061,1,Manhattan,10179001004,0,0,0,3.7
2020,CB2020,061,1,Manhattan,10179002000,1008,495,513,2.95
2020,CB2020,061,1,Manhattan,10179003000,752,335,417,2.9
2020,CB2020,061,1,Manhattan,10179003001,530,250,280,3.09
2020,CB2020,061,1,Manhattan,10179004000,637,291,346,2.7
2020,CB2020,061,1,Manhattan,10179004001,1139,555,584,2.71
2020,CB2020,061,1,Manhattan,10179005000,283,128,155,1.95
2020,CB2020,061,1,Manhattan,10179005001,126,65,61,0.75
2020,CB2020,061,1,Manhattan,10179005002,402,191,211,2.7
2020,CB2020,061,1,Manhattan,10179006000,855,437,418,2.7
2020,CB2020,061,1,Manhattan,10179006001,656,271,385,2.71
2020,CB2020,061,1,Manhattan,10179007000,346,159,187,1.64
2020,CB2020,061,1,Manhattan,10179007001,295,149,146,1.06
2020,CB2020,061,1,Manhattan,10179007002,640,287,353,2.69
2020,CB2020,061,1,Manhattan,10180001000,979,491,488,4.69
2020,CB2020,061,1,Manhattan,10180001001,279,151,128,4.51
2020,CB2020,061,1,Manhattan,10180001002,597,322,275,4.57
2020,CB2020,061,1,Manhattan,10180002000,823,384,439,4.4
2020,CB2020,061,1,Manhattan,10180002001,685,322,363,4.26
2020,CB2020,061,1,Manhattan,10180002002,255,139,116,4.36
2020,CB2020,061,1,Manhattan,10180003000,897,362,535,8.67
2020,CB2020,061,1,Manhattan,10180004000,902,354,548,3.86
2020,CB2020,061,1,Manhattan,10180005000,841,334,507,3.92
2020,CB2020,061,1,Manhattan,10180005001,1171,481,690,9.28
2020,CB2020,061,1,Manhattan,10181001000,1536,637,899,5.77
2020,CB2020,061,1,Manhattan,10181002000,1229,529,700,5.37
2020,CB2020,061,1,Manhattan,10181003000,1779,764,1015,5.97
2020,CB2020,061,1,Manhattan,10181004000,1212,526,686,5.36
2020,CB2020,061,1,Manhattan,10181005000,1518,688,830,5.78
2020,CB2020,061,1,Manhattan,10181006000,1667,702,965,5.96
2020,CB2020,061,1,Manhattan,10182001000,357,191,166,1.52
2020,CB2020,061,1,Manhattan,10182001001,298,134,164,1.79
2020,CB2020,061,1,Manhattan,10182001002,743,341,402,3.37
2020,CB2020,061,1,Manhattan,10182002000,578,239,339,3.08
2020,CB2020,061,1,Manhattan,10182002001,544,235,309,3.09
2020,CB2020,061,1,Manhattan,10182003000,674,252,422,3.05
2020,CB2020,061,1,Manhattan,10182003001,554,266,288,3.06
2020,CB2020,061,1,Manhattan,10182003002,170,87,83,1.76
2020,CB2020,061,1,Manhattan,10182003003,112,66,46,1.53
2020,CB2020,061,1,Manhattan,10182003004,234,154,80,3.32
2020,CB2020,061,1,Manhattan,10182004000,1437,616,821,9.04
2020,CB2020,061,1,Manhattan,10182005000,1974,826,1148,9.12
2020,CB2020,061,1,Manhattan,10183000001,0,0,0,0
2020,CB2020,061,1,Manhattan,10183001000,663,302,361,2.58
2020,CB2020,061,1,Manhattan,10183001001,0,0,0,0.55
2020,CB2020,061,1,Manhattan,10183001002,0,0,0,6.78
2020,CB2020,061,1,Manhattan,10183001003,0,0,0,0.56
2020,CB2020,061,1,Manhattan,10183001004,0,0,0,0.2
2020,CB2020,061,1,Manhattan,10183001005,0,0,0,7.62
2020,CB2020,061,1,Manhattan,10183001006,0,0,0,1.48
2020,CB2020,061,1,Manhattan,10183001007,0,0,0,1.22
2020,CB2020,061,1,Manhattan,10183001008,0,0,0,0.37
2020,CB2020,061,1,Manhattan,10183001009,966,514,452,3.46
2020,CB2020,061,1,Manhattan,10183002000,646,304,342,4.1
2020,CB2020,061,1,Manhattan,10183003000,297,158,139,1.39
2020,CB2020,061,1,Manhattan,10183003001,845,492,353,2.66
2020,CB2020,061,1,Manhattan,10183004000,808,390,418,2.72
2020,CB2020,061,1,Manhattan,10183004001,1139,539,600,2.92
2020,CB2020,061,1,Manhattan,10183005000,257,123,134,2.89
2020,CB2020,061,1,Manhattan,10183005001,505,243,262,1.28
2020,CB2020,061,1,Manhattan,10183005002,337,145,192,1.42
2020,CB2020,061,1,Manhattan,10183006000,630,322,308,2.71
2020,CB2020,061,1,Manhattan,10183006001,297,172,125,2.93
2020,CB2020,061,1,Manhattan,10183007000,732,344,388,2.89
2020,CB2020,061,1,Manhattan,10183007001,412,186,226,2.7
2020,CB2020,061,1,Manhattan,10184001000,526,317,209,3.07
2020,CB2020,061,1,Manhattan,10184001001,296,153,143,3.07
2020,CB2020,061,1,Manhattan,10184002000,516,241,275,2.6
2020,CB2020,061,1,Manhattan,10184002001,139,60,79,0.7
2020,CB2020,061,1,Manhattan,10184002002,590,252,338,3.42
2020,CB2020,061,1,Manhattan,10184003000,1783,697,1086,8.95
2020,CB2020,061,1,Manhattan,10184004000,811,328,483,5.45
2020,CB2020,061,1,Manhattan,10184004001,795,334,461,3.55
2020,CB2020,061,1,Manhattan,10184005000,651,283,368,3.06
2020,CB2020,061,1,Manhattan,10184005001,473,227,246,3.07
2020,CB2020,061,1,Manhattan,10184005002,446,212,234,1.98
2020,CB2020,061,1,Manhattan,10184005003,299,112,187,1.32
2020,CB2020,061,1,Manhattan,10184005004,495,234,261,3.39
2020,CB2020,061,1,Manhattan,10185001000,1578,645,933,11.25
2020,CB2020,061,1,Manhattan,10185002000,2378,1076,1302,16.37
2020,CB2020,061,1,Manhattan,10185003000,1287,532,755,4.6
2020,CB2020,061,1,Manhattan,10186001000,1341,570,771,7.77
2020,CB2020,061,1,Manhattan,10186001001,421,187,234,1.97
2020,CB2020,061,1,Manhattan,10186002000,596,222,374,6.26
2020,CB2020,061,1,Manhattan,10186002001,1031,464,567,5.41
2020,CB2020,061,1,Manhattan,10186002002,0,0,0,0.37
2020,CB2020,061,1,Manhattan,10186003000,1051,397,654,5.51
2020,CB2020,061,1,Manhattan,10186003001,687,286,401,2.79
2020,CB2020,061,1,Manhattan,10187000001,0,0,0,0
2020,CB2020,061,1,Manhattan,10187001000,745,345,400,2.98
2020,CB2020,061,1,Manhattan,10187001001,0,0,0,4.07
2020,CB2020,061,1,Manhattan,10187001002,0,0,0,10
2020,CB2020,061,1,Manhattan,10187001003,0,0,0,1.34
2020,CB2020,061,1,Manhattan,10187001004,0,0,0,4.29
2020,CB2020,061,1,Manhattan,10187001005,995,484,511,3.32
2020,CB2020,061,1,Manhattan,10187002000,1107,537,570,3.35
2020,CB2020,061,1,Manhattan,10187002001,951,466,485,2.9
2020,CB2020,061,1,Manhattan,10187003000,482,228,254,2.72
2020,CB2020,061,1,Manhattan,10187003001,409,224,185,2.7
2020,CB2020,061,1,Manhattan,10187004000,874,422,452,2.67
2020,CB2020,061,1,Manhattan,10187004001,771,392,379,2.72
2020,CB2020,061,1,Manhattan,10187005000,903,384,519,2.71
2020,CB2020,061,1,Manhattan,10187005001,894,426,468,2.64
2020,CB2020,061,1,Manhattan,10187006000,468,226,242,2.76
2020,CB2020,061,1,Manhattan,10187006001,784,392,392,2.73
2020,CB2020,061,1,Manhattan,10188001000,822,367,455,4.5
2020,CB2020,061,1,Manhattan,10188001001,125,70,55,4.5
2020,CB2020,061,1,Manhattan,10188002000,728,386,342,4.85
2020,CB2020,061,1,Manhattan,10188002001,809,451,358,4.99
2020,CB2020,061,1,Manhattan,10188003000,330,165,165,2.97
2020,CB2020,061,1,Manhattan,10188003001,250,150,100,1.64
2020,CB2020,061,1,Manhattan,10188003002,943,504,439,4.71
2020,CB2020,061,1,Manhattan,10188004000,1051,528,523,4.27
2020,CB2020,061,1,Manhattan,10188004001,639,334,305,4.27
2020,CB2020,061,1,Manhattan,10189001000,363,199,164,2.95
2020,CB2020,061,1,Manhattan,10189001001,635,287,348,2.8
2020,CB2020,061,1,Manhattan,10189001002,606,308,298,2.73
2020,CB2020,061,1,Manhattan,10189002000,677,324,353,2.77
2020,CB2020,061,1,Manhattan,10189002001,631,257,374,2.75
2020,CB2020,061,1,Manhattan,10189002002,814,410,404,2.91
2020,CB2020,061,1,Manhattan,10189003000,635,271,364,2.65
2020,CB2020,061,1,Manhattan,10189003001,890,366,524,5.42
2020,CB2020,061,1,Manhattan,10189003002,570,243,327,2.51
2020,CB2020,061,1,Manhattan,10189004000,618,277,341,2.82
2020,CB2020,061,1,Manhattan,10189004001,542,250,292,2.72
2020,CB2020,061,1,Manhattan,10189005000,977,432,545,5.82
2020,CB2020,061,1,Manhattan,10189005001,842,369,473,5.49
2020,CB2020,061,1,Manhattan,10189006000,1263,533,730,7.65
2020,CB2020,061,1,Manhattan,10189006001,563,185,378,2.35
2020,CB2020,061,1,Manhattan,10189006002,930,375,555,11.25
2020,CB2020,061,1,Manhattan,10190001000,121,67,54,0.87
2020,CB2020,061,1,Manhattan,10190001001,813,394,419,5.24
2020,CB2020,061,1,Manhattan,10190001002,329,118,211,6.14
2020,CB2020,061,1,Manhattan,10190002000,259,106,153,1.51
2020,CB2020,061,1,Manhattan,10190002001,1083,476,607,5.08
2020,CB2020,061,1,Manhattan,10190002002,1074,501,573,6.8
2020,CB2020,061,1,Manhattan,10191000001,31,15,16,0
2020,CB2020,061,1,Manhattan,10191001000,0,0,0,0.87
2020,CB2020,061,1,Manhattan,10191001001,0,0,0,16.09
2020,CB2020,061,1,Manhattan,10191001002,0,0,0,1.17
2020,CB2020,061,1,Manhattan,10191001003,0,0,0,2.06
2020,CB2020,061,1,Manhattan,10191001004,642,315,327,3.02
2020,CB2020,061,1,Manhattan,10191001005,909,401,508,2.85
2020,CB2020,061,1,Manhattan,10191001006,0,0,0,1.36
2020,CB2020,061,1,Manhattan,10191002000,1033,485,548,2.86
2020,CB2020,061,1,Manhattan,10191002001,967,430,537,2.86
2020,CB2020,061,1,Manhattan,10191003000,415,245,170,1.8
2020,CB2020,061,1,Manhattan,10191003001,769,345,424,2.24
2020,CB2020,061,1,Manhattan,10191004000,695,310,385,2.58
2020,CB2020,061,1,Manhattan,10191004001,885,399,486,2.69
2020,CB2020,061,1,Manhattan,10191005000,715,333,382,4.05
2020,CB2020,061,1,Manhattan,10191005001,704,309,395,3.16
2020,CB2020,061,1,Manhattan,10191006000,626,317,309,2.85
2020,CB2020,061,1,Manhattan,10191006001,614,287,327,2.73
2020,CB2020,061,1,Manhattan,10192000001,0,0,0,0
2020,CB2020,061,1,Manhattan,10192000002,0,0,0,0
2020,CB2020,061,1,Manhattan,10192000003,0,0,0,0
2020,CB2020,061,1,Manhattan,10192001000,16,7,9,5.94
2020,CB2020,061,1,Manhattan,10192001001,0,0,0,4.32
2020,CB2020,061,1,Manhattan,10192001002,46,27,19,8.67
2020,CB2020,061,1,Manhattan,10192001003,170,133,37,4.05
2020,CB2020,061,1,Manhattan,10192001004,413,164,249,4.47
2020,CB2020,061,1,Manhattan,10192001005,0,0,0,0.41
2020,CB2020,061,1,Manhattan,10192001006,0,0,0,0.27
2020,CB2020,061,1,Manhattan,10192002000,1768,723,1045,10.46
2020,CB2020,061,1,Manhattan,10192003000,1558,631,927,8.32
2020,CB2020,061,1,Manhattan,10193001000,327,143,184,1.08
2020,CB2020,061,1,Manhattan,10193001001,298,142,156,1.43
2020,CB2020,061,1,Manhattan,10193001002,742,324,418,2.75
2020,CB2020,061,1,Manhattan,10193002000,737,322,415,2.76
2020,CB2020,061,1,Manhattan,10193002001,762,327,435,2.97
2020,CB2020,061,1,Manhattan,10193003000,746,339,407,2.65
2020,CB2020,061,1,Manhattan,10193003001,757,326,431,2.85
2020,CB2020,061,1,Manhattan,10193004000,504,191,313,2.53
2020,CB2020,061,1,Manhattan,10193004001,465,202,263,2.65
2020,CB2020,061,1,Manhattan,10193005000,1177,491,686,5.12
2020,CB2020,061,1,Manhattan,10193005001,809,370,439,5.43
2020,CB2020,061,1,Manhattan,10193006000,329,131,198,5.41
2020,CB2020,061,1,Manhattan,10193006001,1083,454,629,5.8
2020,CB2020,061,1,Manhattan,10194001000,2532,1053,1479,16.88
2020,CB2020,061,1,Manhattan,10194002000,647,290,357,4.63
2020,CB2020,061,1,Manhattan,10194002001,170,96,74,4.27
2020,CB2020,061,1,Manhattan,10194003000,883,563,320,4.4
2020,CB2020,061,1,Manhattan,10194003001,601,327,274,4.33
2020,CB2020,061,1,Manhattan,10194004000,504,280,224,4.34
2020,CB2020,061,1,Manhattan,10194004001,1641,709,932,4.41
2020,CB2020,061,1,Manhattan,10195000001,0,0,0,0
2020,CB2020,061,1,Manhattan,10195001000,581,258,323,2.51
2020,CB2020,061,1,Manhattan,10195001001,0,0,0,1.04
2020,CB2020,061,1,Manhattan,10195001002,0,0,0,15.9
2020,CB2020,061,1,Manhattan,10195001003,0,0,0,1.06
2020,CB2020,061,1,Manhattan,10195001004,0,0,0,1.97
2020,CB2020,061,1,Manhattan,10195001005,893,542,351,2.92
2020,CB2020,061,1,Manhattan,10195001006,0,0,0,0.87
2020,CB2020,061,1,Manhattan,10195002000,0,0,0,0.31
2020,CB2020,061,1,Manhattan,10195002001,436,188,248,2.77
2020,CB2020,061,1,Manhattan,10195002002,774,398,376,3.01
2020,CB2020,061,1,Manhattan,10195002003,7,7,0,1.07
2020,CB2020,061,1,Manhattan,10195003000,1387,691,696,5.17
2020,CB2020,061,1,Manhattan,10195003001,1033,456,577,5.41
2020,CB2020,061,1,Manhattan,10195004000,1340,659,681,5.13
2020,CB2020,061,1,Manhattan,10195005000,841,386,455,3.22
2020,CB2020,061,1,Manhattan,10195005001,536,261,275,1.63
2020,CB2020,061,1,Manhattan,10196001000,452,199,253,3.08
2020,CB2020,061,1,Manhattan,10196001001,1025,463,562,3.08
2020,CB2020,061,1,Manhattan,10196002000,322,186,136,3.05
2020,CB2020,061,1,Manhattan,10196002001,146,43,103,1.27
2020,CB2020,061,1,Manhattan,10196002002,262,122,140,3.09
2020,CB2020,061,1,Manhattan,10196002003,455,210,245,3.09
2020,CB2020,061,1,Manhattan,10196002004,185,89,96,3.05
2020,CB2020,061,1,Manhattan,10196002005,30,15,15,1.78
2020,CB2020,061,1,Manhattan,10196003000,280,140,140,3.26
2020,CB2020,061,1,Manhattan,10196003001,122,89,33,3.29
2020,CB2020,061,1,Manhattan,10196003002,309,159,150,3.31
2020,CB2020,061,1,Manhattan,10196003003,243,110,133,3.08
2020,CB2020,061,1,Manhattan,10196003004,69,42,27,3.04
2020,CB2020,061,1,Manhattan,10196003005,38,26,12,3.28
2020,CB2020,061,1,Manhattan,10196003006,93,50,43,3.04
2020,CB2020,061,1,Manhattan,10197011000,11,6,5,40.15
2020,CB2020,061,1,Manhattan,10197011001,0,0,0,3.86
2020,CB2020,061,1,Manhattan,10197011002,1267,582,685,14.3
2020,CB2020,061,1,Manhattan,10197021000,675,315,360,2.78
2020,CB2020,061,1,Manhattan,10197021001,0,0,0,0.39
2020,CB2020,061,1,Manhattan,10197021002,332,135,197,2.78
2020,CB2020,061,1,Manhattan,10197021003,741,364,377,2.75
2020,CB2020,061,1,Manhattan,10197021004,853,451,402,3.01
2020,CB2020,061,1,Manhattan,10198001000,285,136,149,3.28
2020,CB2020,061,1,Manhattan,10198001001,119,63,56,3.29
2020,CB2020,061,1,Manhattan,10198001002,498,271,227,3.29
2020,CB2020,061,1,Manhattan,10198001003,85,27,58,3.33
2020,CB2020,061,1,Manhattan,10198001004,298,124,174,3.12
2020,CB2020,061,1,Manhattan,10198001005,268,118,150,3.14
2020,CB2020,061,1,Manhattan,10198001006,139,85,54,3.17
2020,CB2020,061,1,Manhattan,10198001007,0,0,0,3.11
2020,CB2020,061,1,Manhattan,10198001008,179,100,79,3.1
2020,CB2020,061,1,Manhattan,10198001009,445,221,224,3.07
2020,CB2020,061,1,Manhattan,10198002000,54,40,14,23.81
2020,CB2020,061,1,Manhattan,10199000001,0,0,0,0
2020,CB2020,061,1,Manhattan,10199001000,465,217,248,2.2
2020,CB2020,061,1,Manhattan,10199001001,440,192,248,1.56
2020,CB2020,061,1,Manhattan,10199001002,0,0,0,0.25
2020,CB2020,061,1,Manhattan,10199001003,0,0,0,14.57
2020,CB2020,061,1,Manhattan,10199001004,0,0,0,1.43
2020,CB2020,061,1,Manhattan,10199001005,0,0,0,2.62
2020,CB2020,061,1,Manhattan,10199001006,494,287,207,1.76
2020,CB2020,061,1,Manhattan,10199001007,297,134,163,1.49
2020,CB2020,061,1,Manhattan,10199001008,0,0,0,1.9
2020,CB2020,061,1,Manhattan,10199001009,0,0,0,0.64
2020,CB2020,061,1,Manhattan,10199002000,0,0,0,0.53
2020,CB2020,061,1,Manhattan,10199002001,490,222,268,2.37
2020,CB2020,061,1,Manhattan,10199002002,1005,378,627,2.87
2020,CB2020,061,1,Manhattan,10199003000,563,254,309,0.86
2020,CB2020,061,1,Manhattan,10199003001,1229,616,613,4.53
2020,CB2020,061,1,Manhattan,10199004000,1039,427,612,1.17
2020,CB2020,061,1,Manhattan,10199004001,648,338,310,4.21
2020,CB2020,061,1,Manhattan,10199005000,651,296,355,1.78
2020,CB2020,061,1,Manhattan,10199005001,637,264,373,2.8
2020,CB2020,061,1,Manhattan,10199005002,225,85,140,0.81
2020,CB2020,061,1,Manhattan,10199006000,212,103,109,1.06
2020,CB2020,061,1,Manhattan,10199006001,1203,544,659,4.6
2020,CB2020,061,1,Manhattan,10200001000,275,128,147,3.18
2020,CB2020,061,1,Manhattan,10200001001,398,193,205,2.64
2020,CB2020,061,1,Manhattan,10200001002,382,167,215,3.49
2020,CB2020,061,1,Manhattan,10200002000,329,162,167,6.56
2020,CB2020,061,1,Manhattan,10200002001,444,245,199,6.59
2020,CB2020,061,1,Manhattan,10200002002,401,186,215,3.2
2020,CB2020,061,1,Manhattan,10200002003,371,175,196,3.16
2020,CB2020,061,1,Manhattan,10200002004,255,136,119,3.13
2020,CB2020,061,1,Manhattan,10201011000,1086,523,563,6.64
2020,CB2020,061,1,Manhattan,10201011001,233,123,110,1.44
2020,CB2020,061,1,Manhattan,10201011002,82,38,44,1.25
2020,CB2020,061,1,Manhattan,10201011003,200,86,114,3.49
2020,CB2020,061,1,Manhattan,10201011004,262,147,115,0.8
2020,CB2020,061,1,Manhattan,10201021000,503,214,289,2.76
2020,CB2020,061,1,Manhattan,10201021001,511,232,279,2.97
2020,CB2020,061,1,Manhattan,10201022000,618,292,326,2.98
2020,CB2020,061,1,Manhattan,10201022001,697,338,359,2.78
2020,CB2020,061,1,Manhattan,10201023000,465,204,261,2.38
2020,CB2020,061,1,Manhattan,10201023001,199,86,113,1.26
2020,CB2020,061,1,Manhattan,10201024000,519,228,291,2.64
2020,CB2020,061,1,Manhattan,10201024001,565,285,280,2.82
2020,CB2020,061,1,Manhattan,10203001000,398,215,183,1.36
2020,CB2020,061,1,Manhattan,10203001001,172,80,92,0.69
2020,CB2020,061,1,Manhattan,10203001002,409,126,283,5.75
2020,CB2020,061,1,Manhattan,10203001003,42,17,25,0.24
2020,CB2020,061,1,Manhattan,10203001004,193,77,116,1.64
2020,CB2020,061,1,Manhattan,10203001005,679,280,399,1.44
2020,CB2020,061,1,Manhattan,10203002000,11,5,6,21.7
2020,CB2020,061,1,Manhattan,10203002001,1970,950,1020,11.22
2020,CB2020,061,1,Manhattan,10205000001,0,0,0,0
2020,CB2020,061,1,Manhattan,10205001000,0,0,0,4.85
2020,CB2020,061,1,Manhattan,10205001001,0,0,0,3.1
2020,CB2020,061,1,Manhattan,10205001002,10,4,6,29.08
2020,CB2020,061,1,Manhattan,10205001003,0,0,0,1.16
2020,CB2020,061,1,Manhattan,10205001004,0,0,0,0.56
2020,CB2020,061,1,Manhattan,10205001005,0,0,0,2.83
2020,CB2020,061,1,Manhattan,10205001006,191,26,165,0.89
2020,CB2020,061,1,Manhattan,10205001007,8,3,5,3.92
2020,CB2020,061,1,Manhattan,10205001008,954,9,945,7.81
2020,CB2020,061,1,Manhattan,10205001009,14,6,8,0.28
2020,CB2020,061,1,Manhattan,10205001010,0,0,0,1.64
2020,CB2020,061,1,Manhattan,10205001011,1274,561,713,5.12
2020,CB2020,061,1,Manhattan,10205002000,10,5,5,0.58
2020,CB2020,061,1,Manhattan,10205002001,1106,453,653,2.55
2020,CB2020,061,1,Manhattan,10205002002,330,73,257,0.5
2020,CB2020,061,1,Manhattan,10205002003,255,21,234,0.56
2020,CB2020,061,1,Manhattan,10205003000,263,123,140,1.35
2020,CB2020,061,1,Manhattan,10205003001,82,42,40,1.19
2020,CB2020,061,1,Manhattan,10205003002,526,251,275,1.52
2020,CB2020,061,1,Manhattan,10206001000,492,225,267,3.17
2020,CB2020,061,1,Manhattan,10206001001,16,12,4,3.05
2020,CB2020,061,1,Manhattan,10206001002,285,147,138,3.04
2020,CB2020,061,1,Manhattan,10206001003,402,209,193,3.05
2020,CB2020,061,1,Manhattan,10206001004,231,106,125,3.04
2020,CB2020,061,1,Manhattan,10206001005,480,225,255,3.05
2020,CB2020,061,1,Manhattan,10206002000,510,223,287,3.12
2020,CB2020,061,1,Manhattan,10206002001,354,175,179,3.06
2020,CB2020,061,1,Manhattan,10206002002,73,27,46,1.37
2020,CB2020,061,1,Manhattan,10206002003,104,61,43,1.68
2020,CB2020,061,1,Manhattan,10206002004,513,344,169,3.05
2020,CB2020,061,1,Manhattan,10206002005,0,0,0,3.03
2020,CB2020,061,1,Manhattan,10206002006,168,74,94,3.05
2020,CB2020,061,1,Manhattan,10207011000,733,377,356,2.91
2020,CB2020,061,1,Manhattan,10207011001,881,468,413,3.24
2020,CB2020,061,1,Manhattan,10207012000,503,275,228,2.4
2020,CB2020,061,1,Manhattan,10207012001,278,118,160,1.51
2020,CB2020,061,1,Manhattan,10207012002,514,122,392,1.1
2020,CB2020,061,1,Manhattan,10207012003,126,68,58,0.53
2020,CB2020,061,1,Manhattan,10208001000,917,440,477,6.27
2020,CB2020,061,1,Manhattan,10208001001,686,313,373,6.1
2020,CB2020,061,1,Manhattan,10208002000,293,154,139,3.56
2020,CB2020,061,1,Manhattan,10208002001,861,449,412,2.53
2020,CB2020,061,1,Manhattan,10208002002,882,384,498,6.1
2020,CB2020,061,1,Manhattan,10208003000,888,420,468,6.07
2020,CB2020,061,1,Manhattan,10208003001,728,320,408,6.09
2020,CB2020,061,1,Manhattan,10209011000,662,325,337,6.38
2020,CB2020,061,1,Manhattan,10209011001,327,166,161,2.92
2020,CB2020,061,1,Manhattan,10209011002,151,88,63,2.57
2020,CB2020,061,1,Manhattan,10209011003,30,15,15,0.35
2020,CB2020,061,1,Manhattan,10209011004,418,213,205,2.66
2020,CB2020,061,1,Manhattan,10209012000,2077,864,1213,13.25
2020,CB2020,061,1,Manhattan,10209012001,0,0,0,0.47
2020,CB2020,061,1,Manhattan,10210000001,6,4,2,0
2020,CB2020,061,1,Manhattan,10210000002,0,0,0,0
2020,CB2020,061,1,Manhattan,10210000003,0,0,0,0
2020,CB2020,061,1,Manhattan,10210001000,0,0,0,4.08
2020,CB2020,061,1,Manhattan,10210001001,0,0,0,0.47
2020,CB2020,061,1,Manhattan,10210001002,0,0,0,1.16
2020,CB2020,061,1,Manhattan,10210001003,654,263,391,4.67
2020,CB2020,061,1,Manhattan,10210001004,490,209,281,2.22
2020,CB2020,061,1,Manhattan,10210001005,0,0,0,0.54
2020,CB2020,061,1,Manhattan,10210001006,0,0,0,0.3
2020,CB2020,061,1,Manhattan,10210002000,0,0,0,0.74
2020,CB2020,061,1,Manhattan,10210002001,0,0,0,0.65
2020,CB2020,061,1,Manhattan,10210002002,529,234,295,3.15
2020,CB2020,061,1,Manhattan,10210003000,1541,620,921,9.21
2020,CB2020,061,1,Manhattan,10210004000,0,0,0,0.8
2020,CB2020,061,1,Manhattan,10210004001,0,0,0,0.34
2020,CB2020,061,1,Manhattan,10210004002,0,0,0,0.26
2020,CB2020,061,1,Manhattan,10210004003,1805,726,1079,8.16
2020,CB2020,061,1,Manhattan,10210004004,0,0,0,0.5
2020,CB2020,061,1,Manhattan,10210005000,0,0,0,3
2020,CB2020,061,1,Manhattan,10210005001,0,0,0,0.93
2020,CB2020,061,1,Manhattan,10210005002,0,0,0,0.92
2020,CB2020,061,1,Manhattan,10210006000,1723,706,1017,8.22
2020,CB2020,061,1,Manhattan,10211000001,0,0,0,0
2020,CB2020,061,1,Manhattan,10211001000,0,0,0,2.17
2020,CB2020,061,1,Manhattan,10211001001,0,0,0,0.5
2020,CB2020,061,1,Manhattan,10211001002,0,0,0,2.79
2020,CB2020,061,1,Manhattan,10211001003,0,0,0,13.75
2020,CB2020,061,1,Manhattan,10211001004,0,0,0,7.34
2020,CB2020,061,1,Manhattan,10211001005,0,0,0,3.57
2020,CB2020,061,1,Manhattan,10211001006,1948,1043,905,8.5
2020,CB2020,061,1,Manhattan,10211001007,38,17,21,2.12
2020,CB2020,061,1,Manhattan,10211002000,1269,597,672,6.97
2020,CB2020,061,1,Manhattan,10211003000,970,470,500,4.07
2020,CB2020,061,1,Manhattan,10211003001,825,421,404,5.88
2020,CB2020,061,1,Manhattan,10211004000,0,0,0,1.54
2020,CB2020,061,1,Manhattan,10211004001,1196,519,677,2.49
2020,CB2020,061,1,Manhattan,10211005000,1141,466,675,4.91
2020,CB2020,061,1,Manhattan,10211005001,588,235,353,2.51
2020,CB2020,061,1,Manhattan,10211006000,589,233,356,2.85
2020,CB2020,061,1,Manhattan,10211006001,1113,485,628,8.6
2020,CB2020,061,1,Manhattan,10211007000,731,356,375,2.75
2020,CB2020,061,1,Manhattan,10211007001,121,65,56,2.68
2020,CB2020,061,1,Manhattan,10212001000,1016,413,603,6.29
2020,CB2020,061,1,Manhattan,10212001001,1388,632,756,6.12
2020,CB2020,061,1,Manhattan,10212002000,9,8,1,6.11
2020,CB2020,061,1,Manhattan,10212002001,19,17,2,6.55
2020,CB2020,061,1,Manhattan,10212003000,863,375,488,5.82
2020,CB2020,061,1,Manhattan,10212004000,1604,666,938,12.7
2020,CB2020,061,1,Manhattan,10213031000,0,0,0,4.13
2020,CB2020,061,1,Manhattan,10213031001,803,400,403,3.68
2020,CB2020,061,1,Manhattan,10213031002,421,175,246,2.65
2020,CB2020,061,1,Manhattan,10213032000,234,116,118,3.3
2020,CB2020,061,1,Manhattan,10213032001,278,145,133,4.05
2020,CB2020,061,1,Manhattan,10213032002,161,83,78,4.56
2020,CB2020,061,1,Manhattan,10213032003,252,154,98,2.45
2020,CB2020,061,1,Manhattan,10213033000,1058,516,542,3.64
2020,CB2020,061,1,Manhattan,10213033001,831,406,425,2.92
2020,CB2020,061,1,Manhattan,10213034000,387,182,205,1.48
2020,CB2020,061,1,Manhattan,10213034001,464,233,231,2.11
2020,CB2020,061,1,Manhattan,10213034002,694,344,350,2.9
2020,CB2020,061,1,Manhattan,10214001000,14,5,9,9.45
2020,CB2020,061,1,Manhattan,10214001001,259,105,154,5.93
2020,CB2020,061,1,Manhattan,10214001002,5,3,2,2.82
2020,CB2020,061,1,Manhattan,10214001003,1215,555,660,5.53
2020,CB2020,061,1,Manhattan,10214001004,0,0,0,0.22
2020,CB2020,061,1,Manhattan,10214002000,1582,730,852,9.54
2020,CB2020,061,1,Manhattan,10215001000,177,84,93,2.07
2020,CB2020,061,1,Manhattan,10215001001,692,303,389,2.3
2020,CB2020,061,1,Manhattan,10215001002,213,107,106,2.58
2020,CB2020,061,1,Manhattan,10215002000,614,262,352,2.36
2020,CB2020,061,1,Manhattan,10215002001,1629,739,890,5.88
2020,CB2020,061,1,Manhattan,10215002002,531,229,302,2.05
2020,CB2020,061,1,Manhattan,10216001000,768,410,358,3.18
2020,CB2020,061,1,Manhattan,10216001001,434,204,230,2.22
2020,CB2020,061,1,Manhattan,10216001002,46,16,30,1.26
2020,CB2020,061,1,Manhattan,10216001003,18,10,8,0.35
2020,CB2020,061,1,Manhattan,10216001004,932,450,482,4.74
2020,CB2020,061,1,Manhattan,10216002000,906,433,473,4.17
2020,CB2020,061,1,Manhattan,10216003000,529,254,275,2.24
2020,CB2020,061,1,Manhattan,10216003001,560,265,295,3.2
2020,CB2020,061,1,Manhattan,10216004000,1246,591,655,5.41
2020,CB2020,061,1,Manhattan,10216004001,833,417,416,5.42
2020,CB2020,061,1,Manhattan,10216005000,1193,561,632,5.4
2020,CB2020,061,1,Manhattan,10216005001,1102,514,588,5.02
2020,CB2020,061,1,Manhattan,10216005002,0,0,0,0.19
2020,CB2020,061,1,Manhattan,10217031000,0,0,0,12.68
2020,CB2020,061,1,Manhattan,10217031001,0,0,0,1.45
2020,CB2020,061,1,Manhattan,10217031002,12,1,11,1.1
2020,CB2020,061,1,Manhattan,10217031003,0,0,0,12.29
2020,CB2020,061,1,Manhattan,10217031004,1,1,0,13.05
2020,CB2020,061,1,Manhattan,10217031005,0,0,0,15.57
2020,CB2020,061,1,Manhattan,10217031006,532,206,326,21.42
2020,CB2020,061,1,Manhattan,10218001000,683,329,354,5.42
2020,CB2020,061,1,Manhattan,10218001001,764,402,362,5.82
2020,CB2020,061,1,Manhattan,10218002000,828,386,442,5.58
2020,CB2020,061,1,Manhattan,10218002001,6,3,3,0.32
2020,CB2020,061,1,Manhattan,10218002002,128,74,54,1.27
2020,CB2020,061,1,Manhattan,10218002003,520,194,326,4.06
2020,CB2020,061,1,Manhattan,10218003000,959,493,466,5.88
2020,CB2020,061,1,Manhattan,10218003001,703,327,376,5.36
2020,CB2020,061,1,Manhattan,10218004000,345,164,181,1.79
2020,CB2020,061,1,Manhattan,10218004001,487,236,251,3.62
2020,CB2020,061,1,Manhattan,10218004002,1093,580,513,4.99
2020,CB2020,061,1,Manhattan,10218004003,14,8,6,0.82
2020,CB2020,061,1,Manhattan,10219000001,0,0,0,0
2020,CB2020,061,1,Manhattan,10219001000,206,100,106,5.4
2020,CB2020,061,1,Manhattan,10219001001,0,0,0,1.1
2020,CB2020,061,1,Manhattan,10219001002,0,0,0,0.64
2020,CB2020,061,1,Manhattan,10219001003,0,0,0,2.31
2020,CB2020,061,1,Manhattan,10219001004,0,0,0,0.34
2020,CB2020,061,1,Manhattan,10219001005,29,8,21,5.37
2020,CB2020,061,1,Manhattan,10219001006,0,0,0,2.7
2020,CB2020,061,1,Manhattan,10219001007,0,0,0,1.15
2020,CB2020,061,1,Manhattan,10219001008,0,0,0,0.27
2020,CB2020,061,1,Manhattan,10219001009,0,0,0,0.29
2020,CB2020,061,1,Manhattan,10219001010,0,0,0,0
2020,CB2020,061,1,Manhattan,10219001011,0,0,0,4.51
2020,CB2020,061,1,Manhattan,10219001012,0,0,0,5.38
2020,CB2020,061,1,Manhattan,10219001013,0,0,0,0.37
2020,CB2020,061,1,Manhattan,10219001014,0,0,0,0.81
2020,CB2020,061,1,Manhattan,10219001015,0,0,0,1.59
2020,CB2020,061,1,Manhattan,10219001016,497,252,245,2.03
2020,CB2020,061,1,Manhattan,10219001017,488,243,245,4.57
2020,CB2020,061,1,Manhattan,10219002000,705,345,360,2.39
2020,CB2020,061,1,Manhattan,10219002001,490,217,273,2.97
2020,CB2020,061,1,Manhattan,10219002002,28,18,10,3.69
2020,CB2020,061,1,Manhattan,10219003000,1083,485,598,3.77
2020,CB2020,061,1,Manhattan,10219003001,1611,662,949,8.51
2020,CB2020,061,1,Manhattan,10219004000,523,222,301,5.36
2020,CB2020,061,1,Manhattan,10219004001,0,0,0,0.38
2020,CB2020,061,1,Manhattan,10219004002,36,25,11,3.15
2020,CB2020,061,1,Manhattan,10220001000,389,208,181,5.39
2020,CB2020,061,1,Manhattan,10220001001,683,326,357,5.4
2020,CB2020,061,1,Manhattan,10220002000,447,223,224,3.69
2020,CB2020,061,1,Manhattan,10220002001,170,80,90,1.73
2020,CB2020,061,1,Manhattan,10220002002,658,299,359,5.39
2020,CB2020,061,1,Manhattan,10220003000,413,167,246,2.65
2020,CB2020,061,1,Manhattan,10220003001,248,89,159,1.05
2020,CB2020,061,1,Manhattan,10220004000,27,8,19,0.78
2020,CB2020,061,1,Manhattan,10220004001,331,142,189,1.7
2020,CB2020,061,1,Manhattan,10220004002,528,263,265,2.67
2020,CB2020,061,1,Manhattan,10220004003,472,205,267,2.74
2020,CB2020,061,1,Manhattan,10220005000,1221,537,684,5.37
2020,CB2020,061,1,Manhattan,10220005001,527,226,301,4.67
2020,CB2020,061,1,Manhattan,10221021000,0,0,0,2.6
2020,CB2020,061,1,Manhattan,10221021001,345,165,180,1.62
2020,CB2020,061,1,Manhattan,10221021002,316,155,161,1.35
2020,CB2020,061,1,Manhattan,10221021003,211,92,119,1.09
2020,CB2020,061,1,Manhattan,10221021004,305,117,188,2.6
2020,CB2020,061,1,Manhattan,10221021005,267,152,115,2.61
2020,CB2020,061,1,Manhattan,10221022000,273,144,129,2.61
2020,CB2020,061,1,Manhattan,10221022001,18,10,8,0.83
2020,CB2020,061,1,Manhattan,10221022002,0,0,0,0.56
2020,CB2020,061,1,Manhattan,10221022003,201,98,103,2.61
2020,CB2020,061,1,Manhattan,10221022004,0,0,0,2.83
2020,CB2020,061,1,Manhattan,10221022005,5,3,2,0.31
2020,CB2020,061,1,Manhattan,10221022006,441,222,219,2.84
2020,CB2020,061,1,Manhattan,10222001000,67,29,38,5.76
2020,CB2020,061,1,Manhattan,10222001001,58,36,22,5.85
2020,CB2020,061,1,Manhattan,10222001002,738,324,414,5.4
2020,CB2020,061,1,Manhattan,10222001003,1017,488,529,5.4
2020,CB2020,061,1,Manhattan,10222002000,55,29,26,5.77
2020,CB2020,061,1,Manhattan,10222002001,23,5,18,5.83
2020,CB2020,061,1,Manhattan,10222002002,732,401,331,5.4
2020,CB2020,061,1,Manhattan,10222002003,603,303,300,5.42
2020,CB2020,061,1,Manhattan,10223010001,0,0,0,0
2020,CB2020,061,1,Manhattan,10223011000,1361,646,715,5.84
2020,CB2020,061,1,Manhattan,10223012000,50,27,23,9.32
2020,CB2020,061,1,Manhattan,10223012001,11,6,5,1.45
2020,CB2020,061,1,Manhattan,10223012002,1982,989,993,5.57
2020,CB2020,061,1,Manhattan,10223013000,913,448,465,3.75
2020,CB2020,061,1,Manhattan,10223013001,60,44,16,3.67
2020,CB2020,061,1,Manhattan,10223013002,0,0,0,2.99
2020,CB2020,061,1,Manhattan,10223013003,0,0,0,0.62
2020,CB2020,061,1,Manhattan,10223013004,0,0,0,4.52
2020,CB2020,061,1,Manhattan,10223013005,1175,570,605,3.89
2020,CB2020,061,1,Manhattan,10223014000,1706,876,830,4.56
2020,CB2020,061,1,Manhattan,10223020001,0,0,0,0
2020,CB2020,061,1,Manhattan,10223021000,0,0,0,2.21
2020,CB2020,061,1,Manhattan,10223021001,0,0,0,0.46
2020,CB2020,061,1,Manhattan,10223021002,0,0,0,0.42
2020,CB2020,061,1,Manhattan,10223021003,0,0,0,0.51
2020,CB2020,061,1,Manhattan,10223022000,3101,1350,1751,11.24
2020,CB2020,061,1,Manhattan,10224001000,797,419,378,5.31
2020,CB2020,061,1,Manhattan,10224001001,830,431,399,5.4
2020,CB2020,061,1,Manhattan,10224002000,677,304,373,5.27
2020,CB2020,061,1,Manhattan,10224002001,921,481,440,5.43
2020,CB2020,061,1,Manhattan,10224002002,225,106,119,5.47
2020,CB2020,061,1,Manhattan,10224003000,1128,476,652,7.64
2020,CB2020,061,1,Manhattan,10224003001,537,197,340,2.96
2020,CB2020,061,1,Manhattan,10224004000,2231,943,1288,10.63
2020,CB2020,061,1,Manhattan,10225000001,0,0,0,0
2020,CB2020,061,1,Manhattan,10225001000,0,0,0,17.99
2020,CB2020,061,1,Manhattan,10225001001,0,0,0,0.9
2020,CB2020,061,1,Manhattan,10225001002,37,19,18,4.79
2020,CB2020,061,1,Manhattan,10225001003,60,23,37,3.09
2020,CB2020,061,1,Manhattan,10225001004,0,0,0,1.2
2020,CB2020,061,1,Manhattan,10225001005,1119,530,589,3.75
2020,CB2020,061,1,Manhattan,10225001006,1228,640,588,3.88
2020,CB2020,061,1,Manhattan,10225002000,1181,528,653,3.95
2020,CB2020,061,1,Manhattan,10225002001,1269,622,647,3.9
2020,CB2020,061,1,Manhattan,10225003000,588,290,298,3.75
2020,CB2020,061,1,Manhattan,10225003001,550,249,301,3.08
2020,CB2020,061,1,Manhattan,10225003002,477,245,232,2.42
2020,CB2020,061,1,Manhattan,10225003003,374,131,243,1.77
2020,CB2020,061,1,Manhattan,10225004000,355,174,181,1.63
2020,CB2020,061,1,Manhattan,10225004001,636,291,345,2.25
2020,CB2020,061,1,Manhattan,10225005000,826,436,390,2.94
2020,CB2020,061,1,Manhattan,10225005001,1195,525,670,3.57
2020,CB2020,061,1,Manhattan,10226001000,964,455,509,5.37
2020,CB2020,061,1,Manhattan,10226001001,421,210,211,2.75
2020,CB2020,061,1,Manhattan,10226001002,293,146,147,1.92
2020,CB2020,061,1,Manhattan,10226001003,98,53,45,0.63
2020,CB2020,061,1,Manhattan,10226002000,713,328,385,5.47
2020,CB2020,061,1,Manhattan,10226002001,424,198,226,5.41
2020,CB2020,061,1,Manhattan,10226003000,330,157,173,5.37
2020,CB2020,061,1,Manhattan,10226003001,484,208,276,3.43
2020,CB2020,061,1,Manhattan,10226003002,584,286,298,1.93
2020,CB2020,061,1,Manhattan,10226003003,579,277,302,5.5
2020,CB2020,061,1,Manhattan,10227001000,213,92,121,2.81
2020,CB2020,061,1,Manhattan,10227001001,274,143,131,2.6
2020,CB2020,061,1,Manhattan,10227001002,350,168,182,2.61
2020,CB2020,061,1,Manhattan,10227001003,385,241,144,2.63
2020,CB2020,061,1,Manhattan,10227001004,508,260,248,2.6
2020,CB2020,061,1,Manhattan,10227002000,746,371,375,8.67
2020,CB2020,061,1,Manhattan,10227002001,487,234,253,4.69
2020,CB2020,061,1,Manhattan,10227003000,183,93,90,0.94
2020,CB2020,061,1,Manhattan,10227003001,1949,944,1005,7.04
2020,CB2020,061,1,Manhattan,10227003002,292,154,138,2.65
2020,CB2020,061,1,Manhattan,10228001000,1136,553,583,5.37
2020,CB2020,061,1,Manhattan,10228001001,919,451,468,5.4
2020,CB2020,061,1,Manhattan,10228002000,812,349,463,5.76
2020,CB2020,061,1,Manhattan,10228002001,399,268,131,4.5
2020,CB2020,061,1,Manhattan,10228002002,304,124,180,1.28
2020,CB2020,061,1,Manhattan,10228003000,802,355,447,5.78
2020,CB2020,061,1,Manhattan,10228003001,418,207,211,5.78
2020,CB2020,061,1,Manhattan,10228004000,582,277,305,5.37
2020,CB2020,061,1,Manhattan,10228004001,589,258,331,5.38
2020,CB2020,061,1,Manhattan,10229000001,0,0,0,0
2020,CB2020,061,1,Manhattan,10229001000,373,194,179,2.92
2020,CB2020,061,1,Manhattan,10229001001,768,362,406,3.05
2020,CB2020,061,1,Manhattan,10229002000,224,99,125,0.96
2020,CB2020,061,1,Manhattan,10229002001,1290,686,604,4.42
2020,CB2020,061,1,Manhattan,10229003000,1003,476,527,5.79
2020,CB2020,061,1,Manhattan,10229003001,1132,537,595,5.78
2020,CB2020,061,1,Manhattan,10229004000,0,0,0,0.31
2020,CB2020,061,1,Manhattan,10229004001,1617,762,855,5.04
2020,CB2020,061,1,Manhattan,10229005000,40,9,31,3.92
2020,CB2020,061,1,Manhattan,10229005001,0,0,0,3.36
2020,CB2020,061,1,Manhattan,10229005002,0,0,0,0.55
2020,CB2020,061,1,Manhattan,10229005003,0,0,0,10.03
2020,CB2020,061,1,Manhattan,10229005004,787,369,418,3.13
2020,CB2020,061,1,Manhattan,10229005005,741,348,393,2.91
2020,CB2020,061,1,Manhattan,10230001000,1725,854,871,5.32
2020,CB2020,061,1,Manhattan,10230002000,592,331,261,5.35
2020,CB2020,061,1,Manhattan,10230002001,971,463,508,5.41
2020,CB2020,061,1,Manhattan,10230003000,1219,601,618,5.37
2020,CB2020,061,1,Manhattan,10230003001,462,214,248,5.36
2020,CB2020,061,1,Manhattan,10230004000,1292,572,720,5.37
2020,CB2020,061,1,Manhattan,10230004001,1356,616,740,5.37
2020,CB2020,061,1,Manhattan,10230005000,1494,705,789,5.36
2020,CB2020,061,1,Manhattan,10231001000,302,139,163,2.62
2020,CB2020,061,1,Manhattan,10231001001,604,329,275,2.61
2020,CB2020,061,1,Manhattan,10231001002,361,166,195,2.62
2020,CB2020,061,1,Manhattan,10231001003,491,235,256,2.62
2020,CB2020,061,1,Manhattan,10231001004,367,170,197,2.81
2020,CB2020,061,1,Manhattan,10231002000,0,0,0,0.6
2020,CB2020,061,1,Manhattan,10231002001,437,220,217,2.29
2020,CB2020,061,1,Manhattan,10231002002,344,171,173,2.61
2020,CB2020,061,1,Manhattan,10231002003,393,217,176,2.76
2020,CB2020,061,1,Manhattan,10231002004,371,165,206,2.77
2020,CB2020,061,1,Manhattan,10231002005,465,217,248,2.98
2020,CB2020,061,1,Manhattan,10231003000,0,0,0,9.08
2020,CB2020,061,1,Manhattan,10231004000,2138,998,1140,8.78
2020,CB2020,061,1,Manhattan,10232001000,646,339,307,5.77
2020,CB2020,061,1,Manhattan,10232001001,563,243,320,5.78
2020,CB2020,061,1,Manhattan,10232002000,1073,467,606,5.38
2020,CB2020,061,1,Manhattan,10232002001,1338,568,770,5.38
2020,CB2020,061,1,Manhattan,10232003000,849,320,529,5.36
2020,CB2020,061,1,Manhattan,10232003001,1198,547,651,5.37
2020,CB2020,061,1,Manhattan,10232004000,1384,625,759,5.78
2020,CB2020,061,1,Manhattan,10232004001,1010,479,531,5.79
2020,CB2020,061,1,Manhattan,10233000001,0,0,0,0
2020,CB2020,061,1,Manhattan,10233001000,602,286,316,2.78
2020,CB2020,061,1,Manhattan,10233001001,153,78,75,0.28
2020,CB2020,061,1,Manhattan,10233001002,55,32,23,7
2020,CB2020,061,1,Manhattan,10233001003,0,0,0,5.52
2020,CB2020,061,1,Manhattan,10233001004,0,0,0,1.22
2020,CB2020,061,1,Manhattan,10233001005,0,0,0,11.66
2020,CB2020,061,1,Manhattan,10233001006,362,172,190,2.45
2020,CB2020,061,1,Manhattan,10233001007,308,141,167,2.45
2020,CB2020,061,1,Manhattan,10233001008,662,333,329,2.53
2020,CB2020,061,1,Manhattan,10233002000,976,489,487,5.37
2020,CB2020,061,1,Manhattan,10233002001,1080,483,597,5.38
2020,CB2020,061,1,Manhattan,10233003000,1458,720,738,5.37
2020,CB2020,061,1,Manhattan,10233003001,712,373,339,5.38
2020,CB2020,061,1,Manhattan,10234001000,1195,603,592,5.17
2020,CB2020,061,1,Manhattan,10234001001,0,0,0,0.13
2020,CB2020,061,1,Manhattan,10234001002,1436,633,803,5.35
2020,CB2020,061,1,Manhattan,10234002000,856,417,439,5.4
2020,CB2020,061,1,Manhattan,10234002001,851,410,441,2.94
2020,CB2020,061,1,Manhattan,10234002002,600,259,341,2.43
2020,CB2020,061,1,Manhattan,10234002003,174,57,117,5.33
2020,CB2020,061,1,Manhattan,10235011000,941,561,380,4.08
2020,CB2020,061,1,Manhattan,10235011001,192,118,74,1.46
2020,CB2020,061,1,Manhattan,10235011002,188,65,123,1.11
2020,CB2020,061,1,Manhattan,10235011003,0,0,0,0.72
2020,CB2020,061,1,Manhattan,10235011004,304,146,158,1.65
2020,CB2020,061,1,Manhattan,10235011005,12,8,4,0.79
2020,CB2020,061,1,Manhattan,10235012000,361,174,187,3.53
2020,CB2020,061,1,Manhattan,10235012001,457,187,270,2.91
2020,CB2020,061,1,Manhattan,10235013000,921,460,461,3.43
2020,CB2020,061,1,Manhattan,10235013001,291,153,138,2.22
2020,CB2020,061,1,Manhattan,10235013002,500,215,285,3.91
2020,CB2020,061,1,Manhattan,10235013003,263,138,125,1.4
2020,CB2020,061,1,Manhattan,10235014000,0,0,0,9.02
2020,CB2020,061,1,Manhattan,10235015000,2290,1078,1212,8.03
2020,CB2020,061,1,Manhattan,10235021000,385,207,178,2.54
2020,CB2020,061,1,Manhattan,10235021001,348,147,201,2.05
2020,CB2020,061,1,Manhattan,10235021002,413,194,219,1.9
2020,CB2020,061,1,Manhattan,10235021003,551,308,243,1.86
2020,CB2020,061,1,Manhattan,10235021004,509,265,244,1.87
2020,CB2020,061,1,Manhattan,10236000001,0,0,0,0
2020,CB2020,061,1,Manhattan,10236001000,102,45,57,4.62
2020,CB2020,061,1,Manhattan,10236001001,594,261,333,3.41
2020,CB2020,061,1,Manhattan,10236001002,571,271,300,2.56
2020,CB2020,061,1,Manhattan,10236001003,333,150,183,1.71
2020,CB2020,061,1,Manhattan,10236001004,110,49,61,0.89
2020,CB2020,061,1,Manhattan,10236002000,0,0,0,0.27
2020,CB2020,061,1,Manhattan,10236002001,375,122,253,4.59
2020,CB2020,061,1,Manhattan,10236002002,0,0,0,0.55
2020,CB2020,061,1,Manhattan,10236002003,461,201,260,3.7
2020,CB2020,061,1,Manhattan,10236002004,858,444,414,4.46
2020,CB2020,061,1,Manhattan,10236003000,0,0,0,1
2020,CB2020,061,1,Manhattan,10236003001,0,0,0,1.74
2020,CB2020,061,1,Manhattan,10236003002,682,272,410,14.46
2020,CB2020,061,1,Manhattan,10236004000,4251,1708,2543,10.51
2020,CB2020,061,1,Manhattan,10236005000,0,0,0,2.57
2020,CB2020,061,1,Manhattan,10236005001,0,0,0,1.33
2020,CB2020,061,1,Manhattan,10236005002,1570,617,953,6.66
2020,CB2020,061,1,Manhattan,10237000001,0,0,0,0
2020,CB2020,061,1,Manhattan,10237001000,1554,774,780,5.39
2020,CB2020,061,1,Manhattan,10237001001,1262,606,656,5.37
2020,CB2020,061,1,Manhattan,10237002000,1121,504,617,3.6
2020,CB2020,061,1,Manhattan,10237002001,893,422,471,3.13
2020,CB2020,061,1,Manhattan,10237003000,37,20,17,12.66
2020,CB2020,061,1,Manhattan,10237003001,0,0,0,6.24
2020,CB2020,061,1,Manhattan,10237003002,0,0,0,1.16
2020,CB2020,061,1,Manhattan,10237003003,0,0,0,7.25
2020,CB2020,061,1,Manhattan,10237003004,0,0,0,1.27
2020,CB2020,061,1,Manhattan,10237003005,1049,477,572,4.6
2020,CB2020,061,1,Manhattan,10237003006,834,404,430,5.37
2020,CB2020,061,1,Manhattan,10237003007,42,15,27,11.15
2020,CB2020,061,1,Manhattan,10238020001,0,0,0,0
2020,CB2020,061,1,Manhattan,10238021000,0,0,0,3.59
2020,CB2020,061,1,Manhattan,10238021001,954,467,487,5.48
2020,CB2020,061,1,Manhattan,10238021002,624,231,393,1.84
2020,CB2020,061,1,Manhattan,10238021003,2681,1226,1455,15.29
2020,CB2020,061,1,Manhattan,10238021004,0,0,0,1.91
2020,CB2020,061,1,Manhattan,10238021005,0,0,0,0.79
2020,CB2020,061,1,Manhattan,10238022000,0,0,0,0.83
2020,CB2020,061,1,Manhattan,10238022001,0,0,0,7.18
2020,CB2020,061,1,Manhattan,10238023000,532,363,169,23.25
2020,CB2020,061,1,Manhattan,10238030001,0,0,0,0
2020,CB2020,061,1,Manhattan,10238031000,0,0,0,1.53
2020,CB2020,061,1,Manhattan,10238031001,1965,822,1143,12.14
2020,CB2020,061,1,Manhattan,10238032000,1650,717,933,10.37
2020,CB2020,061,1,Manhattan,10238032001,10,4,6,1.92
2020,CB2020,061,1,Manhattan,10238040001,0,0,0,0
2020,CB2020,061,1,Manhattan,10238040002,0,0,0,0
2020,CB2020,061,1,Manhattan,10238040003,0,0,0,0
2020,CB2020,061,1,Manhattan,10238041000,29,13,16,18.04
2020,CB2020,061,1,Manhattan,10238041001,426,248,178,18.5
2020,CB2020,061,1,Manhattan,10238042000,437,196,241,9.22
2020,CB2020,061,1,Manhattan,10238042001,1213,592,621,5.6
2020,CB2020,061,1,Manhattan,10238042002,0,0,0,1.39
2020,CB2020,061,1,Manhattan,10238042003,0,0,0,3.38
2020,CB2020,061,1,Manhattan,10238042004,0,0,0,0.53
2020,CB2020,061,1,Manhattan,10238043000,1201,614,587,3.51
2020,CB2020,061,1,Manhattan,10238043001,0,0,0,0.97
2020,CB2020,061,1,Manhattan,10239001000,407,169,238,1.97
2020,CB2020,061,1,Manhattan,10239001001,316,167,149,1.66
2020,CB2020,061,1,Manhattan,10239001002,537,231,306,3.17
2020,CB2020,061,1,Manhattan,10239002000,508,224,284,1.59
2020,CB2020,061,1,Manhattan,10239002001,400,198,202,1.95
2020,CB2020,061,1,Manhattan,10239002002,507,230,277,5.43
2020,CB2020,061,1,Manhattan,10240000001,0,0,0,0
2020,CB2020,061,1,Manhattan,10240000002,0,0,0,0
2020,CB2020,061,1,Manhattan,10240000003,0,0,0,0
2020,CB2020,061,1,Manhattan,10240000004,0,0,0,0
2020,CB2020,061,1,Manhattan,10240001000,0,0,0,28.53
2020,CB2020,061,1,Manhattan,10240001001,0,0,0,0.47
2020,CB2020,061,1,Manhattan,10240001002,0,0,0,7.87
2020,CB2020,061,1,Manhattan,10240001003,0,0,0,0.66
2020,CB2020,061,1,Manhattan,10240001004,0,0,0,1.7
2020,CB2020,061,1,Manhattan,10240001005,0,0,0,2.14
2020,CB2020,061,1,Manhattan,10240001006,0,0,0,0.44
2020,CB2020,061,1,Manhattan,10240001007,0,0,0,1.87
2020,CB2020,061,1,Manhattan,10240001008,0,0,0,70.52
2020,CB2020,061,1,Manhattan,10240001009,0,0,0,7.48
2020,CB2020,061,1,Manhattan,10240001010,0,0,0,0.6
2020,CB2020,061,1,Manhattan,10240001011,0,0,0,1.94
2020,CB2020,061,1,Manhattan,10240001012,0,0,0,3.61
2020,CB2020,061,1,Manhattan,10240001013,2,1,1,101.33
2020,CB2020,061,1,Manhattan,10240001014,0,0,0,2.22
2020,CB2020,061,1,Manhattan,10240001015,0,0,0,3.15
2020,CB2020,061,1,Manhattan,10240002000,158,146,12,52.07
2020,CB2020,061,1,Manhattan,10240002001,507,454,53,27.68
2020,CB2020,061,1,Manhattan,10240002002,0,0,0,2.8
2020,CB2020,061,1,Manhattan,10240002003,0,0,0,2.14
2020,CB2020,061,1,Manhattan,10240002004,0,0,0,2.49
2020,CB2020,061,1,Manhattan,10240002005,0,0,0,2.04
2020,CB2020,061,1,Manhattan,10240002006,635,598,37,111.4
2020,CB2020,061,1,Manhattan,10240002007,0,0,0,0.67
2020,CB2020,061,1,Manhattan,10240003000,0,0,0,103.89
2020,CB2020,061,1,Manhattan,10241000001,0,0,0,0
2020,CB2020,061,1,Manhattan,10241001000,0,0,0,1.46
2020,CB2020,061,1,Manhattan,10241001001,200,106,94,1.45
2020,CB2020,061,1,Manhattan,10241001002,1731,732,999,8.03
2020,CB2020,061,1,Manhattan,10241001003,0,0,0,3.45
2020,CB2020,061,1,Manhattan,10241001004,0,0,0,0.88
2020,CB2020,061,1,Manhattan,10241001005,0,0,0,1.96
2020,CB2020,061,1,Manhattan,10241001006,0,0,0,0.68
2020,CB2020,061,1,Manhattan,10241001007,0,0,0,0.56
2020,CB2020,061,1,Manhattan,10241002000,1214,619,595,4.03
2020,CB2020,061,1,Manhattan,10241002001,321,135,186,4.74
2020,CB2020,061,1,Manhattan,10241002002,0,0,0,0.46
2020,CB2020,061,1,Manhattan,10241003000,1159,537,622,5.76
2020,CB2020,061,1,Manhattan,10241004000,1572,754,818,5.37
2020,CB2020,061,1,Manhattan,10241005000,1415,668,747,5.35
2020,CB2020,061,1,Manhattan,10242000001,0,0,0,0
2020,CB2020,061,1,Manhattan,10242000002,0,0,0,0
2020,CB2020,061,1,Manhattan,10242001000,0,0,0,4.46
2020,CB2020,061,1,Manhattan,10242001001,0,0,0,1.13
2020,CB2020,061,1,Manhattan,10242001002,408,179,229,3.77
2020,CB2020,061,1,Manhattan,10242001003,817,371,446,3.08
2020,CB2020,061,1,Manhattan,10242001004,0,0,0,3.35
2020,CB2020,061,1,Manhattan,10242001005,366,120,246,3.06
2020,CB2020,061,1,Manhattan,10242001006,488,202,286,3.05
2020,CB2020,061,1,Manhattan,10242001007,0,0,0,2.08
2020,CB2020,061,1,Manhattan,10242002000,0,0,0,3.11
2020,CB2020,061,1,Manhattan,10242002001,524,231,293,3.06
2020,CB2020,061,1,Manhattan,10242002002,615,262,353,3.06
2020,CB2020,061,1,Manhattan,10242002003,167,65,102,3.03
2020,CB2020,061,1,Manhattan,10242003000,0,0,0,5.24
2020,CB2020,061,1,Manhattan,10242003001,0,0,0,1.24
2020,CB2020,061,1,Manhattan,10242003002,55,25,30,6.92
2020,CB2020,061,1,Manhattan,10242003003,31,15,16,3.81
2020,CB2020,061,1,Manhattan,10242003004,20,14,6,4.23
2020,CB2020,061,1,Manhattan,10242003005,0,0,0,4.21
2020,CB2020,061,1,Manhattan,10242003006,22,12,10,4.56
2020,CB2020,061,1,Manhattan,10242003007,643,305,338,4.6
2020,CB2020,061,1,Manhattan,10242003008,0,0,0,5.49
2020,CB2020,061,1,Manhattan,10242003009,292,163,129,4.43
2020,CB2020,061,1,Manhattan,10242003010,0,0,0,4.05
2020,CB2020,061,1,Manhattan,10242003011,0,0,0,0.35
2020,CB2020,061,1,Manhattan,10242003012,0,0,0,0.47
2020,CB2020,061,1,Manhattan,10243011000,585,262,323,3.53
2020,CB2020,061,1,Manhattan,10243011001,662,314,348,2.1
2020,CB2020,061,1,Manhattan,10243011002,125,89,36,2.03
2020,CB2020,061,1,Manhattan,10243012000,804,433,371,4.5
2020,CB2020,061,1,Manhattan,10243012001,188,101,87,2.2
2020,CB2020,061,1,Manhattan,10243012002,0,0,0,2.53
2020,CB2020,061,1,Manhattan,10243012003,140,81,59,0.98
2020,CB2020,061,1,Manhattan,10243012004,790,379,411,2.7
2020,CB2020,061,1,Manhattan,10243013000,449,228,221,2.58
2020,CB2020,061,1,Manhattan,10243013001,245,113,132,1.84
2020,CB2020,061,1,Manhattan,10243013002,5,3,2,1
2020,CB2020,061,1,Manhattan,10243020001,0,0,0,0
2020,CB2020,061,1,Manhattan,10243021000,0,0,0,2.91
2020,CB2020,061,1,Manhattan,10243021001,0,0,0,2.49
2020,CB2020,061,1,Manhattan,10243021002,49,24,25,4.15
2020,CB2020,061,1,Manhattan,10243021003,157,132,25,7.1
2020,CB2020,061,1,Manhattan,10243021004,2289,954,1335,9.06
2020,CB2020,061,1,Manhattan,10243022000,2394,949,1445,11.18
2020,CB2020,061,1,Manhattan,10243023000,2348,975,1373,15.82
2020,CB2020,061,1,Manhattan,10245001000,739,320,419,3.25
2020,CB2020,061,1,Manhattan,10245001001,1117,541,576,3.52
2020,CB2020,061,1,Manhattan,10245002000,1067,467,600,4.76
2020,CB2020,061,1,Manhattan,10245002001,861,431,430,3.18
2020,CB2020,061,1,Manhattan,10245003000,876,403,473,2.85
2020,CB2020,061,1,Manhattan,10245003001,538,263,275,2.51
2020,CB2020,061,1,Manhattan,10245004000,1328,639,689,4.39
2020,CB2020,061,1,Manhattan,10245004001,1008,503,505,5.35
2020,CB2020,061,1,Manhattan,10245004002,0,0,0,0.29
2020,CB2020,061,1,Manhattan,10245005000,276,136,140,1
2020,CB2020,061,1,Manhattan,10245005001,1501,701,800,5.38
2020,CB2020,061,1,Manhattan,10245005002,687,333,354,2.17
2020,CB2020,061,1,Manhattan,10245005003,207,129,78,1.68
2020,CB2020,061,1,Manhattan,10245006000,327,167,160,1.3
2020,CB2020,061,1,Manhattan,10245006001,1232,631,601,5.35
2020,CB2020,061,1,Manhattan,10245007000,1621,808,813,5.41
2020,CB2020,061,1,Manhattan,10247000001,0,0,0,0
2020,CB2020,061,1,Manhattan,10247001000,36,22,14,7.15
2020,CB2020,061,1,Manhattan,10247001001,0,0,0,1.69
2020,CB2020,061,1,Manhattan,10247001002,0,0,0,5.31
2020,CB2020,061,1,Manhattan,10247001003,0,0,0,9.9
2020,CB2020,061,1,Manhattan,10247001004,1138,535,603,6.55
2020,CB2020,061,1,Manhattan,10247001005,141,62,79,1.94
2020,CB2020,061,1,Manhattan,10247002000,1389,660,729,6.43
2020,CB2020,061,1,Manhattan,10247003000,1287,603,684,4.44
2020,CB2020,061,1,Manhattan,10247004000,1358,662,696,3.99
2020,CB2020,061,1,Manhattan,10247005000,325,153,172,8.95
2020,CB2020,061,1,Manhattan,10247005001,0,0,0,3.67
2020,CB2020,061,1,Manhattan,10247005002,847,389,458,3.32
2020,CB2020,061,1,Manhattan,10249001000,0,0,0,0.46
2020,CB2020,061,1,Manhattan,10249001001,227,119,108,3.1
2020,CB2020,061,1,Manhattan,10249001002,24,12,12,4.18
2020,CB2020,061,1,Manhattan,10249001003,0,0,0,1.62
2020,CB2020,061,1,Manhattan,10249001004,524,241,283,2.77
2020,CB2020,061,1,Manhattan,10249001005,309,176,133,2.86
2020,CB2020,061,1,Manhattan,10251001000,4,1,3,2.09
2020,CB2020,061,1,Manhattan,10251001001,291,189,102,4.67
2020,CB2020,061,1,Manhattan,10251001002,24,10,14,12.53
2020,CB2020,061,1,Manhattan,10251001003,27,17,10,2.36
2020,CB2020,061,1,Manhattan,10251001004,0,0,0,0.75
2020,CB2020,061,1,Manhattan,10251001005,0,0,0,1.37
2020,CB2020,061,1,Manhattan,10251001006,293,141,152,2.66
2020,CB2020,061,1,Manhattan,10251001007,501,233,268,2.85
2020,CB2020,061,1,Manhattan,10251001008,0,0,0,0.72
2020,CB2020,061,1,Manhattan,10251002000,668,321,347,2.68
2020,CB2020,061,1,Manhattan,10251002001,0,0,0,2.31
2020,CB2020,061,1,Manhattan,10251002002,0,0,0,1.83
2020,CB2020,061,1,Manhattan,10251002003,479,202,277,2.56
2020,CB2020,061,1,Manhattan,10253001000,895,435,460,2.8
2020,CB2020,061,1,Manhattan,10253001001,822,383,439,2.62
2020,CB2020,061,1,Manhattan,10253002000,730,336,394,2.68
2020,CB2020,061,1,Manhattan,10253002001,896,432,464,2.53
2020,CB2020,061,1,Manhattan,10253003000,1017,487,530,2.82
2020,CB2020,061,1,Manhattan,10253003001,720,349,371,2.59
2020,CB2020,061,1,Manhattan,10253004000,448,178,270,2.26
2020,CB2020,061,1,Manhattan,10253004001,116,52,64,1.63
2020,CB2020,061,1,Manhattan,10253004002,0,0,0,1.08
2020,CB2020,061,1,Manhattan,10253004003,17,15,2,0.34
2020,CB2020,061,1,Manhattan,10253004004,189,83,106,2.51
2020,CB2020,061,1,Manhattan,10253004005,576,274,302,2.68
2020,CB2020,061,1,Manhattan,10253005000,877,399,478,3.19
2020,CB2020,061,1,Manhattan,10253005001,954,395,559,3.35
2020,CB2020,061,1,Manhattan,10253006000,1057,491,566,4.12
2020,CB2020,061,1,Manhattan,10253006001,767,384,383,4.65
2020,CB2020,061,1,Manhattan,10255000001,0,0,0,0
2020,CB2020,061,1,Manhattan,10255001000,0,0,0,12.03
2020,CB2020,061,1,Manhattan,10255001001,0,0,0,12.17
2020,CB2020,061,1,Manhattan,10255001002,0,0,0,19.59
2020,CB2020,061,1,Manhattan,10255001003,8,4,4,16.51
2020,CB2020,061,1,Manhattan,10255001004,51,30,21,7.02
2020,CB2020,061,1,Manhattan,10255001005,221,108,113,1.91
2020,CB2020,061,1,Manhattan,10255001006,277,125,152,0.93
2020,CB2020,061,1,Manhattan,10255001007,1487,622,865,14.11
2020,CB2020,061,1,Manhattan,10255002000,239,113,126,1.44
2020,CB2020,061,1,Manhattan,10255002001,643,322,321,2.43
2020,CB2020,061,1,Manhattan,10255002002,264,119,145,9.5
2020,CB2020,061,1,Manhattan,10255003000,961,485,476,3.33
2020,CB2020,061,1,Manhattan,10255003001,663,293,370,2.55
2020,CB2020,061,1,Manhattan,10255004000,561,222,339,2.23
2020,CB2020,061,1,Manhattan,10255004001,322,138,184,1.81
2020,CB2020,061,1,Manhattan,10255004002,0,0,0,1.49
2020,CB2020,061,1,Manhattan,10257001000,119,55,64,2.89
2020,CB2020,061,1,Manhattan,10257001001,0,0,0,2.91
2020,CB2020,061,1,Manhattan,10257001002,229,120,109,2.19
2020,CB2020,061,1,Manhattan,10257001003,0,0,0,0.56
2020,CB2020,061,1,Manhattan,10257001004,316,147,169,1.57
2020,CB2020,061,1,Manhattan,10257001005,345,144,201,2.66
2020,CB2020,061,1,Manhattan,10257001006,0,0,0,1.18
2020,CB2020,061,1,Manhattan,10257002000,281,136,145,2.51
2020,CB2020,061,1,Manhattan,10257002001,429,195,234,2.64
2020,CB2020,061,1,Manhattan,10257002002,353,179,174,2.64
2020,CB2020,061,1,Manhattan,10257002003,399,182,217,2.76
2020,CB2020,061,1,Manhattan,10257002004,0,0,0,0.26
2020,CB2020,061,1,Manhattan,10257003000,432,226,206,1.88
2020,CB2020,061,1,Manhattan,10257003001,173,78,95,0.88
2020,CB2020,061,1,Manhattan,10257003002,0,0,0,2.65
2020,CB2020,061,1,Manhattan,10257003003,530,224,306,2.65
2020,CB2020,061,1,Manhattan,10257003004,664,299,365,2.77
2020,CB2020,061,1,Manhattan,10259001000,404,201,203,1.86
2020,CB2020,061,1,Manhattan,10259001001,562,254,308,1.87
2020,CB2020,061,1,Manhattan,10259001002,464,199,265,1.86
2020,CB2020,061,1,Manhattan,10259001003,391,187,204,1.91
2020,CB2020,061,1,Manhattan,10259001004,427,209,218,2.01
2020,CB2020,061,1,Manhattan,10259002000,302,158,144,2.14
2020,CB2020,061,1,Manhattan,10259002001,439,187,252,2.14
2020,CB2020,061,1,Manhattan,10259002002,473,189,284,2.35
2020,CB2020,061,1,Manhattan,10259002003,567,281,286,2.52
2020,CB2020,061,1,Manhattan,10261001000,879,427,452,2.83
2020,CB2020,061,1,Manhattan,10261001001,612,263,349,2.72
2020,CB2020,061,1,Manhattan,10261001002,440,209,231,1.78
2020,CB2020,061,1,Manhattan,10261001003,331,171,160,0.96
2020,CB2020,061,1,Manhattan,10261002000,850,420,430,2.64
2020,CB2020,061,1,Manhattan,10261002001,582,273,309,2.62
2020,CB2020,061,1,Manhattan,10261003000,0,0,0,0.48
2020,CB2020,061,1,Manhattan,10261003001,0,0,0,0.49
2020,CB2020,061,1,Manhattan,10261003002,677,321,356,0.55
2020,CB2020,061,1,Manhattan,10261003003,706,324,382,0.6
2020,CB2020,061,1,Manhattan,10261003004,0,0,0,0.53
2020,CB2020,061,1,Manhattan,10261003005,0,0,0,0.56
2020,CB2020,061,1,Manhattan,10261003006,0,0,0,0.49
2020,CB2020,061,1,Manhattan,10261003007,0,0,0,0.76
2020,CB2020,061,1,Manhattan,10261003008,0,0,0,0.55
2020,CB2020,061,1,Manhattan,10261003009,0,0,0,0.57
2020,CB2020,061,1,Manhattan,10261004000,684,328,356,2.75
2020,CB2020,061,1,Manhattan,10261004001,841,361,480,2.63
2020,CB2020,061,1,Manhattan,10261005000,808,373,435,2.71
2020,CB2020,061,1,Manhattan,10261005001,761,340,421,2.75
2020,CB2020,061,1,Manhattan,10261006000,906,426,480,2.94
2020,CB2020,061,1,Manhattan,10261007000,893,465,428,2.91
2020,CB2020,061,1,Manhattan,10261007001,582,297,285,1.82
2020,CB2020,061,1,Manhattan,10261007002,181,81,100,0.96
2020,CB2020,061,1,Manhattan,10263001000,417,203,214,2.34
2020,CB2020,061,1,Manhattan,10263001001,298,152,146,2
2020,CB2020,061,1,Manhattan,10263001002,0,0,0,0.37
2020,CB2020,061,1,Manhattan,10263001003,0,0,0,0.38
2020,CB2020,061,1,Manhattan,10263001004,0,0,0,0.74
2020,CB2020,061,1,Manhattan,10263001005,0,0,0,0.31
2020,CB2020,061,1,Manhattan,10263001006,0,0,0,0.46
2020,CB2020,061,1,Manhattan,10263001007,0,0,0,0.5
2020,CB2020,061,1,Manhattan,10263001008,41,24,17,0.37
2020,CB2020,061,1,Manhattan,10263001009,23,19,4,0.64
2020,CB2020,061,1,Manhattan,10263001010,1310,608,702,0.47
2020,CB2020,061,1,Manhattan,10263001011,0,0,0,0.42
2020,CB2020,061,1,Manhattan,10263002000,758,369,389,2.33
2020,CB2020,061,1,Manhattan,10263002001,645,303,342,2.33
2020,CB2020,061,1,Manhattan,10263003000,496,212,284,2.52
2020,CB2020,061,1,Manhattan,10263003001,430,218,212,2.39
2020,CB2020,061,1,Manhattan,10263003002,190,82,108,1.16
2020,CB2020,061,1,Manhattan,10263003003,371,178,193,1.25
2020,CB2020,061,1,Manhattan,10263004000,16,7,9,1.57
2020,CB2020,061,1,Manhattan,10263004001,763,346,417,2.75
2020,CB2020,061,1,Manhattan,10263004002,617,279,338,2.47
2020,CB2020,061,1,Manhattan,10263004003,0,0,0,1.01
2020,CB2020,061,1,Manhattan,10263004004,0,0,0,0.51
2020,CB2020,061,1,Manhattan,10263004005,196,72,124,0.95
2020,CB2020,061,1,Manhattan,10263004006,87,43,44,2.08
2020,CB2020,061,1,Manhattan,10263005000,603,299,304,2.23
2020,CB2020,061,1,Manhattan,10263005001,133,69,64,1.92
2020,CB2020,061,1,Manhattan,10263005002,575,269,306,2.39
2020,CB2020,061,1,Manhattan,10265001000,642,301,341,2.5
2020,CB2020,061,1,Manhattan,10265001001,377,173,204,1.52
2020,CB2020,061,1,Manhattan,10265002000,0,0,0,0.48
2020,CB2020,061,1,Manhattan,10265002001,0,0,0,0.46
2020,CB2020,061,1,Manhattan,10265002002,0,0,0,0.26
2020,CB2020,061,1,Manhattan,10265002003,0,0,0,0.57
2020,CB2020,061,1,Manhattan,10265002004,0,0,0,0.64
2020,CB2020,061,1,Manhattan,10265002005,0,0,0,0.59
2020,CB2020,061,1,Manhattan,10265002006,0,0,0,1.09
2020,CB2020,061,1,Manhattan,10265002007,11,8,3,5.87
2020,CB2020,061,1,Manhattan,10265002008,0,0,0,1.9
2020,CB2020,061,1,Manhattan,10265002009,0,0,0,0.47
2020,CB2020,061,1,Manhattan,10265002010,0,0,0,0.4
2020,CB2020,061,1,Manhattan,10265002011,0,0,0,0.73
2020,CB2020,061,1,Manhattan,10265002012,443,210,233,1.9
2020,CB2020,061,1,Manhattan,10265002013,459,205,254,1.84
2020,CB2020,061,1,Manhattan,10265002014,880,444,436,3.17
2020,CB2020,061,1,Manhattan,10265003000,295,148,147,2.38
2020,CB2020,061,1,Manhattan,10265003001,680,321,359,3.7
2020,CB2020,061,1,Manhattan,10265003002,0,0,0,1.34
2020,CB2020,061,1,Manhattan,10265003003,0,0,0,0.3
2020,CB2020,061,1,Manhattan,10265003004,0,0,0,0.28
2020,CB2020,061,1,Manhattan,10265003005,0,0,0,3.2
2020,CB2020,061,1,Manhattan,10265004000,1306,599,707,5.01
2020,CB2020,061,1,Manhattan,10265004001,785,376,409,3.59
2020,CB2020,061,1,Manhattan,10265005000,562,291,271,2.34
2020,CB2020,061,1,Manhattan,10265005001,410,155,255,1.67
2020,CB2020,061,1,Manhattan,10267001000,194,91,103,0.61
2020,CB2020,061,1,Manhattan,10267001001,243,136,107,0.87
2020,CB2020,061,1,Manhattan,10267001002,604,324,280,2.33
2020,CB2020,061,1,Manhattan,10267001003,212,83,129,1.11
2020,CB2020,061,1,Manhattan,10267001004,491,489,2,4
2020,CB2020,061,1,Manhattan,10267001005,339,176,163,2.78
2020,CB2020,061,1,Manhattan,10269001000,828,370,458,2.74
2020,CB2020,061,1,Manhattan,10269001001,362,164,198,1.35
2020,CB2020,061,1,Manhattan,10269001002,138,113,25,1.64
2020,CB2020,061,1,Manhattan,10269002000,42,26,16,1.35
2020,CB2020,061,1,Manhattan,10269002001,275,154,121,1.58
2020,CB2020,061,1,Manhattan,10269002002,0,0,0,1.04
2020,CB2020,061,1,Manhattan,10269002003,306,129,177,1.52
2020,CB2020,061,1,Manhattan,10269002004,860,466,394,2.53
2020,CB2020,061,1,Manhattan,10269003000,140,60,80,2.7
2020,CB2020,061,1,Manhattan,10269003001,388,171,217,2.53
2020,CB2020,061,1,Manhattan,10269003002,250,122,128,3.06
2020,CB2020,061,1,Manhattan,10269004000,349,186,163,2.57
2020,CB2020,061,1,Manhattan,10269004001,302,169,133,2.42
2020,CB2020,061,1,Manhattan,10269004002,428,227,201,2.93
2020,CB2020,061,1,Manhattan,10269005000,647,310,337,2.88
2020,CB2020,061,1,Manhattan,10269005001,555,286,269,2.53
2020,CB2020,061,1,Manhattan,10269005002,527,277,250,2.47
2020,CB2020,061,1,Manhattan,10269006000,548,236,312,1.7
2020,CB2020,061,1,Manhattan,10269006001,256,113,143,0.93
2020,CB2020,061,1,Manhattan,10269006002,647,331,316,2.88
2020,CB2020,061,1,Manhattan,10271001000,429,220,209,2.54
2020,CB2020,061,1,Manhattan,10271001001,685,329,356,2.55
2020,CB2020,061,1,Manhattan,10271001002,499,227,272,2.24
2020,CB2020,061,1,Manhattan,10271002000,591,297,294,2.21
2020,CB2020,061,1,Manhattan,10271002001,341,165,176,2.27
2020,CB2020,061,1,Manhattan,10271002002,213,110,103,2.15
2020,CB2020,061,1,Manhattan,10271002003,409,203,206,2.59
2020,CB2020,061,1,Manhattan,10271003000,403,191,212,5.46
2020,CB2020,061,1,Manhattan,10271003001,353,161,192,2.13
2020,CB2020,061,1,Manhattan,10271003002,407,224,183,1.84
2020,CB2020,061,1,Manhattan,10271003003,150,75,75,1.72
2020,CB2020,061,1,Manhattan,10271003004,281,139,142,1.44
2020,CB2020,061,1,Manhattan,10271003005,229,101,128,1.79
2020,CB2020,061,1,Manhattan,10271004000,303,150,153,2.5
2020,CB2020,061,1,Manhattan,10271004001,349,160,189,2.86
2020,CB2020,061,1,Manhattan,10271004002,536,226,310,4.71
2020,CB2020,061,1,Manhattan,10271005000,844,398,446,3.68
2020,CB2020,061,1,Manhattan,10271005001,601,272,329,2.98
2020,CB2020,061,1,Manhattan,10273001000,167,74,93,5.79
2020,CB2020,061,1,Manhattan,10273001001,740,336,404,5.37
2020,CB2020,061,1,Manhattan,10273001002,828,392,436,4.11
2020,CB2020,061,1,Manhattan,10273002000,1160,549,611,6.93
2020,CB2020,061,1,Manhattan,10273003000,989,462,527,6.62
2020,CB2020,061,1,Manhattan,10273003001,0,0,0,2.87
2020,CB2020,061,1,Manhattan,10273003002,757,352,405,2.85
2020,CB2020,061,1,Manhattan,10273003003,583,268,315,2.24
2020,CB2020,061,1,Manhattan,10273004000,818,374,444,4.02
2020,CB2020,061,1,Manhattan,10273004001,477,243,234,2.91
2020,CB2020,061,1,Manhattan,10275000001,0,0,0,0
2020,CB2020,061,1,Manhattan,10275000002,0,0,0,0
2020,CB2020,061,1,Manhattan,10275001000,0,0,0,12.55
2020,CB2020,061,1,Manhattan,10275001001,0,0,0,12.02
2020,CB2020,061,1,Manhattan,10275001002,0,0,0,0.7
2020,CB2020,061,1,Manhattan,10275001003,0,0,0,16
2020,CB2020,061,1,Manhattan,10275001004,178,78,100,1.09
2020,CB2020,061,1,Manhattan,10275001005,0,0,0,1.3
2020,CB2020,061,1,Manhattan,10275001006,531,252,279,8.96
2020,CB2020,061,1,Manhattan,10275001007,0,0,0,0.54
2020,CB2020,061,1,Manhattan,10275001008,0,0,0,1.83
2020,CB2020,061,1,Manhattan,10275001009,486,241,245,1.9
2020,CB2020,061,1,Manhattan,10275002000,1868,911,957,11.18
2020,CB2020,061,1,Manhattan,10275002001,0,0,0,1.04
2020,CB2020,061,1,Manhattan,10277001000,604,263,341,18.64
2020,CB2020,061,1,Manhattan,10277001001,229,96,133,1.54
2020,CB2020,061,1,Manhattan,10277001002,780,393,387,2.63
2020,CB2020,061,1,Manhattan,10277001003,233,102,131,2.75
2020,CB2020,061,1,Manhattan,10277002000,760,355,405,2.52
2020,CB2020,061,1,Manhattan,10277002001,710,327,383,2.63
2020,CB2020,061,1,Manhattan,10277003000,865,390,475,2.63
2020,CB2020,061,1,Manhattan,10277003001,801,372,429,2.74
2020,CB2020,061,1,Manhattan,10277004000,479,200,279,1.64
2020,CB2020,061,1,Manhattan,10277004001,962,492,470,2.65
2020,CB2020,061,1,Manhattan,10279001000,520,225,295,2.92
2020,CB2020,061,1,Manhattan,10279001001,383,203,180,2.69
2020,CB2020,061,1,Manhattan,10279002000,133,66,67,0.8
2020,CB2020,061,1,Manhattan,10279002001,731,310,421,2.23
2020,CB2020,061,1,Manhattan,10279002002,637,322,315,2.42
2020,CB2020,061,1,Manhattan,10279003000,595,283,312,2.23
2020,CB2020,061,1,Manhattan,10279003001,650,288,362,2.34
2020,CB2020,061,1,Manhattan,10279003002,547,255,292,2.32
2020,CB2020,061,1,Manhattan,10279004000,1259,559,700,10.51
2020,CB2020,061,1,Manhattan,10279004001,386,186,200,1.44
2020,CB2020,061,1,Manhattan,10279005000,570,257,313,3.61
2020,CB2020,061,1,Manhattan,10279005001,965,413,552,3.36
2020,CB2020,061,1,Manhattan,10279006000,1406,637,769,3.84
2020,CB2020,061,1,Manhattan,10279006001,359,169,190,1.41
2020,CB2020,061,1,Manhattan,10279007000,878,408,470,2.37
2020,CB2020,061,1,Manhattan,10281001000,844,394,450,4.45
2020,CB2020,061,1,Manhattan,10281002000,2264,1070,1194,18.84
2020,CB2020,061,1,Manhattan,10283001000,726,352,374,3.61
2020,CB2020,061,1,Manhattan,10283002000,3286,1471,1815,19.09
2020,CB2020,061,1,Manhattan,10283003000,1231,597,634,4.15
2020,CB2020,061,1,Manhattan,10283003001,239,104,135,0.96
2020,CB2020,061,1,Manhattan,10283004000,883,416,467,3.09
2020,CB2020,061,1,Manhattan,10283004001,0,0,0,3.11
2020,CB2020,061,1,Manhattan,10283004002,1375,656,719,3.34
2020,CB2020,061,1,Manhattan,10285001000,723,337,386,5.19
2020,CB2020,061,1,Manhattan,10285001001,1434,730,704,4.73
2020,CB2020,061,1,Manhattan,10285002000,1747,791,956,4.69
2020,CB2020,061,1,Manhattan,10285003000,709,313,396,4.28
2020,CB2020,061,1,Manhattan,10285003001,489,210,279,5.09
2020,CB2020,061,1,Manhattan,10285004000,1692,756,936,6.16
2020,CB2020,061,1,Manhattan,10287000001,0,0,0,0
2020,CB2020,061,1,Manhattan,10287001000,0,0,0,12.5
2020,CB2020,061,1,Manhattan,10287001001,0,0,0,6.8
2020,CB2020,061,1,Manhattan,10287001002,0,0,0,2.35
2020,CB2020,061,1,Manhattan,10287001003,0,0,0,3.8
2020,CB2020,061,1,Manhattan,10287001004,246,104,142,2.54
2020,CB2020,061,1,Manhattan,10287001005,319,146,173,2.46
2020,CB2020,061,1,Manhattan,10287001006,100,50,50,2.64
2020,CB2020,061,1,Manhattan,10287001007,0,0,0,62.52
2020,CB2020,061,1,Manhattan,10287001008,0,0,0,5.43
2020,CB2020,061,1,Manhattan,10287001009,0,0,0,0.78
2020,CB2020,061,1,Manhattan,10287001010,0,0,0,12.95
2020,CB2020,061,1,Manhattan,10287002000,699,332,367,3.02
2020,CB2020,061,1,Manhattan,10287002001,699,314,385,4.48
2020,CB2020,061,1,Manhattan,10287003000,757,340,417,4.94
2020,CB2020,061,1,Manhattan,10287003001,952,449,503,4.34
2020,CB2020,061,1,Manhattan,10291001000,1741,804,937,5.19
2020,CB2020,061,1,Manhattan,10291002000,973,445,528,5.19
2020,CB2020,061,1,Manhattan,10291003000,1136,487,649,4.37
2020,CB2020,061,1,Manhattan,10291003001,460,213,247,1.03
2020,CB2020,061,1,Manhattan,10291004000,96,43,53,5.55
2020,CB2020,061,1,Manhattan,10291004001,1344,676,668,6.14
2020,CB2020,061,1,Manhattan,10291004002,202,103,99,0.8
2020,CB2020,061,1,Manhattan,10291005000,1518,685,833,6.35
2020,CB2020,061,1,Manhattan,10291006000,1857,866,991,6.38
2020,CB2020,061,1,Manhattan,10291007000,1182,566,616,5.33
2020,CB2020,061,1,Manhattan,10293001000,1136,520,616,3.49
2020,CB2020,061,1,Manhattan,10293001001,198,104,94,0.97
2020,CB2020,061,1,Manhattan,10293001002,0,0,0,1.44
2020,CB2020,061,1,Manhattan,10293001003,505,235,270,3.87
2020,CB2020,061,1,Manhattan,10293001004,0,0,0,0.56
2020,CB2020,061,1,Manhattan,10293002000,1298,645,653,4.71
2020,CB2020,061,1,Manhattan,10293002001,0,0,0,0.77
2020,CB2020,061,1,Manhattan,10293003000,578,285,293,5.09
2020,CB2020,061,1,Manhattan,10293003001,1130,486,644,5.19
2020,CB2020,061,1,Manhattan,10293004000,771,383,388,3.55
2020,CB2020,061,1,Manhattan,10293004001,1003,491,512,3.85
2020,CB2020,061,1,Manhattan,10293005000,1416,622,794,5.34
2020,CB2020,061,1,Manhattan,10295001000,1089,518,571,5.05
2020,CB2020,061,1,Manhattan,10295001001,872,408,464,3.93
2020,CB2020,061,1,Manhattan,10295002000,773,361,412,3.65
2020,CB2020,061,1,Manhattan,10295002001,493,242,251,3.95
2020,CB2020,061,1,Manhattan,10295003000,1078,514,564,3.48
2020,CB2020,061,1,Manhattan,10295003001,905,425,480,4.31
2020,CB2020,061,1,Manhattan,10295004000,405,201,204,1.3
2020,CB2020,061,1,Manhattan,10295004001,683,306,377,3.51
2020,CB2020,061,1,Manhattan,10295004002,741,362,379,4.33
2020,CB2020,061,1,Manhattan,10297000001,0,0,0,0
2020,CB2020,061,1,Manhattan,10297000002,0,0,0,0
2020,CB2020,061,1,Manhattan,10297000003,0,0,0,0
2020,CB2020,061,1,Manhattan,10297000004,0,0,0,0
2020,CB2020,061,1,Manhattan,10297001000,0,0,0,0.8
2020,CB2020,061,1,Manhattan,10297001001,3,1,2,33.3
2020,CB2020,061,1,Manhattan,10297001002,0,0,0,0
2020,CB2020,061,1,Manhattan,10297001003,13,4,9,145.02
2020,CB2020,061,1,Manhattan,10297001004,0,0,0,24.65
2020,CB2020,061,1,Manhattan,10297001005,0,0,0,17.92
2020,CB2020,061,1,Manhattan,10297001006,0,0,0,12.59
2020,CB2020,061,1,Manhattan,10299000001,0,0,0,0
2020,CB2020,061,1,Manhattan,10299000002,0,0,0,0
2020,CB2020,061,1,Manhattan,10299000003,0,0,0,0
2020,CB2020,061,1,Manhattan,10299001000,406,137,269,4.75
2020,CB2020,061,1,Manhattan,10299001001,1124,489,635,8.72
2020,CB2020,061,1,Manhattan,10299001002,1124,440,684,5.28
2020,CB2020,061,1,Manhattan,10299002000,0,0,0,10.38
2020,CB2020,061,1,Manhattan,10299002001,0,0,0,2.23
2020,CB2020,061,1,Manhattan,10299002002,0,0,0,2.8
2020,CB2020,061,1,Manhattan,10299002003,0,0,0,3.43
2020,CB2020,061,1,Manhattan,10299002004,0,0,0,5.26
2020,CB2020,061,1,Manhattan,10299002005,0,0,0,3.75
2020,CB2020,061,1,Manhattan,10299002006,8,7,1,52.58
2020,CB2020,061,1,Manhattan,10299002007,0,0,0,3.32
2020,CB2020,061,1,Manhattan,10299003000,0,0,0,2.76
2020,CB2020,061,1,Manhattan,10299003001,81,48,33,3.76
2020,CB2020,061,1,Manhattan,10299003002,569,249,320,3.53
2020,CB2020,061,1,Manhattan,10299003003,112,56,56,3.43
2020,CB2020,061,1,Manhattan,10299003004,165,81,84,3.51
2020,CB2020,061,1,Manhattan,10299003005,0,0,0,1.64
2020,CB2020,061,1,Manhattan,10299003006,0,0,0,1.94
2020,CB2020,061,1,Manhattan,10299003007,0,0,0,1.73
2020,CB2020,061,1,Manhattan,10299003008,0,0,0,1.68
2020,CB2020,061,1,Manhattan,10299003009,0,0,0,3.48
2020,CB2020,061,1,Manhattan,10299003010,0,0,0,3.55
2020,CB2020,061,1,Manhattan,10299003011,0,0,0,1.44
2020,CB2020,061,1,Manhattan,10299003012,9,3,6,17.28
2020,CB2020,061,1,Manhattan,10303001000,165,78,87,1.75
2020,CB2020,061,1,Manhattan,10303001001,25,6,19,2.36
2020,CB2020,061,1,Manhattan,10303001002,767,343,424,3.24
2020,CB2020,061,1,Manhattan,10303001003,409,232,177,4.46
2020,CB2020,061,1,Manhattan,10303002000,0,0,0,3.93
2020,CB2020,061,1,Manhattan,10303002001,227,102,125,9.05
2020,CB2020,061,1,Manhattan,10303002002,292,141,151,3.38
2020,CB2020,061,1,Manhattan,10303002003,416,194,222,2.95
2020,CB2020,061,1,Manhattan,10303003000,328,129,199,1.49
2020,CB2020,061,1,Manhattan,10303003001,425,221,204,1.65
2020,CB2020,061,1,Manhattan,10303003002,99,44,55,2.43
2020,CB2020,061,1,Manhattan,10303003003,538,263,275,2.03
2020,CB2020,061,1,Manhattan,10307001000,0,0,0,0.76
2020,CB2020,061,1,Manhattan,10307001001,701,331,370,5.21
2020,CB2020,061,1,Manhattan,10307001002,33,21,12,1.17
2020,CB2020,061,1,Manhattan,10307002000,322,179,143,2.43
2020,CB2020,061,1,Manhattan,10307002001,706,331,375,3.61
2020,CB2020,061,1,Manhattan,10307003000,717,337,380,3.62
2020,CB2020,061,1,Manhattan,10307003001,948,494,454,4.04
2020,CB2020,061,1,Manhattan,10309001000,0,0,0,10.01
2020,CB2020,061,1,Manhattan,10309002000,656,250,406,3.82
2020,CB2020,061,1,Manhattan,10309002001,610,275,335,4.72
2020,CB2020,061,1,Manhattan,10309002002,927,417,510,4.21
2020,CB2020,061,1,Manhattan,10309002003,0,0,0,0.56
2020,CB2020,061,1,Manhattan,10309003000,2362,962,1400,10.46
2020,CB2020,061,1,Manhattan,10309004000,343,169,174,2.21
2020,CB2020,061,1,Manhattan,10309004001,790,330,460,4.32
2020,CB2020,061,1,Manhattan,10309004002,469,234,235,3.23
2020,CB2020,061,1,Manhattan,10309004003,535,244,291,2.31
2020,CB2020,061,1,Manhattan,10309005000,1134,539,595,23.55
2020,CB2020,061,1,Manhattan,10309005001,768,340,428,5.41
2020,CB2020,061,1,Manhattan,10311000001,0,0,0,0
2020,CB2020,061,1,Manhattan,10311000002,0,0,0,0
2020,CB2020,061,1,Manhattan,10311000003,0,0,0,0
2020,CB2020,061,1,Manhattan,10311000004,0,0,0,0
2020,CB2020,061,1,Manhattan,10311000005,0,0,0,0
2020,CB2020,061,1,Manhattan,10311000006,0,0,0,0
2020,CB2020,061,1,Manhattan,10311001000,4,3,1,67.05
2020,CB2020,061,1,Manhattan,10311001001,0,0,0,3.1
2020,CB2020,061,1,Manhattan,10311001002,0,0,0,0.37
2020,CB2020,061,1,Manhattan,10311001003,0,0,0,10.39
2020,CB2020,061,1,Manhattan,10311001004,0,0,0,1.08
2020,CB2020,061,1,Manhattan,10311001005,0,0,0,0.32
2020,CB2020,061,1,Manhattan,10311001006,0,0,0,6.43
2020,CB2020,061,1,Manhattan,10311001007,0,0,0,4.39
2020,CB2020,061,1,Manhattan,10311001008,0,0,0,4.7
2020,CB2020,061,1,Manhattan,10311001009,8,6,2,82.74
2020,CB2020,061,1,Manhattan,10317030001,0,0,0,0
2020,CB2020,061,1,Manhattan,10317030002,0,0,0,0
2020,CB2020,061,1,Manhattan,10317031000,0,0,0,1.26
2020,CB2020,061,1,Manhattan,10317031001,753,393,360,15.53
2020,CB2020,061,1,Manhattan,10317031002,0,0,0,15.74
2020,CB2020,061,1,Manhattan,10317031003,0,0,0,1.6
2020,CB2020,061,1,Manhattan,10317032000,2145,1074,1071,4.62
2020,CB2020,061,1,Manhattan,10317033000,904,398,506,2.06
2020,CB2020,061,1,Manhattan,10317033001,0,0,0,0.48
2020,CB2020,061,1,Manhattan,10317033002,434,222,212,1.77
2020,CB2020,061,1,Manhattan,10317033003,0,0,0,0.55
2020,CB2020,061,1,Manhattan,10317033004,0,0,0,0.94
2020,CB2020,061,1,Manhattan,10317033005,1013,510,503,5.05
2020,CB2020,061,1,Manhattan,10317033006,0,0,0,0.78
2020,CB2020,061,1,Manhattan,10317033007,0,0,0,6.53
2020,CB2020,061,1,Manhattan,10317033008,598,283,315,2.01
2020,CB2020,061,1,Manhattan,10317033009,0,0,0,0.47
2020,CB2020,061,1,Manhattan,10317033010,0,0,0,1.18
2020,CB2020,061,1,Manhattan,10317033011,0,0,0,0.71
2020,CB2020,061,1,Manhattan,10317040001,0,0,0,0
2020,CB2020,061,1,Manhattan,10317040002,0,0,0,0
2020,CB2020,061,1,Manhattan,10317040003,0,0,0,0
2020,CB2020,061,1,Manhattan,10317041000,3104,1480,1624,8.88
2020,CB2020,061,1,Manhattan,10317041001,21,10,11,4.48
2020,CB2020,061,1,Manhattan,10317041002,0,0,0,0.86
2020,CB2020,061,1,Manhattan,10317042000,1862,891,971,6.11
2020,CB2020,061,1,Manhattan,10317042001,26,11,15,0.64
2020,CB2020,061,1,Manhattan,10317043000,0,0,0,1.47
2020,CB2020,061,1,Manhattan,10317043001,1969,944,1025,6.52
2020,CB2020,061,1,Manhattan,10317043002,26,9,17,0.69
2020,CB2020,061,1,Manhattan,10317043003,460,216,244,4.32
2020,CB2020,061,1,Manhattan,10317043004,0,0,0,1.18
2020,CB2020,061,1,Manhattan,10317043005,0,0,0,0.55
2020,CB2020,061,1,Manhattan,10317043006,233,109,124,1.83
2020,CB2020,061,1,Manhattan,10317043007,577,306,271,1.69
2020,CB2020,061,1,Manhattan,10317043008,619,309,310,1.42
2020,CB2020,061,1,Manhattan,10317044000,1525,729,796,14.95
2020,CB2020,061,1,Manhattan,10319000001,0,0,0,0
2020,CB2020,061,1,Manhattan,10319000002,0,0,0,0
2020,CB2020,061,1,Manhattan,10319000003,0,0,0,0
2020,CB2020,061,1,Manhattan,10319001000,3,2,1,9.17
2020,CB2020,061,1,Manhattan,10319001001,0,0,0,1.4
2020,CB2020,061,1,Manhattan,10319001002,0,0,0,4.67
2020,CB2020,061,1,Manhattan,10319001003,0,0,0,1
2020,CB2020,061,1,Manhattan,10319001004,0,0,0,5.18
2020,CB2020,061,1,Manhattan,10319001005,0,0,0,0.27
2020,CB2020,061,1,Manhattan,10319001006,0,0,0,2.11
2020,CB2020,061,1,Manhattan,10319001007,0,0,0,0.74
2020,CB2020,081,4,Queens,40001011000,912,458,454,3.33
2020,CB2020,081,4,Queens,40001011001,1233,594,639,4.12
2020,CB2020,081,4,Queens,40001011002,0,0,0,0
2020,CB2020,081,4,Queens,40001011003,0,0,0,0
2020,CB2020,081,4,Queens,40001011004,0,0,0,0
2020,CB2020,081,4,Queens,40001011005,624,294,330,18.79
2020,CB2020,081,4,Queens,40001011006,0,0,0,0.68
2020,CB2020,081,4,Queens,40001011007,33,21,12,1.88
2020,CB2020,081,4,Queens,40001011008,134,64,70,2.81
2020,CB2020,081,4,Queens,40001011009,12,8,4,0
2020,CB2020,081,4,Queens,40001011010,0,0,0,3.75
2020,CB2020,081,4,Queens,40001011011,0,0,0,13.58
2020,CB2020,081,4,Queens,40001011012,0,0,0,0.28
2020,CB2020,081,4,Queens,40001011013,0,0,0,0.35
2020,CB2020,081,4,Queens,40001011014,0,0,0,4.48
2020,CB2020,081,4,Queens,40001011015,0,0,0,0.56
2020,CB2020,081,4,Queens,40001011016,0,0,0,7.92
2020,CB2020,081,4,Queens,40001012000,916,439,477,3.2
2020,CB2020,081,4,Queens,40001012001,0,0,0,1.08
2020,CB2020,081,4,Queens,40001012002,0,0,0,1.22
2020,CB2020,081,4,Queens,40001012003,0,0,0,0
2020,CB2020,081,4,Queens,40001012004,795,393,402,4.42
2020,CB2020,081,4,Queens,40001021000,67,16,51,3.82
2020,CB2020,081,4,Queens,40001021001,0,0,0,0
2020,CB2020,081,4,Queens,40001021002,0,0,0,1.5
2020,CB2020,081,4,Queens,40001021003,1552,806,746,2.01
2020,CB2020,081,4,Queens,40001021004,731,383,348,2.23
2020,CB2020,081,4,Queens,40001021005,999,504,495,3.13
2020,CB2020,081,4,Queens,40001022000,1886,940,946,6.48
2020,CB2020,081,4,Queens,40001022001,1564,816,748,3.02
2020,CB2020,081,4,Queens,40001022002,685,377,308,4.16
2020,CB2020,081,4,Queens,40001031000,0,0,0,31.63
2020,CB2020,081,4,Queens,40001031001,0,0,0,0
2020,CB2020,081,4,Queens,40001031002,33,21,12,11.78
2020,CB2020,081,4,Queens,40001031003,0,0,0,2.22
2020,CB2020,081,4,Queens,40001041000,0,0,0,4.04
2020,CB2020,081,4,Queens,40001041001,0,0,0,3.13
2020,CB2020,081,4,Queens,40001041002,0,0,0,2.24
2020,CB2020,081,4,Queens,40001041003,0,0,0,1.22
2020,CB2020,081,4,Queens,40001041004,0,0,0,3.26
2020,CB2020,081,4,Queens,40001041005,0,0,0,3.9
2020,CB2020,081,4,Queens,40001041006,0,0,0,4.78
2020,CB2020,081,4,Queens,40001041007,0,0,0,3.02
2020,CB2020,081,4,Queens,40001041008,0,0,0,3.93
2020,CB2020,081,4,Queens,40001041009,0,0,0,3.65
2020,CB2020,081,4,Queens,40001041010,0,0,0,17.63
2020,CB2020,081,4,Queens,40001041011,0,0,0,0
2020,CB2020,081,4,Queens,40001041012,4,4,0,8.67
2020,CB2020,081,4,Queens,40001041013,0,0,0,0.71
2020,CB2020,081,4,Queens,40001041014,0,0,0,0.67
2020,CB2020,081,4,Queens,40001041015,0,0,0,0.77
2020,CB2020,081,4,Queens,40001041016,0,0,0,1.98
2020,CB2020,081,4,Queens,40001041017,0,0,0,0.66
2020,CB2020,081,4,Queens,40001041018,4,3,1,5.29
2020,CB2020,081,4,Queens,40001041019,13,13,0,17.74
2020,CB2020,081,4,Queens,40001041020,0,0,0,0
2020,CB2020,081,4,Queens,40001041021,0,0,0,3.93
2020,CB2020,081,4,Queens,40001041022,0,0,0,3.14
2020,CB2020,081,4,Queens,40001041023,0,0,0,4.83
2020,CB2020,081,4,Queens,40001041024,0,0,0,0.29
2020,CB2020,081,4,Queens,40001041025,0,0,0,12.05
2020,CB2020,081,4,Queens,40001041026,0,0,0,0
2020,CB2020,081,4,Queens,40001041027,0,0,0,0
2020,CB2020,081,4,Queens,40001041028,0,0,0,3.93
2020,CB2020,081,4,Queens,40001041029,0,0,0,2.6
2020,CB2020,081,4,Queens,40001041030,0,0,0,2.46
2020,CB2020,081,4,Queens,40001041031,0,0,0,10.95
2020,CB2020,081,4,Queens,40001041032,0,0,0,0
2020,CB2020,081,4,Queens,40001041033,6,5,1,4.12
2020,CB2020,081,4,Queens,40001041034,0,0,0,0.22
2020,CB2020,081,4,Queens,40001041035,0,0,0,0.62
2020,CB2020,081,4,Queens,40001041036,0,0,0,0
2020,CB2020,081,4,Queens,40001041037,0,0,0,0
2020,CB2020,081,4,Queens,40001041038,0,0,0,0.85
2020,CB2020,081,4,Queens,40002001000,355,163,192,3.82
2020,CB2020,081,4,Queens,40002001001,323,166,157,3.73
2020,CB2020,081,4,Queens,40002001002,286,157,129,3.73
2020,CB2020,081,4,Queens,40002001003,251,121,130,3.03
2020,CB2020,081,4,Queens,40002002000,561,304,257,7.51
2020,CB2020,081,4,Queens,40002002001,198,87,111,1.94
2020,CB2020,081,4,Queens,40002002002,309,143,166,3.07
2020,CB2020,081,4,Queens,40002002003,0,0,0,3.15
2020,CB2020,081,4,Queens,40002002004,185,85,100,3.14
2020,CB2020,081,4,Queens,40002002005,334,150,184,3.03
2020,CB2020,081,4,Queens,40002002006,282,146,136,2.55
2020,CB2020,081,4,Queens,40004001000,277,136,141,2.96
2020,CB2020,081,4,Queens,40004001001,361,157,204,4.66
2020,CB2020,081,4,Queens,40004001002,468,212,256,4.48
2020,CB2020,081,4,Queens,40004001003,322,157,165,4.43
2020,CB2020,081,4,Queens,40004001004,209,112,97,2.76
2020,CB2020,081,4,Queens,40004001005,221,131,90,2.75
2020,CB2020,081,4,Queens,40004002000,259,128,131,2.7
2020,CB2020,081,4,Queens,40004002001,333,157,176,2.55
2020,CB2020,081,4,Queens,40004002002,262,142,120,2.49
2020,CB2020,081,4,Queens,40004002003,269,120,149,2.67
2020,CB2020,081,4,Queens,40004002004,406,177,229,2.8
2020,CB2020,081,4,Queens,40004002005,227,112,115,2.51
2020,CB2020,081,4,Queens,40004003000,214,76,138,2.79
2020,CB2020,081,4,Queens,40004003001,166,100,66,2.77
2020,CB2020,081,4,Queens,40004003002,364,185,179,4.13
2020,CB2020,081,4,Queens,40004003003,291,161,130,4.05
2020,CB2020,081,4,Queens,40004003004,269,134,135,4.07
2020,CB2020,081,4,Queens,40006001000,204,82,122,2.77
2020,CB2020,081,4,Queens,40006001001,316,168,148,2.78
2020,CB2020,081,4,Queens,40006001002,202,107,95,2.76
2020,CB2020,081,4,Queens,40006001003,264,115,149,3.88
2020,CB2020,081,4,Queens,40006001004,159,85,74,2.96
2020,CB2020,081,4,Queens,40006001005,51,31,20,1.13
2020,CB2020,081,4,Queens,40006002000,289,141,148,2.93
2020,CB2020,081,4,Queens,40006002001,325,177,148,2.88
2020,CB2020,081,4,Queens,40006002002,44,26,18,1.55
2020,CB2020,081,4,Queens,40006002003,141,77,64,2.37
2020,CB2020,081,4,Queens,40006002004,104,43,61,2.26
2020,CB2020,081,4,Queens,40006002005,262,123,139,3.26
2020,CB2020,081,4,Queens,40006003000,358,151,207,3.06
2020,CB2020,081,4,Queens,40006003001,251,162,89,3.13
2020,CB2020,081,4,Queens,40006003002,69,20,49,0.45
2020,CB2020,081,4,Queens,40006003003,255,121,134,1.97
2020,CB2020,081,4,Queens,40006003004,293,166,127,4.06
2020,CB2020,081,4,Queens,40006003005,148,75,73,2.94
2020,CB2020,081,4,Queens,40006003006,0,0,0,0.58
2020,CB2020,081,4,Queens,40006003007,163,53,110,1.69
2020,CB2020,081,4,Queens,40006003008,216,102,114,2.18
2020,CB2020,081,4,Queens,40006003009,63,26,37,1.35
2020,CB2020,081,4,Queens,40007011000,456,251,205,4.16
2020,CB2020,081,4,Queens,40007011001,161,85,76,3.79
2020,CB2020,081,4,Queens,40007011002,145,79,66,3.98
2020,CB2020,081,4,Queens,40007011003,291,142,149,3.96
2020,CB2020,081,4,Queens,40007011004,348,160,188,3.46
2020,CB2020,081,4,Queens,40007011005,133,76,57,0.54
2020,CB2020,081,4,Queens,40007012000,646,345,301,7.1
2020,CB2020,081,4,Queens,40007012001,0,0,0,0.25
2020,CB2020,081,4,Queens,40007012002,148,72,76,1.58
2020,CB2020,081,4,Queens,40007012003,345,192,153,4.11
2020,CB2020,081,4,Queens,40007012004,102,38,64,4.06
2020,CB2020,081,4,Queens,40007012005,132,62,70,2.16
2020,CB2020,081,4,Queens,40007012006,0,0,0,1.93
2020,CB2020,081,4,Queens,40007012007,0,0,0,0.37
2020,CB2020,081,4,Queens,40007012008,0,0,0,0.45
2020,CB2020,081,4,Queens,40007012009,221,111,110,2.92
2020,CB2020,081,4,Queens,40007012010,35,28,7,0.84
2020,CB2020,081,4,Queens,40007012011,213,101,112,2.42
2020,CB2020,081,4,Queens,40007012012,84,42,42,1.25
2020,CB2020,081,4,Queens,40007012013,0,0,0,0.38
2020,CB2020,081,4,Queens,40007012014,0,0,0,0.44
2020,CB2020,081,4,Queens,40007012015,0,0,0,1.21
2020,CB2020,081,4,Queens,40007012016,0,0,0,1.6
2020,CB2020,081,4,Queens,40007012017,0,0,0,1.15
2020,CB2020,081,4,Queens,40007012018,0,0,0,4.33
2020,CB2020,081,4,Queens,40007012019,0,0,0,1.01
2020,CB2020,081,4,Queens,40007021000,645,333,312,4.16
2020,CB2020,081,4,Queens,40007021001,0,0,0,3.81
2020,CB2020,081,4,Queens,40007021002,58,15,43,3.82
2020,CB2020,081,4,Queens,40007021003,398,215,183,3.82
2020,CB2020,081,4,Queens,40007021004,148,87,61,3.76
2020,CB2020,081,4,Queens,40007021005,63,22,41,0.85
2020,CB2020,081,4,Queens,40007021006,286,124,162,3.01
2020,CB2020,081,4,Queens,40007022000,348,188,160,4.24
2020,CB2020,081,4,Queens,40007022001,318,147,171,3.91
2020,CB2020,081,4,Queens,40007022002,310,235,75,3.8
2020,CB2020,081,4,Queens,40007022003,9,5,4,2.37
2020,CB2020,081,4,Queens,40007022004,0,0,0,0.65
2020,CB2020,081,4,Queens,40007023000,196,108,88,4.04
2020,CB2020,081,4,Queens,40007023001,0,0,0,0.51
2020,CB2020,081,4,Queens,40007023002,56,47,9,4.08
2020,CB2020,081,4,Queens,40007023003,38,22,16,4.12
2020,CB2020,081,4,Queens,40007023004,87,55,32,4.1
2020,CB2020,081,4,Queens,40007023005,69,18,51,4
2020,CB2020,081,4,Queens,40007023006,393,178,215,3.99
2020,CB2020,081,4,Queens,40007023007,333,193,140,4.12
2020,CB2020,081,4,Queens,40007023008,255,120,135,4.1
2020,CB2020,081,4,Queens,40007023009,250,102,148,3.99
2020,CB2020,081,4,Queens,40008001000,324,164,160,3.32
2020,CB2020,081,4,Queens,40008001001,284,139,145,3.39
2020,CB2020,081,4,Queens,40008001002,275,165,110,3.24
2020,CB2020,081,4,Queens,40008001003,257,113,144,4.02
2020,CB2020,081,4,Queens,40008001004,356,170,186,4.07
2020,CB2020,081,4,Queens,40008001005,246,147,99,3.99
2020,CB2020,081,4,Queens,40008002000,486,218,268,4.29
2020,CB2020,081,4,Queens,40008002001,326,167,159,4.43
2020,CB2020,081,4,Queens,40008002002,309,157,152,4.49
2020,CB2020,081,4,Queens,40008002003,235,146,89,3.5
2020,CB2020,081,4,Queens,40008002004,251,142,109,4.35
2020,CB2020,081,4,Queens,40008002005,231,112,119,3.83
2020,CB2020,081,4,Queens,40010001000,516,249,267,3.53
2020,CB2020,081,4,Queens,40010001001,525,264,261,3.91
2020,CB2020,081,4,Queens,40010001002,403,213,190,5.4
2020,CB2020,081,4,Queens,40010001003,504,225,279,5.25
2020,CB2020,081,4,Queens,40010002000,239,115,124,2.73
2020,CB2020,081,4,Queens,40010002001,373,188,185,2.72
2020,CB2020,081,4,Queens,40010002002,361,180,181,5.27
2020,CB2020,081,4,Queens,40010002003,402,192,210,5.46
2020,CB2020,081,4,Queens,40010002004,466,214,252,5.58
2020,CB2020,081,4,Queens,40012001000,313,142,171,2.78
2020,CB2020,081,4,Queens,40012001001,165,89,76,2.52
2020,CB2020,081,4,Queens,40012001002,123,63,60,3.27
2020,CB2020,081,4,Queens,40012001003,325,168,157,5.94
2020,CB2020,081,4,Queens,40012001004,276,112,164,2.62
2020,CB2020,081,4,Queens,40012002000,119,61,58,2.23
2020,CB2020,081,4,Queens,40012002001,299,147,152,3.74
2020,CB2020,081,4,Queens,40012002002,188,99,89,3.07
2020,CB2020,081,4,Queens,40012002003,90,54,36,3.73
2020,CB2020,081,4,Queens,40012002004,233,105,128,1.91
2020,CB2020,081,4,Queens,40012002005,253,123,130,3.82
2020,CB2020,081,4,Queens,40012003000,322,156,166,5.4
2020,CB2020,081,4,Queens,40012003001,726,364,362,7.7
2020,CB2020,081,4,Queens,40012003002,751,368,383,7.4
2020,CB2020,081,4,Queens,40014001000,210,120,90,3.26
2020,CB2020,081,4,Queens,40014001001,274,133,141,2.87
2020,CB2020,081,4,Queens,40014001002,308,158,150,2.89
2020,CB2020,081,4,Queens,40014001003,178,77,101,2.82
2020,CB2020,081,4,Queens,40014001004,187,74,113,2.76
2020,CB2020,081,4,Queens,40014001005,170,65,105,2.81
2020,CB2020,081,4,Queens,40014002000,299,160,139,2.88
2020,CB2020,081,4,Queens,40014002001,549,270,279,5.99
2020,CB2020,081,4,Queens,40014002002,460,195,265,6.17
2020,CB2020,081,4,Queens,40014002003,282,125,157,3.49
2020,CB2020,081,4,Queens,40014003000,90,54,36,2.67
2020,CB2020,081,4,Queens,40014003001,247,95,152,2.87
2020,CB2020,081,4,Queens,40014003002,292,162,130,3.31
2020,CB2020,081,4,Queens,40014003003,226,103,123,2.66
2020,CB2020,081,4,Queens,40014003004,169,106,63,2.61
2020,CB2020,081,4,Queens,40014003005,173,81,92,2.73
2020,CB2020,081,4,Queens,40016001000,228,109,119,2.91
2020,CB2020,081,4,Queens,40016001001,178,83,95,2.72
2020,CB2020,081,4,Queens,40016001002,304,152,152,3.36
2020,CB2020,081,4,Queens,40016001003,319,161,158,2.65
2020,CB2020,081,4,Queens,40016001004,187,106,81,2.12
2020,CB2020,081,4,Queens,40016001005,140,52,88,2.41
2020,CB2020,081,4,Queens,40016002000,176,84,92,3.29
2020,CB2020,081,4,Queens,40016002001,274,149,125,2.89
2020,CB2020,081,4,Queens,40016002002,302,147,155,3.27
2020,CB2020,081,4,Queens,40016002003,319,173,146,4
2020,CB2020,081,4,Queens,40016002004,342,148,194,3.86
2020,CB2020,081,4,Queens,40016002005,272,115,157,3.96
2020,CB2020,081,4,Queens,40018001000,234,112,122,3.68
2020,CB2020,081,4,Queens,40018001001,567,265,302,4.4
2020,CB2020,081,4,Queens,40018001002,567,278,289,8.7
2020,CB2020,081,4,Queens,40018001003,260,145,115,5.09
2020,CB2020,081,4,Queens,40018002000,234,125,109,3.42
2020,CB2020,081,4,Queens,40018002001,180,99,81,3.19
2020,CB2020,081,4,Queens,40018002002,271,131,140,4.14
2020,CB2020,081,4,Queens,40018002003,282,148,134,4.16
2020,CB2020,081,4,Queens,40018002004,154,65,89,2.63
2020,CB2020,081,4,Queens,40018002005,179,95,84,2.44
2020,CB2020,081,4,Queens,40018002006,116,56,60,2
2020,CB2020,081,4,Queens,40019011000,17,9,8,1.65
2020,CB2020,081,4,Queens,40019011001,41,17,24,4.01
2020,CB2020,081,4,Queens,40019011002,0,0,0,1.13
2020,CB2020,081,4,Queens,40019011003,20,15,5,1.85
2020,CB2020,081,4,Queens,40019011004,0,0,0,0.31
2020,CB2020,081,4,Queens,40019011005,853,450,403,16.1
2020,CB2020,081,4,Queens,40019011006,503,255,248,31.39
2020,CB2020,081,4,Queens,40019021000,0,0,0,0.71
2020,CB2020,081,4,Queens,40019021001,0,0,0,0.31
2020,CB2020,081,4,Queens,40019021002,0,0,0,0.44
2020,CB2020,081,4,Queens,40019021003,430,245,185,1.88
2020,CB2020,081,4,Queens,40019021004,971,536,435,2.24
2020,CB2020,081,4,Queens,40019021005,0,0,0,0.95
2020,CB2020,081,4,Queens,40019021006,29,11,18,4.41
2020,CB2020,081,4,Queens,40019021007,134,45,89,2.99
2020,CB2020,081,4,Queens,40019021008,81,62,19,1.57
2020,CB2020,081,4,Queens,40019021009,83,44,39,1.62
2020,CB2020,081,4,Queens,40019021010,149,66,83,1.32
2020,CB2020,081,4,Queens,40019021011,0,0,0,1.27
2020,CB2020,081,4,Queens,40019021012,1429,750,679,3.37
2020,CB2020,081,4,Queens,40019021013,0,0,0,1.26
2020,CB2020,081,4,Queens,40019021014,1939,993,946,6.17
2020,CB2020,081,4,Queens,40019021015,0,0,0,1.36
2020,CB2020,081,4,Queens,40019021016,3400,1632,1768,11.13
2020,CB2020,081,4,Queens,40019031000,0,0,0,0.44
2020,CB2020,081,4,Queens,40019031001,0,0,0,4.92
2020,CB2020,081,4,Queens,40019031002,0,0,0,0.99
2020,CB2020,081,4,Queens,40019031003,0,0,0,0.46
2020,CB2020,081,4,Queens,40019031004,0,0,0,2.2
2020,CB2020,081,4,Queens,40019031005,15,7,8,3.41
2020,CB2020,081,4,Queens,40019031006,22,6,16,3.6
2020,CB2020,081,4,Queens,40019031007,0,0,0,3.79
2020,CB2020,081,4,Queens,40019031008,0,0,0,3.86
2020,CB2020,081,4,Queens,40019031009,0,0,0,3.8
2020,CB2020,081,4,Queens,40019031010,0,0,0,4.46
2020,CB2020,081,4,Queens,40019031011,0,0,0,6.08
2020,CB2020,081,4,Queens,40019031012,19,14,5,5.44
2020,CB2020,081,4,Queens,40019031013,12,12,0,2.38
2020,CB2020,081,4,Queens,40019031014,10,4,6,2
2020,CB2020,081,4,Queens,40019031015,0,0,0,1.86
2020,CB2020,081,4,Queens,40019031016,0,0,0,1.66
2020,CB2020,081,4,Queens,40019031017,0,0,0,4.33
2020,CB2020,081,4,Queens,40019031018,0,0,0,3.54
2020,CB2020,081,4,Queens,40019031019,18,14,4,3.16
2020,CB2020,081,4,Queens,40019031020,0,0,0,2.54
2020,CB2020,081,4,Queens,40019031021,0,0,0,1.65
2020,CB2020,081,4,Queens,40019031022,0,0,0,0.92
2020,CB2020,081,4,Queens,40019031023,32,10,22,1.54
2020,CB2020,081,4,Queens,40019031024,32,16,16,3.36
2020,CB2020,081,4,Queens,40019031025,46,34,12,4.21
2020,CB2020,081,4,Queens,40019031026,24,12,12,4.11
2020,CB2020,081,4,Queens,40019031027,0,0,0,3.3
2020,CB2020,081,4,Queens,40019031028,0,0,0,3.31
2020,CB2020,081,4,Queens,40019031029,0,0,0,2.48
2020,CB2020,081,4,Queens,40019031030,0,0,0,0.85
2020,CB2020,081,4,Queens,40019031031,552,313,239,1.67
2020,CB2020,081,4,Queens,40019031032,34,31,3,1.93
2020,CB2020,081,4,Queens,40019031033,49,28,21,1.13
2020,CB2020,081,4,Queens,40019031034,97,42,55,1.43
2020,CB2020,081,4,Queens,40019031035,0,0,0,1.51
2020,CB2020,081,4,Queens,40019031036,0,0,0,2.95
2020,CB2020,081,4,Queens,40019031037,1103,545,558,2.54
2020,CB2020,081,4,Queens,40019031038,0,0,0,2.99
2020,CB2020,081,4,Queens,40019031039,149,65,84,4.23
2020,CB2020,081,4,Queens,40019031040,0,0,0,4.03
2020,CB2020,081,4,Queens,40020001000,314,184,130,5.83
2020,CB2020,081,4,Queens,40020001001,339,166,173,5.84
2020,CB2020,081,4,Queens,40020001002,129,77,52,5.25
2020,CB2020,081,4,Queens,40020001003,554,225,329,9.29
2020,CB2020,081,4,Queens,40020001004,271,119,152,3.88
2020,CB2020,081,4,Queens,40020001005,79,34,45,1.95
2020,CB2020,081,4,Queens,40020001006,122,70,52,1.79
2020,CB2020,081,4,Queens,40020001007,63,36,27,1.99
2020,CB2020,081,4,Queens,40020001008,0,0,0,0.35
2020,CB2020,081,4,Queens,40022001000,575,299,276,8.92
2020,CB2020,081,4,Queens,40022001001,208,86,122,3.6
2020,CB2020,081,4,Queens,40022001002,72,38,34,1.6
2020,CB2020,081,4,Queens,40022001003,129,70,59,1.94
2020,CB2020,081,4,Queens,40022001004,192,108,84,3.15
2020,CB2020,081,4,Queens,40022002000,283,137,146,3.17
2020,CB2020,081,4,Queens,40022002001,90,41,49,2.09
2020,CB2020,081,4,Queens,40022002002,80,41,39,2.12
2020,CB2020,081,4,Queens,40022002003,317,149,168,3.16
2020,CB2020,081,4,Queens,40022002004,259,131,128,3.63
2020,CB2020,081,4,Queens,40022002005,72,44,28,2.09
2020,CB2020,081,4,Queens,40022002006,13,9,4,0.99
2020,CB2020,081,4,Queens,40024001000,179,75,104,3.59
2020,CB2020,081,4,Queens,40024001001,665,338,327,10.49
2020,CB2020,081,4,Queens,40024002000,202,94,108,3.19
2020,CB2020,081,4,Queens,40024002001,0,0,0,0.94
2020,CB2020,081,4,Queens,40024002002,336,157,179,5.51
2020,CB2020,081,4,Queens,40024002003,230,127,103,5.55
2020,CB2020,081,4,Queens,40024002004,320,132,188,3.26
2020,CB2020,081,4,Queens,40024002005,263,142,121,2.53
2020,CB2020,081,4,Queens,40025001000,1223,511,712,7.31
2020,CB2020,081,4,Queens,40025002000,1097,430,667,6.97
2020,CB2020,081,4,Queens,40025003000,1180,472,708,6.82
2020,CB2020,081,4,Queens,40025004000,1234,518,716,6.99
2020,CB2020,081,4,Queens,40025005000,1158,461,697,7.77
2020,CB2020,081,4,Queens,40025006000,1350,561,789,13.86
2020,CB2020,081,4,Queens,40025006001,0,0,0,1.04
2020,CB2020,081,4,Queens,40025006002,0,0,0,1.24
2020,CB2020,081,4,Queens,40026001000,121,53,68,2.17
2020,CB2020,081,4,Queens,40026001001,104,58,46,1.94
2020,CB2020,081,4,Queens,40026001002,41,23,18,1.72
2020,CB2020,081,4,Queens,40026001003,144,59,85,3.73
2020,CB2020,081,4,Queens,40026001004,151,72,79,3.46
2020,CB2020,081,4,Queens,40026001005,177,78,99,3.23
2020,CB2020,081,4,Queens,40026001006,257,140,117,4.34
2020,CB2020,081,4,Queens,40026002000,233,122,111,4.35
2020,CB2020,081,4,Queens,40026002001,245,130,115,4.31
2020,CB2020,081,4,Queens,40026002002,677,321,356,7.32
2020,CB2020,081,4,Queens,40028001000,163,80,83,2.54
2020,CB2020,081,4,Queens,40028001001,438,225,213,7.59
2020,CB2020,081,4,Queens,40028001002,165,54,111,8.26
2020,CB2020,081,4,Queens,40028001003,154,103,51,2.93
2020,CB2020,081,4,Queens,40028001004,287,116,171,2.93
2020,CB2020,081,4,Queens,40028001005,165,92,73,2.3
2020,CB2020,081,4,Queens,40028001006,249,133,116,2.94
2020,CB2020,081,4,Queens,40028001007,116,67,49,2.37
2020,CB2020,081,4,Queens,40028002000,266,126,140,2.94
2020,CB2020,081,4,Queens,40028002001,241,125,116,2.93
2020,CB2020,081,4,Queens,40028002002,513,243,270,6.98
2020,CB2020,081,4,Queens,40028002003,240,126,114,3.79
2020,CB2020,081,4,Queens,40028002004,0,0,0,0.92
2020,CB2020,081,4,Queens,40028002005,0,0,0,0.71
2020,CB2020,081,4,Queens,40028002006,142,77,65,2.54
2020,CB2020,081,4,Queens,40028002007,165,91,74,2.93
2020,CB2020,081,4,Queens,40030001000,372,229,143,8.49
2020,CB2020,081,4,Queens,40030001001,328,157,171,5.61
2020,CB2020,081,4,Queens,40030001002,209,81,128,3.37
2020,CB2020,081,4,Queens,40030001003,93,38,55,1.69
2020,CB2020,081,4,Queens,40030001004,299,150,149,4.29
2020,CB2020,081,4,Queens,40030001005,0,0,0,0.36
2020,CB2020,081,4,Queens,40030001006,0,0,0,0.48
2020,CB2020,081,4,Queens,40030001007,91,43,48,1.96
2020,CB2020,081,4,Queens,40030001008,87,43,44,1.61
2020,CB2020,081,4,Queens,40031001000,233,124,109,2.77
2020,CB2020,081,4,Queens,40031001001,94,62,32,2.68
2020,CB2020,081,4,Queens,40031001002,207,118,89,2.8
2020,CB2020,081,4,Queens,40031001003,109,54,55,3.32
2020,CB2020,081,4,Queens,40031001004,167,87,80,3.34
2020,CB2020,081,4,Queens,40031002000,197,111,86,2.79
2020,CB2020,081,4,Queens,40031002001,128,64,64,2.83
2020,CB2020,081,4,Queens,40031002002,139,84,55,2.77
2020,CB2020,081,4,Queens,40031002003,38,15,23,2.85
2020,CB2020,081,4,Queens,40031002004,43,31,12,1.93
2020,CB2020,081,4,Queens,40031002005,3,0,3,0.88
2020,CB2020,081,4,Queens,40031002006,613,312,301,3.1
2020,CB2020,081,4,Queens,40031002007,49,25,24,3.2
2020,CB2020,081,4,Queens,40031002008,137,14,123,3.36
2020,CB2020,081,4,Queens,40031002009,0,0,0,2.14
2020,CB2020,081,4,Queens,40032001000,100,41,59,10.07
2020,CB2020,081,4,Queens,40032001001,162,85,77,2.76
2020,CB2020,081,4,Queens,40032001002,126,72,54,2.66
2020,CB2020,081,4,Queens,40032001003,43,31,12,1.52
2020,CB2020,081,4,Queens,40032001004,0,0,0,0.36
2020,CB2020,081,4,Queens,40032001005,0,0,0,0.42
2020,CB2020,081,4,Queens,40032001006,0,0,0,1.01
2020,CB2020,081,4,Queens,40032001007,187,85,102,2.59
2020,CB2020,081,4,Queens,40032001008,0,0,0,2.83
2020,CB2020,081,4,Queens,40032001009,137,77,60,2.73
2020,CB2020,081,4,Queens,40032001010,212,88,124,2.75
2020,CB2020,081,4,Queens,40032001011,105,61,44,1.38
2020,CB2020,081,4,Queens,40032001012,84,41,43,1.16
2020,CB2020,081,4,Queens,40032001013,470,244,226,4.73
2020,CB2020,081,4,Queens,40032001014,165,58,107,2.33
2020,CB2020,081,4,Queens,40032001015,0,0,0,0.35
2020,CB2020,081,4,Queens,40032001016,0,0,0,0.38
2020,CB2020,081,4,Queens,40033011000,125,78,47,3.35
2020,CB2020,081,4,Queens,40033011001,0,0,0,3.36
2020,CB2020,081,4,Queens,40033011002,9,9,0,4.03
2020,CB2020,081,4,Queens,40033011003,370,219,151,1.72
2020,CB2020,081,4,Queens,40033011004,461,219,242,3
2020,CB2020,081,4,Queens,40033011005,61,24,37,3.12
2020,CB2020,081,4,Queens,40033011006,591,329,262,3.29
2020,CB2020,081,4,Queens,40033011007,730,363,367,3.44
2020,CB2020,081,4,Queens,40033011008,1189,631,558,3.44
2020,CB2020,081,4,Queens,40033011009,96,85,11,3.82
2020,CB2020,081,4,Queens,40033011010,0,0,0,5.21
2020,CB2020,081,4,Queens,40033011011,0,0,0,0.66
2020,CB2020,081,4,Queens,40033011012,0,0,0,0.46
2020,CB2020,081,4,Queens,40033011013,0,0,0,1.24
2020,CB2020,081,4,Queens,40033011014,0,0,0,0.64
2020,CB2020,081,4,Queens,40033011015,0,0,0,1.12
2020,CB2020,081,4,Queens,40033011016,0,0,0,1.36
2020,CB2020,081,4,Queens,40033011017,767,386,381,2.43
2020,CB2020,081,4,Queens,40033011018,0,0,0,0.52
2020,CB2020,081,4,Queens,40033011019,0,0,0,0.98
2020,CB2020,081,4,Queens,40033021000,9,3,6,4.23
2020,CB2020,081,4,Queens,40033021001,0,0,0,3.46
2020,CB2020,081,4,Queens,40033021002,108,57,51,3.25
2020,CB2020,081,4,Queens,40033021003,265,120,145,3.35
2020,CB2020,081,4,Queens,40033021004,134,54,80,3.35
2020,CB2020,081,4,Queens,40033021005,113,29,84,3.35
2020,CB2020,081,4,Queens,40033021006,226,122,104,3.35
2020,CB2020,081,4,Queens,40033021007,188,112,76,3.24
2020,CB2020,081,4,Queens,40033021008,14,5,9,3.45
2020,CB2020,081,4,Queens,40033021009,11,4,7,4.34
2020,CB2020,081,4,Queens,40033022000,30,16,14,3.69
2020,CB2020,081,4,Queens,40033022001,13,10,3,3.39
2020,CB2020,081,4,Queens,40033022002,133,78,55,3.42
2020,CB2020,081,4,Queens,40033022003,326,170,156,3.9
2020,CB2020,081,4,Queens,40033022004,86,34,52,5.86
2020,CB2020,081,4,Queens,40033022005,22,11,11,3.12
2020,CB2020,081,4,Queens,40033022006,0,0,0,3.28
2020,CB2020,081,4,Queens,40033022007,10,8,2,3.89
2020,CB2020,081,4,Queens,40033022008,18,13,5,3.38
2020,CB2020,081,4,Queens,40033022009,0,0,0,2.88
2020,CB2020,081,4,Queens,40033022010,158,153,5,2.71
2020,CB2020,081,4,Queens,40033022011,154,85,69,2.82
2020,CB2020,081,4,Queens,40033022012,148,78,70,3.33
2020,CB2020,081,4,Queens,40034001000,32,12,20,8.59
2020,CB2020,081,4,Queens,40034001001,0,0,0,2.84
2020,CB2020,081,4,Queens,40034001002,179,84,95,2.82
2020,CB2020,081,4,Queens,40034001003,233,117,116,2.82
2020,CB2020,081,4,Queens,40034001004,114,46,68,2.83
2020,CB2020,081,4,Queens,40034001005,68,32,36,2.82
2020,CB2020,081,4,Queens,40034001006,184,84,100,2.79
2020,CB2020,081,4,Queens,40034001007,81,62,19,2.86
2020,CB2020,081,4,Queens,40034001008,0,0,0,1.79
2020,CB2020,081,4,Queens,40034001009,0,0,0,0.64
2020,CB2020,081,4,Queens,40034001010,81,32,49,2.31
2020,CB2020,081,4,Queens,40034001011,55,28,27,1.06
2020,CB2020,081,4,Queens,40034002000,191,100,91,2.91
2020,CB2020,081,4,Queens,40034002001,223,119,104,2.94
2020,CB2020,081,4,Queens,40034002002,201,114,87,2.89
2020,CB2020,081,4,Queens,40034002003,246,99,147,2.99
2020,CB2020,081,4,Queens,40034002004,339,169,170,3.8
2020,CB2020,081,4,Queens,40034002005,215,101,114,3.19
2020,CB2020,081,4,Queens,40036001000,234,134,100,2.73
2020,CB2020,081,4,Queens,40036001001,190,89,101,2.68
2020,CB2020,081,4,Queens,40036001002,259,132,127,2.61
2020,CB2020,081,4,Queens,40036001003,221,100,121,2.62
2020,CB2020,081,4,Queens,40036001004,225,118,107,2.62
2020,CB2020,081,4,Queens,40036001005,212,100,112,2.61
2020,CB2020,081,4,Queens,40036001006,279,100,179,2.62
2020,CB2020,081,4,Queens,40036001007,144,94,50,2.4
2020,CB2020,081,4,Queens,40036001008,66,43,23,1.19
2020,CB2020,081,4,Queens,40036001009,95,30,65,1.88
2020,CB2020,081,4,Queens,40036001010,79,36,43,1.83
2020,CB2020,081,4,Queens,40036001011,0,0,0,0.29
2020,CB2020,081,4,Queens,40036001012,0,0,0,0.3
2020,CB2020,081,4,Queens,40036002000,223,104,119,2.69
2020,CB2020,081,4,Queens,40036002001,363,179,184,2.75
2020,CB2020,081,4,Queens,40036002002,328,178,150,2.75
2020,CB2020,081,4,Queens,40036002003,355,158,197,2.75
2020,CB2020,081,4,Queens,40036002004,331,173,158,2.75
2020,CB2020,081,4,Queens,40036002005,300,141,159,2.76
2020,CB2020,081,4,Queens,40036002006,291,130,161,1.67
2020,CB2020,081,4,Queens,40037001000,0,0,0,0
2020,CB2020,081,4,Queens,40037001001,1,1,0,16.2
2020,CB2020,081,4,Queens,40037001002,0,0,0,0
2020,CB2020,081,4,Queens,40037001003,1,1,0,17.24
2020,CB2020,081,4,Queens,40037001004,0,0,0,10.76
2020,CB2020,081,4,Queens,40037001005,0,0,0,50.77
2020,CB2020,081,4,Queens,40037001006,0,0,0,0.12
2020,CB2020,081,4,Queens,40037001007,0,0,0,0.44
2020,CB2020,081,4,Queens,40038001000,0,0,0,1.4
2020,CB2020,081,4,Queens,40038001001,125,60,65,3.81
2020,CB2020,081,4,Queens,40038001002,126,55,71,1.52
2020,CB2020,081,4,Queens,40038001003,131,84,47,2.2
2020,CB2020,081,4,Queens,40038001004,78,37,41,2.04
2020,CB2020,081,4,Queens,40038001005,179,91,88,1.6
2020,CB2020,081,4,Queens,40038001006,201,106,95,4.06
2020,CB2020,081,4,Queens,40038001007,0,0,0,0.52
2020,CB2020,081,4,Queens,40038001008,0,0,0,0.5
2020,CB2020,081,4,Queens,40038001009,0,0,0,0.52
2020,CB2020,081,4,Queens,40038001010,129,62,67,2.28
2020,CB2020,081,4,Queens,40038001011,0,0,0,3.9
2020,CB2020,081,4,Queens,40038002000,390,195,195,3.91
2020,CB2020,081,4,Queens,40038002001,317,152,165,3.91
2020,CB2020,081,4,Queens,40038002002,260,121,139,3.84
2020,CB2020,081,4,Queens,40038002003,284,138,146,3.76
2020,CB2020,081,4,Queens,40038002004,270,128,142,3.78
2020,CB2020,081,4,Queens,40039001000,184,99,85,3.61
2020,CB2020,081,4,Queens,40039001001,72,42,30,3.04
2020,CB2020,081,4,Queens,40039001002,229,148,81,4.36
2020,CB2020,081,4,Queens,40039001003,495,286,209,4.15
2020,CB2020,081,4,Queens,40039001004,116,62,54,4.03
2020,CB2020,081,4,Queens,40039001005,240,120,120,4.22
2020,CB2020,081,4,Queens,40039001006,87,43,44,3.25
2020,CB2020,081,4,Queens,40039001007,0,0,0,3.1
2020,CB2020,081,4,Queens,40039001008,39,21,18,3.21
2020,CB2020,081,4,Queens,40039001009,0,0,0,3.35
2020,CB2020,081,4,Queens,40040011000,0,0,0,1.64
2020,CB2020,081,4,Queens,40040011001,293,160,133,4.58
2020,CB2020,081,4,Queens,40040011002,298,161,137,3.9
2020,CB2020,081,4,Queens,40040011003,326,171,155,5.08
2020,CB2020,081,4,Queens,40040011004,215,88,127,3.9
2020,CB2020,081,4,Queens,40040011005,0,0,0,0.59
2020,CB2020,081,4,Queens,40040011006,0,0,0,0.65
2020,CB2020,081,4,Queens,40040011007,112,42,70,0.66
2020,CB2020,081,4,Queens,40040012000,0,0,0,0.63
2020,CB2020,081,4,Queens,40040012001,120,50,70,2.63
2020,CB2020,081,4,Queens,40040012002,353,189,164,4.5
2020,CB2020,081,4,Queens,40040012003,318,146,172,4.53
2020,CB2020,081,4,Queens,40040012004,75,37,38,4.31
2020,CB2020,081,4,Queens,40040012005,240,125,115,3.04
2020,CB2020,081,4,Queens,40040012006,53,25,28,1.81
2020,CB2020,081,4,Queens,40040012007,0,0,0,0.62
2020,CB2020,081,4,Queens,40040021000,0,0,0,1.69
2020,CB2020,081,4,Queens,40040021001,43,18,25,4.78
2020,CB2020,081,4,Queens,40040021002,545,244,301,4.7
2020,CB2020,081,4,Queens,40040021003,313,160,153,4.51
2020,CB2020,081,4,Queens,40040021004,178,97,81,4.32
2020,CB2020,081,4,Queens,40040021005,28,18,10,0.33
2020,CB2020,081,4,Queens,40040021006,0,0,0,0.52
2020,CB2020,081,4,Queens,40040021007,0,0,0,0.48
2020,CB2020,081,4,Queens,40040021008,0,0,0,0.46
2020,CB2020,081,4,Queens,40040021009,84,30,54,1.67
2020,CB2020,081,4,Queens,40040021010,95,42,53,2.4
2020,CB2020,081,4,Queens,40040021011,25,10,15,1.19
2020,CB2020,081,4,Queens,40040021012,0,0,0,1.95
2020,CB2020,081,4,Queens,40040021013,0,0,0,1.33
2020,CB2020,081,4,Queens,40040021014,50,22,28,2
2020,CB2020,081,4,Queens,40042001000,203,102,101,3.24
2020,CB2020,081,4,Queens,40042001001,52,35,17,2.1
2020,CB2020,081,4,Queens,40042001002,37,18,19,0.95
2020,CB2020,081,4,Queens,40042001003,309,165,144,3.83
2020,CB2020,081,4,Queens,40042001004,360,189,171,3.77
2020,CB2020,081,4,Queens,40042001005,86,48,38,3.73
2020,CB2020,081,4,Queens,40042001006,430,200,230,3.83
2020,CB2020,081,4,Queens,40042001007,52,22,30,1.63
2020,CB2020,081,4,Queens,40042001008,155,88,67,2.73
2020,CB2020,081,4,Queens,40042001009,0,0,0,0.52
2020,CB2020,081,4,Queens,40042002000,441,213,228,3.89
2020,CB2020,081,4,Queens,40042002001,364,192,172,3.87
2020,CB2020,081,4,Queens,40042002002,448,243,205,3.86
2020,CB2020,081,4,Queens,40042003000,564,277,287,3.92
2020,CB2020,081,4,Queens,40042003001,523,298,225,3.86
2020,CB2020,081,4,Queens,40042003002,481,248,233,3.76
2020,CB2020,081,4,Queens,40043001000,904,358,546,14.15
2020,CB2020,081,4,Queens,40043001001,1252,498,754,12.19
2020,CB2020,081,4,Queens,40043002000,38,19,19,3.26
2020,CB2020,081,4,Queens,40043002001,111,53,58,3.07
2020,CB2020,081,4,Queens,40043002002,21,9,12,3.2
2020,CB2020,081,4,Queens,40043002003,0,0,0,3.41
2020,CB2020,081,4,Queens,40043002004,0,0,0,0.78
2020,CB2020,081,4,Queens,40043002005,0,0,0,2.14
2020,CB2020,081,4,Queens,40044011000,339,161,178,3.15
2020,CB2020,081,4,Queens,40044011001,155,94,61,2.01
2020,CB2020,081,4,Queens,40044011002,0,0,0,1.6
2020,CB2020,081,4,Queens,40044011003,0,0,0,1.93
2020,CB2020,081,4,Queens,40044011004,129,50,79,2.82
2020,CB2020,081,4,Queens,40044011005,207,86,121,2.83
2020,CB2020,081,4,Queens,40044011006,274,143,131,2.85
2020,CB2020,081,4,Queens,40044011007,0,0,0,2.83
2020,CB2020,081,4,Queens,40044011008,199,94,105,2.31
2020,CB2020,081,4,Queens,40044011009,74,26,48,0.59
2020,CB2020,081,4,Queens,40044011010,33,7,26,0.48
2020,CB2020,081,4,Queens,40044011011,296,148,148,3.32
2020,CB2020,081,4,Queens,40044011012,228,108,120,3.08
2020,CB2020,081,4,Queens,40044011013,197,94,103,2.82
2020,CB2020,081,4,Queens,40044012000,115,71,44,1.93
2020,CB2020,081,4,Queens,40044012001,240,104,136,2.82
2020,CB2020,081,4,Queens,40044012002,20,14,6,0.9
2020,CB2020,081,4,Queens,40044012003,282,130,152,4.61
2020,CB2020,081,4,Queens,40044012004,130,72,58,2.76
2020,CB2020,081,4,Queens,40044012005,292,130,162,4.28
2020,CB2020,081,4,Queens,40044012006,150,61,89,3.58
2020,CB2020,081,4,Queens,40044012007,101,53,48,2.66
2020,CB2020,081,4,Queens,40044012008,76,55,21,2.16
2020,CB2020,081,4,Queens,40044012009,0,0,0,0.8
2020,CB2020,081,4,Queens,40044012010,114,46,68,1.87
2020,CB2020,081,4,Queens,40044012011,265,152,113,3.87
2020,CB2020,081,4,Queens,40045001000,0,0,0,2.85
2020,CB2020,081,4,Queens,40045001001,0,0,0,1.22
2020,CB2020,081,4,Queens,40045001002,0,0,0,1.67
2020,CB2020,081,4,Queens,40045001003,0,0,0,1.94
2020,CB2020,081,4,Queens,40045001004,0,0,0,3.46
2020,CB2020,081,4,Queens,40045001005,0,0,0,4.97
2020,CB2020,081,4,Queens,40045001006,447,211,236,4.85
2020,CB2020,081,4,Queens,40045001007,224,112,112,4.05
2020,CB2020,081,4,Queens,40045001008,126,70,56,4.12
2020,CB2020,081,4,Queens,40045001009,202,113,89,2.8
2020,CB2020,081,4,Queens,40045001010,183,76,107,3.04
2020,CB2020,081,4,Queens,40045002000,744,329,415,6.17
2020,CB2020,081,4,Queens,40045003000,594,270,324,6.62
2020,CB2020,081,4,Queens,40045003001,732,313,419,6.68
2020,CB2020,081,4,Queens,40047001000,336,186,150,4.91
2020,CB2020,081,4,Queens,40047001001,622,314,308,4.8
2020,CB2020,081,4,Queens,40047001002,508,255,253,5.54
2020,CB2020,081,4,Queens,40047001003,162,78,84,4.57
2020,CB2020,081,4,Queens,40047002000,1200,500,700,12.07
2020,CB2020,081,4,Queens,40047002001,1262,466,796,12.41
2020,CB2020,081,4,Queens,40050001000,0,0,0,37.49
2020,CB2020,081,4,Queens,40050001001,0,0,0,0.25
2020,CB2020,081,4,Queens,40051001000,312,180,132,3.82
2020,CB2020,081,4,Queens,40051001001,608,300,308,3.93
2020,CB2020,081,4,Queens,40051001002,286,153,133,4.06
2020,CB2020,081,4,Queens,40051001003,333,151,182,4.16
2020,CB2020,081,4,Queens,40051002000,393,214,179,2.94
2020,CB2020,081,4,Queens,40051002001,199,99,100,2.69
2020,CB2020,081,4,Queens,40051002002,140,70,70,3.12
2020,CB2020,081,4,Queens,40051002003,40,21,19,1.26
2020,CB2020,081,4,Queens,40051002004,27,21,6,1.84
2020,CB2020,081,4,Queens,40051002005,22,6,16,3.05
2020,CB2020,081,4,Queens,40051002006,152,69,83,3.02
2020,CB2020,081,4,Queens,40052001000,318,130,188,3.04
2020,CB2020,081,4,Queens,40052001001,199,103,96,3.04
2020,CB2020,081,4,Queens,40052001002,291,157,134,2.87
2020,CB2020,081,4,Queens,40052001003,253,115,138,2.89
2020,CB2020,081,4,Queens,40052001004,179,100,79,2.02
2020,CB2020,081,4,Queens,40052001005,65,38,27,1.01
2020,CB2020,081,4,Queens,40052001006,59,33,26,1.3
2020,CB2020,081,4,Queens,40052001007,134,63,71,1.79
2020,CB2020,081,4,Queens,40052002000,433,207,226,4.6
2020,CB2020,081,4,Queens,40052002001,506,258,248,4.28
2020,CB2020,081,4,Queens,40052002002,112,59,53,0.85
2020,CB2020,081,4,Queens,40052002003,51,21,30,1.55
2020,CB2020,081,4,Queens,40052002004,480,270,210,3.03
2020,CB2020,081,4,Queens,40053001000,492,251,241,3.98
2020,CB2020,081,4,Queens,40053001001,225,114,111,2.97
2020,CB2020,081,4,Queens,40053001002,676,329,347,5.87
2020,CB2020,081,4,Queens,40053002000,374,174,200,3.38
2020,CB2020,081,4,Queens,40053002001,454,215,239,4.38
2020,CB2020,081,4,Queens,40053002002,569,277,292,4.3
2020,CB2020,081,4,Queens,40053003000,333,157,176,3.95
2020,CB2020,081,4,Queens,40053003001,639,320,319,3.94
2020,CB2020,081,4,Queens,40053004000,447,244,203,3.95
2020,CB2020,081,4,Queens,40053004001,550,258,292,3.95
2020,CB2020,081,4,Queens,40053004002,344,159,185,3.96
2020,CB2020,081,4,Queens,40053004003,294,157,137,3.93
2020,CB2020,081,4,Queens,40054001000,0,0,0,0.36
2020,CB2020,081,4,Queens,40054001001,0,0,0,1.68
2020,CB2020,081,4,Queens,40054001002,31,18,13,2.5
2020,CB2020,081,4,Queens,40054001003,212,76,136,3.05
2020,CB2020,081,4,Queens,40054001004,0,0,0,0.31
2020,CB2020,081,4,Queens,40054001005,199,77,122,3.62
2020,CB2020,081,4,Queens,40054001006,206,127,79,3.45
2020,CB2020,081,4,Queens,40054001007,202,100,102,3.79
2020,CB2020,081,4,Queens,40054002000,0,0,0,0.84
2020,CB2020,081,4,Queens,40054002001,103,47,56,2.64
2020,CB2020,081,4,Queens,40054002002,265,137,128,4.44
2020,CB2020,081,4,Queens,40054002003,260,135,125,4.42
2020,CB2020,081,4,Queens,40054002004,141,62,79,4.31
2020,CB2020,081,4,Queens,40054002005,239,120,119,4.27
2020,CB2020,081,4,Queens,40054002006,194,94,100,4.25
2020,CB2020,081,4,Queens,40054003000,35,19,16,2.18
2020,CB2020,081,4,Queens,40054003001,0,0,0,0.49
2020,CB2020,081,4,Queens,40054003002,187,109,78,3.1
2020,CB2020,081,4,Queens,40054003003,255,136,119,4.49
2020,CB2020,081,4,Queens,40054003004,256,110,146,4.29
2020,CB2020,081,4,Queens,40054003005,231,119,112,4.25
2020,CB2020,081,4,Queens,40054003006,255,124,131,4.19
2020,CB2020,081,4,Queens,40054003007,94,29,65,2.17
2020,CB2020,081,4,Queens,40054003008,131,58,73,2.04
2020,CB2020,081,4,Queens,40054003009,146,78,68,2.8
2020,CB2020,081,4,Queens,40054003010,157,86,71,2.47
2020,CB2020,081,4,Queens,40054004000,71,34,37,1.52
2020,CB2020,081,4,Queens,40054004001,105,40,65,1.17
2020,CB2020,081,4,Queens,40054004002,0,0,0,0.89
2020,CB2020,081,4,Queens,40054004003,114,59,55,1.44
2020,CB2020,081,4,Queens,40054004004,139,84,55,1.5
2020,CB2020,081,4,Queens,40054004005,99,52,47,1.5
2020,CB2020,081,4,Queens,40054004006,134,56,78,2.12
2020,CB2020,081,4,Queens,40054004007,134,46,88,2.57
2020,CB2020,081,4,Queens,40054004008,247,136,111,3.87
2020,CB2020,081,4,Queens,40054004009,256,110,146,3.99
2020,CB2020,081,4,Queens,40054004010,422,216,206,4.12
2020,CB2020,081,4,Queens,40054004011,89,43,46,1.71
2020,CB2020,081,4,Queens,40055001000,139,71,68,4.32
2020,CB2020,081,4,Queens,40055001001,20,12,8,4.45
2020,CB2020,081,4,Queens,40055001002,372,216,156,4.06
2020,CB2020,081,4,Queens,40055001003,53,16,37,4.7
2020,CB2020,081,4,Queens,40055001004,44,14,30,2.42
2020,CB2020,081,4,Queens,40055001005,137,56,81,5.18
2020,CB2020,081,4,Queens,40055001006,22,12,10,2.38
2020,CB2020,081,4,Queens,40055001007,41,18,23,1.61
2020,CB2020,081,4,Queens,40055001008,87,56,31,2.59
2020,CB2020,081,4,Queens,40055001009,0,0,0,2.86
2020,CB2020,081,4,Queens,40055001010,227,125,102,2.94
2020,CB2020,081,4,Queens,40055001011,106,73,33,2.98
2020,CB2020,081,4,Queens,40055001012,119,70,49,0.51
2020,CB2020,081,4,Queens,40057001000,562,278,284,3.94
2020,CB2020,081,4,Queens,40057001001,376,211,165,3.94
2020,CB2020,081,4,Queens,40057001002,385,200,185,3.95
2020,CB2020,081,4,Queens,40057001003,0,0,0,3.93
2020,CB2020,081,4,Queens,40057001004,32,9,23,3.95
2020,CB2020,081,4,Queens,40057001005,216,111,105,3.95
2020,CB2020,081,4,Queens,40057001006,410,191,219,3.95
2020,CB2020,081,4,Queens,40057002000,329,158,171,3.96
2020,CB2020,081,4,Queens,40057002001,500,268,232,3.93
2020,CB2020,081,4,Queens,40057003000,575,258,317,3.95
2020,CB2020,081,4,Queens,40057003001,844,419,425,3.95
2020,CB2020,081,4,Queens,40057003002,0,0,0,3.94
2020,CB2020,081,4,Queens,40057003003,0,0,0,3.95
2020,CB2020,081,4,Queens,40057003004,48,28,20,3.94
2020,CB2020,081,4,Queens,40058001000,214,116,98,3.46
2020,CB2020,081,4,Queens,40058001001,124,81,43,1.85
2020,CB2020,081,4,Queens,40058001002,260,141,119,4.42
2020,CB2020,081,4,Queens,40058001003,345,145,200,4.38
2020,CB2020,081,4,Queens,40058001004,168,77,91,3.44
2020,CB2020,081,4,Queens,40058001005,17,4,13,0.54
2020,CB2020,081,4,Queens,40058001006,308,157,151,3.86
2020,CB2020,081,4,Queens,40058001007,104,58,46,2.33
2020,CB2020,081,4,Queens,40058001008,36,15,21,0.57
2020,CB2020,081,4,Queens,40058001009,151,49,102,3.62
2020,CB2020,081,4,Queens,40058001010,46,21,25,0.7
2020,CB2020,081,4,Queens,40058001011,47,18,29,0.88
2020,CB2020,081,4,Queens,40058001012,215,115,100,4.25
2020,CB2020,081,4,Queens,40058001013,177,89,88,4.27
2020,CB2020,081,4,Queens,40058001014,195,86,109,4.56
2020,CB2020,081,4,Queens,40058002000,0,0,0,0.59
2020,CB2020,081,4,Queens,40058002001,0,0,0,0.42
2020,CB2020,081,4,Queens,40058002002,48,21,27,2.81
2020,CB2020,081,4,Queens,40058002003,441,219,222,4.39
2020,CB2020,081,4,Queens,40058002004,127,55,72,2.33
2020,CB2020,081,4,Queens,40058002005,161,79,82,2.13
2020,CB2020,081,4,Queens,40058002006,148,43,105,2.86
2020,CB2020,081,4,Queens,40058002007,110,61,49,1.97
2020,CB2020,081,4,Queens,40058002008,158,70,88,5.82
2020,CB2020,081,4,Queens,40058002009,0,0,0,5.28
2020,CB2020,081,4,Queens,40058002010,31,16,15,1.18
2020,CB2020,081,4,Queens,40058003000,96,73,23,2.84
2020,CB2020,081,4,Queens,40058003001,60,31,29,1.91
2020,CB2020,081,4,Queens,40058003002,70,38,32,1.03
2020,CB2020,081,4,Queens,40058003003,98,48,50,2.44
2020,CB2020,081,4,Queens,40058003004,50,28,22,1.56
2020,CB2020,081,4,Queens,40058003005,20,11,9,0.58
2020,CB2020,081,4,Queens,40058003006,179,102,77,3.4
2020,CB2020,081,4,Queens,40058003007,223,83,140,3.73
2020,CB2020,081,4,Queens,40058003008,136,73,63,3.46
2020,CB2020,081,4,Queens,40058003009,228,127,101,13.05
2020,CB2020,081,4,Queens,40058003010,151,68,83,3.3
2020,CB2020,081,4,Queens,40058003011,175,85,90,3.5
2020,CB2020,081,4,Queens,40058003012,65,20,45,1.15
2020,CB2020,081,4,Queens,40058003013,0,0,0,0.7
2020,CB2020,081,4,Queens,40058004000,168,84,84,3.42
2020,CB2020,081,4,Queens,40058004001,232,110,122,5.55
2020,CB2020,081,4,Queens,40058004002,128,66,62,3.31
2020,CB2020,081,4,Queens,40058004003,188,61,127,3.51
2020,CB2020,081,4,Queens,40058004004,147,68,79,10.85
2020,CB2020,081,4,Queens,40058004005,149,76,73,3.7
2020,CB2020,081,4,Queens,40059001000,664,307,357,5.88
2020,CB2020,081,4,Queens,40059001001,527,285,242,5.86
2020,CB2020,081,4,Queens,40059001002,74,42,32,3.75
2020,CB2020,081,4,Queens,40059001003,110,28,82,2.12
2020,CB2020,081,4,Queens,40059001004,478,245,233,5.88
2020,CB2020,081,4,Queens,40059002000,771,393,378,5.88
2020,CB2020,081,4,Queens,40059002001,619,306,313,5.86
2020,CB2020,081,4,Queens,40059003000,640,300,340,5.93
2020,CB2020,081,4,Queens,40059003001,348,169,179,5.84
2020,CB2020,081,4,Queens,40061001000,588,282,306,6.11
2020,CB2020,081,4,Queens,40061001001,723,359,364,6.03
2020,CB2020,081,4,Queens,40061002000,878,402,476,6.02
2020,CB2020,081,4,Queens,40061002001,1124,544,580,6
2020,CB2020,081,4,Queens,40061003000,921,442,479,6.01
2020,CB2020,081,4,Queens,40061003001,764,398,366,6.01
2020,CB2020,081,4,Queens,40061004000,264,146,118,3.42
2020,CB2020,081,4,Queens,40061004001,210,106,104,2.59
2020,CB2020,081,4,Queens,40061004002,819,410,409,6
2020,CB2020,081,4,Queens,40062011000,343,152,191,11.1
2020,CB2020,081,4,Queens,40062011001,283,133,150,3.13
2020,CB2020,081,4,Queens,40062011002,706,307,399,8.33
2020,CB2020,081,4,Queens,40062011003,306,139,167,3.67
2020,CB2020,081,4,Queens,40062011004,0,0,0,0.77
2020,CB2020,081,4,Queens,40062011005,354,170,184,11.92
2020,CB2020,081,4,Queens,40062011006,0,0,0,3.81
2020,CB2020,081,4,Queens,40062011007,0,0,0,4.11
2020,CB2020,081,4,Queens,40062011008,263,100,163,10.06
2020,CB2020,081,4,Queens,40062011009,161,78,83,5.38
2020,CB2020,081,4,Queens,40062011010,0,0,0,2.37
2020,CB2020,081,4,Queens,40062012000,1137,528,609,12.85
2020,CB2020,081,4,Queens,40062013000,1058,455,603,12.34
2020,CB2020,081,4,Queens,40062013001,778,375,403,9.71
2020,CB2020,081,4,Queens,40062021000,0,0,0,1.66
2020,CB2020,081,4,Queens,40062021001,0,0,0,15.19
2020,CB2020,081,4,Queens,40062021002,0,0,0,1.23
2020,CB2020,081,4,Queens,40062021003,73,43,30,2.17
2020,CB2020,081,4,Queens,40062021004,0,0,0,1.28
2020,CB2020,081,4,Queens,40062021005,0,0,0,17.07
2020,CB2020,081,4,Queens,40062021006,22,7,15,3.6
2020,CB2020,081,4,Queens,40062021007,73,38,35,3.47
2020,CB2020,081,4,Queens,40062021008,72,34,38,3.39
2020,CB2020,081,4,Queens,40062021009,0,0,0,4.61
2020,CB2020,081,4,Queens,40062022000,0,0,0,3.56
2020,CB2020,081,4,Queens,40062022001,0,0,0,9.42
2020,CB2020,081,4,Queens,40062022002,486,237,249,22.07
2020,CB2020,081,4,Queens,40062022003,172,87,85,3.64
2020,CB2020,081,4,Queens,40062022004,0,0,0,0.33
2020,CB2020,081,4,Queens,40062022005,29,18,11,4.09
2020,CB2020,081,4,Queens,40062022006,0,0,0,1.54
2020,CB2020,081,4,Queens,40062023000,213,91,122,3.56
2020,CB2020,081,4,Queens,40062023001,178,87,91,3.45
2020,CB2020,081,4,Queens,40062023002,212,97,115,3.69
2020,CB2020,081,4,Queens,40062023003,180,90,90,3.48
2020,CB2020,081,4,Queens,40062023004,178,99,79,3.5
2020,CB2020,081,4,Queens,40062023005,91,38,53,3.68
2020,CB2020,081,4,Queens,40062024000,84,36,48,6.95
2020,CB2020,081,4,Queens,40062024001,199,102,97,3.65
2020,CB2020,081,4,Queens,40062024002,125,76,49,3.46
2020,CB2020,081,4,Queens,40062024003,241,120,121,3.5
2020,CB2020,081,4,Queens,40062024004,306,117,189,3.55
2020,CB2020,081,4,Queens,40062025000,0,0,0,3.89
2020,CB2020,081,4,Queens,40062025001,216,105,111,3.7
2020,CB2020,081,4,Queens,40062025002,160,87,73,3.95
2020,CB2020,081,4,Queens,40062025003,140,78,62,3.71
2020,CB2020,081,4,Queens,40062025004,172,66,106,3.8
2020,CB2020,081,4,Queens,40062025005,275,121,154,3.93
2020,CB2020,081,4,Queens,40062026000,412,196,216,13.12
2020,CB2020,081,4,Queens,40062026001,242,118,124,7.62
2020,CB2020,081,4,Queens,40062026002,374,176,198,4.11
2020,CB2020,081,4,Queens,40062026003,213,88,125,11.59
2020,CB2020,081,4,Queens,40062026004,0,0,0,0.23
2020,CB2020,081,4,Queens,40062027000,0,0,0,55.05
2020,CB2020,081,4,Queens,40062027001,320,156,164,3.61
2020,CB2020,081,4,Queens,40062027002,326,152,174,3.56
2020,CB2020,081,4,Queens,40062027003,364,179,185,3.87
2020,CB2020,081,4,Queens,40062027004,334,166,168,3.6
2020,CB2020,081,4,Queens,40062027005,269,135,134,3.56
2020,CB2020,081,4,Queens,40062027006,198,93,105,6.85
2020,CB2020,081,4,Queens,40062027007,0,0,0,3.94
2020,CB2020,081,4,Queens,40062027008,0,0,0,0.43
2020,CB2020,081,4,Queens,40062027009,0,0,0,0
2020,CB2020,081,4,Queens,40063001000,241,140,101,4.25
2020,CB2020,081,4,Queens,40063001001,676,313,363,6.52
2020,CB2020,081,4,Queens,40063001002,166,66,100,2.25
2020,CB2020,081,4,Queens,40063002000,785,402,383,6.58
2020,CB2020,081,4,Queens,40063002001,733,363,370,3.25
2020,CB2020,081,4,Queens,40063002002,524,266,258,2.5
2020,CB2020,081,4,Queens,40063002003,125,44,81,0.84
2020,CB2020,081,4,Queens,40063003000,1097,526,571,6.57
2020,CB2020,081,4,Queens,40063003001,419,195,224,5.91
2020,CB2020,081,4,Queens,40063003002,74,33,41,0.68
2020,CB2020,081,4,Queens,40063004000,437,204,233,5.77
2020,CB2020,081,4,Queens,40063004001,467,217,250,6.58
2020,CB2020,081,4,Queens,40063004002,133,67,66,0.82
2020,CB2020,081,4,Queens,40065011000,342,158,184,2.72
2020,CB2020,081,4,Queens,40065011001,221,95,126,1.33
2020,CB2020,081,4,Queens,40065011002,834,408,426,4.06
2020,CB2020,081,4,Queens,40065012000,303,147,156,3.42
2020,CB2020,081,4,Queens,40065012001,275,136,139,2.12
2020,CB2020,081,4,Queens,40065012002,550,289,261,3.9
2020,CB2020,081,4,Queens,40065012003,304,158,146,3.8
2020,CB2020,081,4,Queens,40065013000,816,417,399,6.1
2020,CB2020,081,4,Queens,40065021000,392,174,218,4.05
2020,CB2020,081,4,Queens,40065021001,433,215,218,4.07
2020,CB2020,081,4,Queens,40065021002,538,283,255,4.06
2020,CB2020,081,4,Queens,40065021003,286,154,132,4.06
2020,CB2020,081,4,Queens,40065022000,747,360,387,6.65
2020,CB2020,081,4,Queens,40065023000,785,425,360,7.76
2020,CB2020,081,4,Queens,40065023001,823,386,437,7.24
2020,CB2020,081,4,Queens,40069001000,1136,576,560,9.1
2020,CB2020,081,4,Queens,40069001001,496,231,265,6.52
2020,CB2020,081,4,Queens,40069002000,155,75,80,2.17
2020,CB2020,081,4,Queens,40069002001,497,177,320,4.02
2020,CB2020,081,4,Queens,40069002002,487,236,251,3.43
2020,CB2020,081,4,Queens,40069002003,941,490,451,8.77
2020,CB2020,081,4,Queens,40069002004,29,15,14,3.08
2020,CB2020,081,4,Queens,40069002005,50,14,36,0.83
2020,CB2020,081,4,Queens,40069003000,599,277,322,6.86
2020,CB2020,081,4,Queens,40069003001,655,287,368,5.2
2020,CB2020,081,4,Queens,40069003002,151,82,69,2.12
2020,CB2020,081,4,Queens,40071001000,168,85,83,2.04
2020,CB2020,081,4,Queens,40071001001,186,90,96,2.16
2020,CB2020,081,4,Queens,40071001002,142,87,55,2.62
2020,CB2020,081,4,Queens,40071001003,191,100,91,2.7
2020,CB2020,081,4,Queens,40071002000,512,259,253,2.68
2020,CB2020,081,4,Queens,40071002001,470,200,270,2.82
2020,CB2020,081,4,Queens,40071003000,574,307,267,3.07
2020,CB2020,081,4,Queens,40071003001,362,181,181,4.5
2020,CB2020,081,4,Queens,40071003002,404,184,220,4.02
2020,CB2020,081,4,Queens,40071004000,478,212,266,6.02
2020,CB2020,081,4,Queens,40071004001,301,159,142,4.03
2020,CB2020,081,4,Queens,40071004002,0,0,0,0.46
2020,CB2020,081,4,Queens,40071004003,192,74,118,2.11
2020,CB2020,081,4,Queens,40071004004,90,45,45,2.58
2020,CB2020,081,4,Queens,40071004005,190,90,100,4.97
2020,CB2020,081,4,Queens,40071004006,95,60,35,1.43
2020,CB2020,081,4,Queens,40073001000,172,91,81,4.02
2020,CB2020,081,4,Queens,40073001001,542,264,278,4.03
2020,CB2020,081,4,Queens,40073001002,528,238,290,4.25
2020,CB2020,081,4,Queens,40073002000,1185,551,634,5.85
2020,CB2020,081,4,Queens,40073002001,466,234,232,4.59
2020,CB2020,081,4,Queens,40073003000,327,159,168,3.38
2020,CB2020,081,4,Queens,40073003001,263,137,126,2.32
2020,CB2020,081,4,Queens,40073003002,191,93,98,1.12
2020,CB2020,081,4,Queens,40073003003,470,238,232,3.15
2020,CB2020,081,4,Queens,40073003004,234,125,109,1.63
2020,CB2020,081,4,Queens,40073003005,92,35,57,0.64
2020,CB2020,081,4,Queens,40075001000,699,336,363,5.66
2020,CB2020,081,4,Queens,40075001001,641,272,369,4.22
2020,CB2020,081,4,Queens,40075001002,580,292,288,5.88
2020,CB2020,081,4,Queens,40075002000,1661,773,888,10.09
2020,CB2020,081,4,Queens,40075003000,896,440,456,6.08
2020,CB2020,081,4,Queens,40077001000,275,123,152,2.89
2020,CB2020,081,4,Queens,40077001001,354,178,176,4.07
2020,CB2020,081,4,Queens,40077001002,189,104,85,4.43
2020,CB2020,081,4,Queens,40077001003,0,0,0,2.52
2020,CB2020,081,4,Queens,40077001004,191,114,77,3.85
2020,CB2020,081,4,Queens,40077001005,591,295,296,5.91
2020,CB2020,081,4,Queens,40077001006,504,245,259,3.81
2020,CB2020,081,4,Queens,40077001007,10,8,2,3.82
2020,CB2020,081,4,Queens,40079001000,285,167,118,3.74
2020,CB2020,081,4,Queens,40079001001,405,223,182,5.5
2020,CB2020,081,4,Queens,40079001002,382,157,225,3.51
2020,CB2020,081,4,Queens,40079001003,355,155,200,3.48
2020,CB2020,081,4,Queens,40079001004,596,322,274,5.88
2020,CB2020,081,4,Queens,40079001005,437,227,210,4.02
2020,CB2020,081,4,Queens,40079002000,127,79,48,2.32
2020,CB2020,081,4,Queens,40079002001,247,140,107,3.58
2020,CB2020,081,4,Queens,40079002002,286,151,135,2.59
2020,CB2020,081,4,Queens,40079002003,220,112,108,1.21
2020,CB2020,081,4,Queens,40079002004,112,42,70,2.39
2020,CB2020,081,4,Queens,40079002005,176,80,96,1.45
2020,CB2020,081,4,Queens,40081001000,33,26,7,1.62
2020,CB2020,081,4,Queens,40081001001,0,0,0,1.39
2020,CB2020,081,4,Queens,40081001002,0,0,0,0.4
2020,CB2020,081,4,Queens,40081001003,152,88,64,1.99
2020,CB2020,081,4,Queens,40081001004,421,241,180,5.04
2020,CB2020,081,4,Queens,40081001005,240,136,104,3.97
2020,CB2020,081,4,Queens,40081001006,220,98,122,4.71
2020,CB2020,081,4,Queens,40081001007,361,187,174,5.05
2020,CB2020,081,4,Queens,40081001008,334,154,180,3.58
2020,CB2020,081,4,Queens,40083001000,118,50,68,3.56
2020,CB2020,081,4,Queens,40083001001,478,265,213,5.1
2020,CB2020,081,4,Queens,40083001002,163,96,67,2.89
2020,CB2020,081,4,Queens,40083001003,396,197,199,3.29
2020,CB2020,081,4,Queens,40083002000,439,250,189,4.11
2020,CB2020,081,4,Queens,40083002001,197,83,114,3.31
2020,CB2020,081,4,Queens,40083002002,309,151,158,3.28
2020,CB2020,081,4,Queens,40083002003,873,537,336,9.02
2020,CB2020,081,4,Queens,40083002004,82,48,34,1
2020,CB2020,081,4,Queens,40083002005,207,112,95,4.06
2020,CB2020,081,4,Queens,40083002006,40,17,23,1.17
2020,CB2020,081,4,Queens,40083002007,166,79,87,2.28
2020,CB2020,081,4,Queens,40083002008,47,20,27,4.2
2020,CB2020,081,4,Queens,40085001000,24,16,8,3.76
2020,CB2020,081,4,Queens,40085001001,231,120,111,3.6
2020,CB2020,081,4,Queens,40085001002,64,33,31,4.13
2020,CB2020,081,4,Queens,40085001003,120,63,57,4.18
2020,CB2020,081,4,Queens,40085001004,84,49,35,4.16
2020,CB2020,081,4,Queens,40085001005,273,143,130,4.02
2020,CB2020,081,4,Queens,40085001006,108,59,49,3.09
2020,CB2020,081,4,Queens,40085001007,42,18,24,3.13
2020,CB2020,081,4,Queens,40085001008,48,27,21,3.13
2020,CB2020,081,4,Queens,40085001009,94,42,52,3.12
2020,CB2020,081,4,Queens,40085002000,316,239,77,6.23
2020,CB2020,081,4,Queens,40085002001,68,50,18,5.58
2020,CB2020,081,4,Queens,40085002002,190,183,7,5.03
2020,CB2020,081,4,Queens,40085002003,49,23,26,5.06
2020,CB2020,081,4,Queens,40085002004,268,231,37,4.73
2020,CB2020,081,4,Queens,40085002005,0,0,0,4.53
2020,CB2020,081,4,Queens,40086001000,0,0,0,1.57
2020,CB2020,081,4,Queens,40086001001,28,15,13,7.59
2020,CB2020,081,4,Queens,40086001002,224,117,107,4.44
2020,CB2020,081,4,Queens,40086001003,246,83,163,5.3
2020,CB2020,081,4,Queens,40086001004,244,126,118,4.44
2020,CB2020,081,4,Queens,40086001005,0,0,0,0.3
2020,CB2020,081,4,Queens,40086001006,0,0,0,0.25
2020,CB2020,081,4,Queens,40086001007,145,61,84,2.98
2020,CB2020,081,4,Queens,40086001008,166,69,97,3
2020,CB2020,081,4,Queens,40086001009,149,79,70,3.55
2020,CB2020,081,4,Queens,40086001010,161,112,49,3.31
2020,CB2020,081,4,Queens,40086001011,111,55,56,4.06
2020,CB2020,081,4,Queens,40086001012,24,17,7,0.9
2020,CB2020,081,4,Queens,40086001013,143,56,87,3.74
2020,CB2020,081,4,Queens,40086001014,0,0,0,0.32
2020,CB2020,081,4,Queens,40086001015,46,28,18,3.38
2020,CB2020,081,4,Queens,40086002000,134,68,66,3.57
2020,CB2020,081,4,Queens,40086002001,91,34,57,2.23
2020,CB2020,081,4,Queens,40086002002,91,30,61,1.46
2020,CB2020,081,4,Queens,40086002003,76,33,43,1.52
2020,CB2020,081,4,Queens,40086002004,168,79,89,3.95
2020,CB2020,081,4,Queens,40086002005,0,0,0,0.34
2020,CB2020,081,4,Queens,40086002006,0,0,0,0.64
2020,CB2020,081,4,Queens,40086002007,172,61,111,4.19
2020,CB2020,081,4,Queens,40086002008,50,21,29,1.24
2020,CB2020,081,4,Queens,40086002009,178,101,77,4.04
2020,CB2020,081,4,Queens,40086002010,76,54,22,2.3
2020,CB2020,081,4,Queens,40086002011,73,49,24,2.57
2020,CB2020,081,4,Queens,40086002012,59,30,29,1.1
2020,CB2020,081,4,Queens,40086002013,74,30,44,2.72
2020,CB2020,081,4,Queens,40086002014,60,34,26,1.24
2020,CB2020,081,4,Queens,40087001000,1367,557,810,20.24
2020,CB2020,081,4,Queens,40087001001,0,0,0,0
2020,CB2020,081,4,Queens,40087002000,752,345,407,9.16
2020,CB2020,081,4,Queens,40087002001,123,50,73,3.6
2020,CB2020,081,4,Queens,40087002002,260,140,120,4.01
2020,CB2020,081,4,Queens,40087002003,630,329,301,3.43
2020,CB2020,081,4,Queens,40087002004,0,0,0,4.15
2020,CB2020,081,4,Queens,40087003000,481,186,295,3.66
2020,CB2020,081,4,Queens,40087003001,1563,679,884,14.37
2020,CB2020,081,4,Queens,40088001000,59,23,36,2.61
2020,CB2020,081,4,Queens,40088001001,89,50,39,2.4
2020,CB2020,081,4,Queens,40088001002,130,43,87,2.85
2020,CB2020,081,4,Queens,40088001003,120,62,58,2.72
2020,CB2020,081,4,Queens,40088001004,148,72,76,3.34
2020,CB2020,081,4,Queens,40088001005,190,88,102,3.39
2020,CB2020,081,4,Queens,40088001006,105,56,49,3.32
2020,CB2020,081,4,Queens,40088001007,0,0,0,0.68
2020,CB2020,081,4,Queens,40088001008,175,89,86,18.91
2020,CB2020,081,4,Queens,40088001009,112,61,51,3.66
2020,CB2020,081,4,Queens,40088001010,121,57,64,2.58
2020,CB2020,081,4,Queens,40088001011,150,70,80,3.47
2020,CB2020,081,4,Queens,40088001012,87,34,53,2.98
2020,CB2020,081,4,Queens,40088001013,67,35,32,2.33
2020,CB2020,081,4,Queens,40088001014,80,42,38,2.2
2020,CB2020,081,4,Queens,40088001015,213,92,121,3.79
2020,CB2020,081,4,Queens,40088001016,142,57,85,7.03
2020,CB2020,081,4,Queens,40088001017,0,0,0,0.32
2020,CB2020,081,4,Queens,40088002000,88,22,66,2.01
2020,CB2020,081,4,Queens,40088002001,157,71,86,3.31
2020,CB2020,081,4,Queens,40088002002,160,84,76,3.42
2020,CB2020,081,4,Queens,40088002003,182,81,101,3.41
2020,CB2020,081,4,Queens,40088002004,152,74,78,3.4
2020,CB2020,081,4,Queens,40088002005,90,48,42,3.67
2020,CB2020,081,4,Queens,40088002006,0,0,0,0.71
2020,CB2020,081,4,Queens,40088002007,0,0,0,0.69
2020,CB2020,081,4,Queens,40088002008,312,143,169,7.62
2020,CB2020,081,4,Queens,40088002009,0,0,0,2.64
2020,CB2020,081,4,Queens,40088002010,28,17,11,1.28
2020,CB2020,081,4,Queens,40088002011,61,25,36,2.03
2020,CB2020,081,4,Queens,40088002012,51,24,27,4.32
2020,CB2020,081,4,Queens,40088002013,173,91,82,3.01
2020,CB2020,081,4,Queens,40088002014,7,3,4,0.41
2020,CB2020,081,4,Queens,40088002015,0,0,0,0.29
2020,CB2020,081,4,Queens,40091001000,697,331,366,3.23
2020,CB2020,081,4,Queens,40091001001,18,11,7,15.35
2020,CB2020,081,4,Queens,40091001002,20,13,7,3.34
2020,CB2020,081,4,Queens,40091001003,492,229,263,5.88
2020,CB2020,081,4,Queens,40091002000,324,172,152,3.22
2020,CB2020,081,4,Queens,40091002001,301,165,136,3.71
2020,CB2020,081,4,Queens,40091002002,311,164,147,3.06
2020,CB2020,081,4,Queens,40091002003,286,143,143,4.18
2020,CB2020,081,4,Queens,40091002004,284,145,139,4.07
2020,CB2020,081,4,Queens,40094001000,304,128,176,4.95
2020,CB2020,081,4,Queens,40094001001,372,194,178,4.01
2020,CB2020,081,4,Queens,40094001002,506,266,240,5.46
2020,CB2020,081,4,Queens,40094001003,265,123,142,4.27
2020,CB2020,081,4,Queens,40094001004,154,48,106,3.47
2020,CB2020,081,4,Queens,40094001005,0,0,0,1.64
2020,CB2020,081,4,Queens,40094001006,0,0,0,0.3
2020,CB2020,081,4,Queens,40094002000,359,186,173,5.02
2020,CB2020,081,4,Queens,40094002001,107,42,65,1.31
2020,CB2020,081,4,Queens,40094002002,306,158,148,5.16
2020,CB2020,081,4,Queens,40094002003,295,149,146,3.34
2020,CB2020,081,4,Queens,40094002004,251,125,126,3.68
2020,CB2020,081,4,Queens,40095001000,446,202,244,4.44
2020,CB2020,081,4,Queens,40095001001,574,299,275,4.42
2020,CB2020,081,4,Queens,40095001002,0,0,0,0.44
2020,CB2020,081,4,Queens,40095001003,0,0,0,0.28
2020,CB2020,081,4,Queens,40095001004,0,0,0,0.47
2020,CB2020,081,4,Queens,40095002000,148,65,83,2.63
2020,CB2020,081,4,Queens,40095002001,154,69,85,2.31
2020,CB2020,081,4,Queens,40095002002,306,161,145,4.38
2020,CB2020,081,4,Queens,40095002003,128,73,55,2.14
2020,CB2020,081,4,Queens,40095002004,76,35,41,2.6
2020,CB2020,081,4,Queens,40095002005,17,4,13,1.39
2020,CB2020,081,4,Queens,40095002006,0,0,0,0.68
2020,CB2020,081,4,Queens,40095002007,0,0,0,0.49
2020,CB2020,081,4,Queens,40095002008,0,0,0,1.49
2020,CB2020,081,4,Queens,40095002009,0,0,0,0.53
2020,CB2020,081,4,Queens,40095002010,0,0,0,0.31
2020,CB2020,081,4,Queens,40095002011,0,0,0,0.39
2020,CB2020,081,4,Queens,40095002012,0,0,0,0.44
2020,CB2020,081,4,Queens,40095002013,327,160,167,4.44
2020,CB2020,081,4,Queens,40095002014,334,147,187,4.42
2020,CB2020,081,4,Queens,40095002015,0,0,0,0.44
2020,CB2020,081,4,Queens,40095002016,0,0,0,0.29
2020,CB2020,081,4,Queens,40095002017,0,0,0,0.29
2020,CB2020,081,4,Queens,40095002018,0,0,0,0.47
2020,CB2020,081,4,Queens,40095002019,0,0,0,0.47
2020,CB2020,081,4,Queens,40096001000,290,158,132,4.99
2020,CB2020,081,4,Queens,40096001001,379,168,211,4.81
2020,CB2020,081,4,Queens,40096001002,320,153,167,4.96
2020,CB2020,081,4,Queens,40096001003,280,149,131,4.97
2020,CB2020,081,4,Queens,40096001004,232,100,132,4.92
2020,CB2020,081,4,Queens,40096001005,62,43,19,3.82
2020,CB2020,081,4,Queens,40096002000,191,96,95,2.73
2020,CB2020,081,4,Queens,40096002001,87,29,58,1.76
2020,CB2020,081,4,Queens,40096002002,175,96,79,2.93
2020,CB2020,081,4,Queens,40096002003,314,135,179,4.95
2020,CB2020,081,4,Queens,40096002004,382,180,202,4.08
2020,CB2020,081,4,Queens,40096002005,146,82,64,2.03
2020,CB2020,081,4,Queens,40096002006,125,67,58,1.4
2020,CB2020,081,4,Queens,40096002007,99,63,36,1.22
2020,CB2020,081,4,Queens,40096002008,45,20,25,1.46
2020,CB2020,081,4,Queens,40097001000,218,84,134,2.64
2020,CB2020,081,4,Queens,40097001001,163,66,97,2.33
2020,CB2020,081,4,Queens,40097001002,126,70,56,2.18
2020,CB2020,081,4,Queens,40097001003,158,83,75,2.46
2020,CB2020,081,4,Queens,40097002000,440,238,202,6.21
2020,CB2020,081,4,Queens,40097002001,167,69,98,2.12
2020,CB2020,081,4,Queens,40097002002,174,66,108,2.43
2020,CB2020,081,4,Queens,40097002003,375,198,177,2.63
2020,CB2020,081,4,Queens,40097002004,72,34,38,1.28
2020,CB2020,081,4,Queens,40097002005,66,37,29,1.07
2020,CB2020,081,4,Queens,40097003000,390,198,192,6.08
2020,CB2020,081,4,Queens,40097003001,337,158,179,5.35
2020,CB2020,081,4,Queens,40097003002,139,57,82,0.79
2020,CB2020,081,4,Queens,40097004000,380,182,198,5.42
2020,CB2020,081,4,Queens,40097004001,508,266,242,6.13
2020,CB2020,081,4,Queens,40097004002,147,68,79,0.76
2020,CB2020,081,4,Queens,40098001000,302,155,147,3.24
2020,CB2020,081,4,Queens,40098001001,254,122,132,2.9
2020,CB2020,081,4,Queens,40098001002,257,119,138,2.58
2020,CB2020,081,4,Queens,40098001003,204,108,96,2.53
2020,CB2020,081,4,Queens,40098001004,142,60,82,2.65
2020,CB2020,081,4,Queens,40098001005,186,91,95,2.84
2020,CB2020,081,4,Queens,40098002000,263,142,121,2.94
2020,CB2020,081,4,Queens,40098002001,187,96,91,3.17
2020,CB2020,081,4,Queens,40098002002,263,114,149,3.29
2020,CB2020,081,4,Queens,40098002003,167,88,79,2.54
2020,CB2020,081,4,Queens,40098002004,79,40,39,0.98
2020,CB2020,081,4,Queens,40098002005,327,174,153,3.89
2020,CB2020,081,4,Queens,40099001000,0,0,0,0.72
2020,CB2020,081,4,Queens,40099001001,0,0,0,7.01
2020,CB2020,081,4,Queens,40099001002,0,0,0,31.42
2020,CB2020,081,4,Queens,40099001003,0,0,0,3.56
2020,CB2020,081,4,Queens,40099001004,0,0,0,1.56
2020,CB2020,081,4,Queens,40099001005,0,0,0,1.73
2020,CB2020,081,4,Queens,40099001006,0,0,0,15.59
2020,CB2020,081,4,Queens,40100001000,318,150,168,3.99
2020,CB2020,081,4,Queens,40100001001,264,125,139,4.27
2020,CB2020,081,4,Queens,40100001002,183,78,105,4.7
2020,CB2020,081,4,Queens,40100001003,109,68,41,2.24
2020,CB2020,081,4,Queens,40100001004,194,86,108,3.18
2020,CB2020,081,4,Queens,40100001005,408,171,237,3.94
2020,CB2020,081,4,Queens,40100002000,292,145,147,5.5
2020,CB2020,081,4,Queens,40100002001,311,143,168,5.49
2020,CB2020,081,4,Queens,40100002002,261,139,122,6.08
2020,CB2020,081,4,Queens,40100002003,349,180,169,5.74
2020,CB2020,081,4,Queens,40100002004,412,194,218,5.17
2020,CB2020,081,4,Queens,40100002005,282,136,146,4.91
2020,CB2020,081,4,Queens,40101001000,278,163,115,2.6
2020,CB2020,081,4,Queens,40101001001,152,95,57,2.3
2020,CB2020,081,4,Queens,40101001002,142,76,66,3.15
2020,CB2020,081,4,Queens,40101001003,205,95,110,2.95
2020,CB2020,081,4,Queens,40101001004,138,56,82,2.59
2020,CB2020,081,4,Queens,40101001005,173,81,92,2.78
2020,CB2020,081,4,Queens,40101001006,180,73,107,2.9
2020,CB2020,081,4,Queens,40101001007,119,57,62,2.4
2020,CB2020,081,4,Queens,40101002000,180,81,99,2.95
2020,CB2020,081,4,Queens,40101002001,142,72,70,3.09
2020,CB2020,081,4,Queens,40101002002,203,101,102,3.22
2020,CB2020,081,4,Queens,40101002003,214,108,106,3.32
2020,CB2020,081,4,Queens,40101002004,128,62,66,1.94
2020,CB2020,081,4,Queens,40101002005,178,96,82,2.03
2020,CB2020,081,4,Queens,40101002006,103,69,34,2.17
2020,CB2020,081,4,Queens,40101002007,119,59,60,2.3
2020,CB2020,081,4,Queens,40102001000,313,175,138,3.98
2020,CB2020,081,4,Queens,40102001001,223,92,131,3.93
2020,CB2020,081,4,Queens,40102001002,223,118,105,3.48
2020,CB2020,081,4,Queens,40102001003,133,59,74,2.59
2020,CB2020,081,4,Queens,40102001004,89,51,38,1.67
2020,CB2020,081,4,Queens,40102001005,45,26,19,3.73
2020,CB2020,081,4,Queens,40102001006,249,109,140,3.8
2020,CB2020,081,4,Queens,40102001007,0,0,0,0.86
2020,CB2020,081,4,Queens,40102001008,32,9,23,1.49
2020,CB2020,081,4,Queens,40102001009,0,0,0,0.44
2020,CB2020,081,4,Queens,40102002000,267,141,126,3.82
2020,CB2020,081,4,Queens,40102002001,251,134,117,3.81
2020,CB2020,081,4,Queens,40102002002,233,118,115,3.82
2020,CB2020,081,4,Queens,40102002003,245,118,127,3.82
2020,CB2020,081,4,Queens,40102002004,218,120,98,3.81
2020,CB2020,081,4,Queens,40102002005,187,95,92,3.82
2020,CB2020,081,4,Queens,40102002006,158,48,110,3.98
2020,CB2020,081,4,Queens,40103001000,0,0,0,2.83
2020,CB2020,081,4,Queens,40103001001,0,0,0,1.91
2020,CB2020,081,4,Queens,40103001002,482,217,265,4.42
2020,CB2020,081,4,Queens,40103001003,220,95,125,4.43
2020,CB2020,081,4,Queens,40103001004,399,204,195,4.21
2020,CB2020,081,4,Queens,40103002000,261,131,130,3.46
2020,CB2020,081,4,Queens,40103002001,188,110,78,2.85
2020,CB2020,081,4,Queens,40103002002,93,47,46,4.32
2020,CB2020,081,4,Queens,40103002003,206,112,94,3.63
2020,CB2020,081,4,Queens,40103002004,240,116,124,2.66
2020,CB2020,081,4,Queens,40103003000,577,287,290,5.43
2020,CB2020,081,4,Queens,40103003001,638,326,312,5.42
2020,CB2020,081,4,Queens,40103004000,81,51,30,10.86
2020,CB2020,081,4,Queens,40103004001,765,370,395,5.46
2020,CB2020,081,4,Queens,40104001000,477,237,240,4.63
2020,CB2020,081,4,Queens,40104001001,461,239,222,4.89
2020,CB2020,081,4,Queens,40104001002,436,199,237,5.13
2020,CB2020,081,4,Queens,40104001003,311,145,166,5.36
2020,CB2020,081,4,Queens,40104002000,299,164,135,4.67
2020,CB2020,081,4,Queens,40104002001,313,143,170,4.67
2020,CB2020,081,4,Queens,40104002002,258,121,137,4.58
2020,CB2020,081,4,Queens,40104002003,274,137,137,4.63
2020,CB2020,081,4,Queens,40104002004,244,105,139,3.78
2020,CB2020,081,4,Queens,40104002005,242,123,119,3.74
2020,CB2020,081,4,Queens,40105001000,305,116,189,3.41
2020,CB2020,081,4,Queens,40105001001,714,379,335,6.3
2020,CB2020,081,4,Queens,40105002000,480,213,267,5.06
2020,CB2020,081,4,Queens,40105002001,529,251,278,5.49
2020,CB2020,081,4,Queens,40105003000,498,249,249,7.67
2020,CB2020,081,4,Queens,40105003001,520,289,231,5.27
2020,CB2020,081,4,Queens,40105003002,678,347,331,5.25
2020,CB2020,081,4,Queens,40105004000,520,265,255,5.24
2020,CB2020,081,4,Queens,40105004001,397,194,203,5.24
2020,CB2020,081,4,Queens,40106001000,292,161,131,4.55
2020,CB2020,081,4,Queens,40106001001,342,195,147,4.39
2020,CB2020,081,4,Queens,40106001002,384,184,200,4.38
2020,CB2020,081,4,Queens,40106001003,239,110,129,3.89
2020,CB2020,081,4,Queens,40106001004,191,87,104,3.5
2020,CB2020,081,4,Queens,40106002000,389,194,195,4.22
2020,CB2020,081,4,Queens,40106002001,427,248,179,4.27
2020,CB2020,081,4,Queens,40106002002,335,159,176,4.69
2020,CB2020,081,4,Queens,40106002003,445,200,245,4.88
2020,CB2020,081,4,Queens,40106002004,373,158,215,3.98
2020,CB2020,081,4,Queens,40107010001,0,0,0,0
2020,CB2020,081,4,Queens,40107010002,0,0,0,0
2020,CB2020,081,4,Queens,40107011000,5,4,1,319.56
2020,CB2020,081,4,Queens,40107011001,2,0,2,76
2020,CB2020,081,4,Queens,40108001000,367,181,186,5.31
2020,CB2020,081,4,Queens,40108001001,454,265,189,5.53
2020,CB2020,081,4,Queens,40108001002,498,277,221,5.83
2020,CB2020,081,4,Queens,40108002000,330,162,168,4.37
2020,CB2020,081,4,Queens,40108002001,344,152,192,4.36
2020,CB2020,081,4,Queens,40108002002,296,171,125,4.46
2020,CB2020,081,4,Queens,40108002003,356,185,171,4.51
2020,CB2020,081,4,Queens,40108002004,389,193,196,4.57
2020,CB2020,081,4,Queens,40110001000,527,244,283,6.81
2020,CB2020,081,4,Queens,40110001001,129,79,50,3.89
2020,CB2020,081,4,Queens,40110001002,202,97,105,2.42
2020,CB2020,081,4,Queens,40110001003,332,166,166,3.9
2020,CB2020,081,4,Queens,40110001004,138,64,74,1.51
2020,CB2020,081,4,Queens,40110002000,232,105,127,4.42
2020,CB2020,081,4,Queens,40110002001,379,183,196,4.46
2020,CB2020,081,4,Queens,40110002002,387,204,183,4.45
2020,CB2020,081,4,Queens,40110002003,270,134,136,2.48
2020,CB2020,081,4,Queens,40110002004,90,37,53,1.2
2020,CB2020,081,4,Queens,40110002005,67,25,42,0.78
2020,CB2020,081,4,Queens,40110002006,437,195,242,4.46
2020,CB2020,081,4,Queens,40111001000,386,175,211,5.26
2020,CB2020,081,4,Queens,40111001001,366,192,174,5.24
2020,CB2020,081,4,Queens,40111001002,794,376,418,7.57
2020,CB2020,081,4,Queens,40111002000,59,40,19,2.57
2020,CB2020,081,4,Queens,40111002001,400,183,217,3.18
2020,CB2020,081,4,Queens,40111002002,283,153,130,2.53
2020,CB2020,081,4,Queens,40111002003,207,108,99,3.02
2020,CB2020,081,4,Queens,40111002004,119,48,71,2.4
2020,CB2020,081,4,Queens,40111002005,112,47,65,2.9
2020,CB2020,081,4,Queens,40111002006,176,79,97,2.59
2020,CB2020,081,4,Queens,40112001000,314,178,136,6.47
2020,CB2020,081,4,Queens,40112001001,198,82,116,4.77
2020,CB2020,081,4,Queens,40112001002,287,163,124,4.56
2020,CB2020,081,4,Queens,40112001003,305,145,160,4.47
2020,CB2020,081,4,Queens,40112002000,275,146,129,4.46
2020,CB2020,081,4,Queens,40112002001,45,24,21,2.99
2020,CB2020,081,4,Queens,40112002002,107,54,53,3.53
2020,CB2020,081,4,Queens,40112002003,191,97,94,5.1
2020,CB2020,081,4,Queens,40112002004,488,251,237,5.2
2020,CB2020,081,4,Queens,40112002005,287,149,138,5.2
2020,CB2020,081,4,Queens,40113001000,460,213,247,5.43
2020,CB2020,081,4,Queens,40113001001,1013,489,524,7.85
2020,CB2020,081,4,Queens,40113002000,394,198,196,8.54
2020,CB2020,081,4,Queens,40113002001,1272,606,666,5.61
2020,CB2020,081,4,Queens,40113003000,419,224,195,5.66
2020,CB2020,081,4,Queens,40113003001,354,185,169,5.54
2020,CB2020,081,4,Queens,40113003002,368,159,209,5.53
2020,CB2020,081,4,Queens,40114001000,21,12,9,2.58
2020,CB2020,081,4,Queens,40114001001,34,25,9,2.11
2020,CB2020,081,4,Queens,40114001002,0,0,0,2.27
2020,CB2020,081,4,Queens,40114001003,50,23,27,2.79
2020,CB2020,081,4,Queens,40114001004,211,99,112,2.65
2020,CB2020,081,4,Queens,40114001005,285,147,138,2.69
2020,CB2020,081,4,Queens,40114001006,79,45,34,1.72
2020,CB2020,081,4,Queens,40114001007,178,90,88,2.63
2020,CB2020,081,4,Queens,40114001008,256,117,139,3.75
2020,CB2020,081,4,Queens,40114001009,306,152,154,3.75
2020,CB2020,081,4,Queens,40114001010,119,58,61,2.5
2020,CB2020,081,4,Queens,40115001000,703,348,355,6.17
2020,CB2020,081,4,Queens,40115001001,233,102,131,3.91
2020,CB2020,081,4,Queens,40115001002,69,42,27,1.17
2020,CB2020,081,4,Queens,40115001003,117,60,57,3.81
2020,CB2020,081,4,Queens,40115001004,179,82,97,2.97
2020,CB2020,081,4,Queens,40115001005,63,28,35,2.32
2020,CB2020,081,4,Queens,40115001006,195,95,100,1.92
2020,CB2020,081,4,Queens,40115001007,231,105,126,2.45
2020,CB2020,081,4,Queens,40115002000,183,116,67,3.44
2020,CB2020,081,4,Queens,40115002001,134,61,73,5.44
2020,CB2020,081,4,Queens,40115002002,103,63,40,6.77
2020,CB2020,081,4,Queens,40115002003,46,28,18,1.51
2020,CB2020,081,4,Queens,40115002004,62,18,44,2.16
2020,CB2020,081,4,Queens,40115002005,96,36,60,1.8
2020,CB2020,081,4,Queens,40116001000,98,41,57,2.16
2020,CB2020,081,4,Queens,40116001001,63,41,22,0.6
2020,CB2020,081,4,Queens,40116001002,130,50,80,2.76
2020,CB2020,081,4,Queens,40116001003,69,31,38,2.67
2020,CB2020,081,4,Queens,40116001004,180,80,100,2.92
2020,CB2020,081,4,Queens,40116001005,114,57,57,2.14
2020,CB2020,081,4,Queens,40116001006,65,27,38,0.59
2020,CB2020,081,4,Queens,40116001007,227,132,95,2.72
2020,CB2020,081,4,Queens,40116002000,159,67,92,2.74
2020,CB2020,081,4,Queens,40116002001,216,91,125,2.82
2020,CB2020,081,4,Queens,40116002002,363,201,162,3.99
2020,CB2020,081,4,Queens,40116002003,304,135,169,3.91
2020,CB2020,081,4,Queens,40116002004,382,210,172,3.82
2020,CB2020,081,4,Queens,40117001000,389,183,206,5.45
2020,CB2020,081,4,Queens,40117001001,456,237,219,5.48
2020,CB2020,081,4,Queens,40117002000,350,161,189,5.37
2020,CB2020,081,4,Queens,40117002001,489,227,262,5.34
2020,CB2020,081,4,Queens,40117003000,360,180,180,6.3
2020,CB2020,081,4,Queens,40117003001,96,33,63,1.64
2020,CB2020,081,4,Queens,40117003002,394,213,181,4.56
2020,CB2020,081,4,Queens,40117003003,211,93,118,3.35
2020,CB2020,081,4,Queens,40117003004,155,75,80,2.37
2020,CB2020,081,4,Queens,40117004000,489,226,263,6.39
2020,CB2020,081,4,Queens,40117004001,451,221,230,6.33
2020,CB2020,081,4,Queens,40118001000,258,152,106,3.57
2020,CB2020,081,4,Queens,40118001001,282,155,127,3.31
2020,CB2020,081,4,Queens,40118001002,220,98,122,3.49
2020,CB2020,081,4,Queens,40118001003,199,92,107,3.78
2020,CB2020,081,4,Queens,40118001004,523,287,236,6.14
2020,CB2020,081,4,Queens,40118002000,255,130,125,3.8
2020,CB2020,081,4,Queens,40118002001,184,91,93,2.78
2020,CB2020,081,4,Queens,40118002002,114,51,63,2.76
2020,CB2020,081,4,Queens,40118002003,211,110,101,2.74
2020,CB2020,081,4,Queens,40118002004,444,250,194,6.45
2020,CB2020,081,4,Queens,40119001000,338,170,168,5.55
2020,CB2020,081,4,Queens,40119001001,402,208,194,5.53
2020,CB2020,081,4,Queens,40119002000,442,214,228,5.46
2020,CB2020,081,4,Queens,40119002001,437,215,222,5.47
2020,CB2020,081,4,Queens,40119002002,110,66,44,5.54
2020,CB2020,081,4,Queens,40120001000,236,130,106,3.69
2020,CB2020,081,4,Queens,40120001001,184,90,94,3.55
2020,CB2020,081,4,Queens,40120001002,284,143,141,3.54
2020,CB2020,081,4,Queens,40120001003,229,137,92,3.5
2020,CB2020,081,4,Queens,40120002000,256,152,104,2.73
2020,CB2020,081,4,Queens,40120002001,129,79,50,2.63
2020,CB2020,081,4,Queens,40120002002,363,223,140,5.3
2020,CB2020,081,4,Queens,40120002003,383,196,187,5.28
2020,CB2020,081,4,Queens,40120002004,150,75,75,2.8
2020,CB2020,081,4,Queens,40120002005,171,77,94,2.68
2020,CB2020,081,4,Queens,40121001000,363,187,176,5.64
2020,CB2020,081,4,Queens,40121001001,361,196,165,5.64
2020,CB2020,081,4,Queens,40121001002,322,147,175,5.64
2020,CB2020,081,4,Queens,40121001003,237,114,123,5.65
2020,CB2020,081,4,Queens,40121002000,489,229,260,5.75
2020,CB2020,081,4,Queens,40121002001,405,196,209,5.75
2020,CB2020,081,4,Queens,40122001000,288,127,161,6.21
2020,CB2020,081,4,Queens,40122001001,301,183,118,5.91
2020,CB2020,081,4,Queens,40122001002,135,58,77,3.21
2020,CB2020,081,4,Queens,40122001003,131,62,69,3.35
2020,CB2020,081,4,Queens,40122001004,243,120,123,3.87
2020,CB2020,081,4,Queens,40122001005,204,106,98,3.73
2020,CB2020,081,4,Queens,40122001006,0,0,0,0.35
2020,CB2020,081,4,Queens,40122001007,26,13,13,0.37
2020,CB2020,081,4,Queens,40122002000,273,148,125,5.41
2020,CB2020,081,4,Queens,40122002001,282,151,131,5.26
2020,CB2020,081,4,Queens,40122002002,184,97,87,3.16
2020,CB2020,081,4,Queens,40122002003,222,107,115,3.14
2020,CB2020,081,4,Queens,40122002004,257,106,151,3.67
2020,CB2020,081,4,Queens,40122002005,256,141,115,3.64
2020,CB2020,081,4,Queens,40122002006,0,0,0,0.32
2020,CB2020,081,4,Queens,40122002007,0,0,0,0.33
2020,CB2020,081,4,Queens,40123011000,27,11,16,6.01
2020,CB2020,081,4,Queens,40123011001,16,8,8,6.04
2020,CB2020,081,4,Queens,40123011002,24,6,18,5.73
2020,CB2020,081,4,Queens,40123011003,158,84,74,5.68
2020,CB2020,081,4,Queens,40123011004,0,0,0,5.54
2020,CB2020,081,4,Queens,40123011005,141,57,84,3.4
2020,CB2020,081,4,Queens,40123011006,200,107,93,3.18
2020,CB2020,081,4,Queens,40123011007,183,68,115,2.17
2020,CB2020,081,4,Queens,40123011008,0,0,0,1.97
2020,CB2020,081,4,Queens,40123011009,199,85,114,1.99
2020,CB2020,081,4,Queens,40123011010,191,102,89,3.56
2020,CB2020,081,4,Queens,40123011011,213,113,100,3.58
2020,CB2020,081,4,Queens,40123011012,116,73,43,1.98
2020,CB2020,081,4,Queens,40123012000,21,6,15,5.9
2020,CB2020,081,4,Queens,40123012001,0,0,0,5.83
2020,CB2020,081,4,Queens,40123012002,0,0,0,5.89
2020,CB2020,081,4,Queens,40123012003,0,0,0,5.63
2020,CB2020,081,4,Queens,40123012004,0,0,0,5.57
2020,CB2020,081,4,Queens,40123012005,56,19,37,5.64
2020,CB2020,081,4,Queens,40123012006,212,117,95,3.43
2020,CB2020,081,4,Queens,40123012007,178,62,116,3.22
2020,CB2020,081,4,Queens,40123012008,143,65,78,2.96
2020,CB2020,081,4,Queens,40123012009,123,72,51,2.49
2020,CB2020,081,4,Queens,40123012010,78,48,30,2.23
2020,CB2020,081,4,Queens,40123012011,94,62,32,2.02
2020,CB2020,081,4,Queens,40123013000,0,0,0,5.66
2020,CB2020,081,4,Queens,40123013001,0,0,0,5.61
2020,CB2020,081,4,Queens,40123013002,0,0,0,5.56
2020,CB2020,081,4,Queens,40123013003,0,0,0,5.64
2020,CB2020,081,4,Queens,40123013004,44,34,10,5.68
2020,CB2020,081,4,Queens,40123013005,407,196,211,5.46
2020,CB2020,081,4,Queens,40123013006,119,46,73,2.7
2020,CB2020,081,4,Queens,40123013007,158,87,71,2.76
2020,CB2020,081,4,Queens,40123013008,171,88,83,5.43
2020,CB2020,081,4,Queens,40124001000,467,219,248,5.08
2020,CB2020,081,4,Queens,40124001001,267,113,154,4.76
2020,CB2020,081,4,Queens,40124001002,148,96,52,5.82
2020,CB2020,081,4,Queens,40124001003,163,61,102,3.35
2020,CB2020,081,4,Queens,40124001004,205,105,100,3.84
2020,CB2020,081,4,Queens,40124001005,0,0,0,0.33
2020,CB2020,081,4,Queens,40124002000,556,276,280,6.29
2020,CB2020,081,4,Queens,40124002001,285,143,142,6.31
2020,CB2020,081,4,Queens,40124002002,357,174,183,5.51
2020,CB2020,081,4,Queens,40124002003,194,102,92,3.45
2020,CB2020,081,4,Queens,40124002004,231,127,104,3.03
2020,CB2020,081,4,Queens,40124002005,0,0,0,0.7
2020,CB2020,081,4,Queens,40124002006,0,0,0,0.38
2020,CB2020,081,4,Queens,40125001000,192,101,91,2.92
2020,CB2020,081,4,Queens,40125001001,227,101,126,2.85
2020,CB2020,081,4,Queens,40125001002,112,58,54,1.94
2020,CB2020,081,4,Queens,40125001003,98,48,50,1.83
2020,CB2020,081,4,Queens,40125001004,0,0,0,1.32
2020,CB2020,081,4,Queens,40125001005,0,0,0,0.47
2020,CB2020,081,4,Queens,40125001006,51,34,17,0.94
2020,CB2020,081,4,Queens,40125001007,0,0,0,1.28
2020,CB2020,081,4,Queens,40125001008,101,51,50,2.04
2020,CB2020,081,4,Queens,40125001009,118,67,51,1.21
2020,CB2020,081,4,Queens,40125001010,0,0,0,0.31
2020,CB2020,081,4,Queens,40125001011,0,0,0,1.25
2020,CB2020,081,4,Queens,40125001012,0,0,0,0.94
2020,CB2020,081,4,Queens,40125001013,0,0,0,0.79
2020,CB2020,081,4,Queens,40125001014,0,0,0,0.51
2020,CB2020,081,4,Queens,40125001015,0,0,0,0.28
2020,CB2020,081,4,Queens,40125001016,0,0,0,0.51
2020,CB2020,081,4,Queens,40125001017,0,0,0,0.71
2020,CB2020,081,4,Queens,40125001018,0,0,0,0.88
2020,CB2020,081,4,Queens,40125001019,0,0,0,0.45
2020,CB2020,081,4,Queens,40125001020,0,0,0,0.79
2020,CB2020,081,4,Queens,40125001021,0,0,0,1.07
2020,CB2020,081,4,Queens,40125002000,552,262,290,4.45
2020,CB2020,081,4,Queens,40125002001,264,134,130,6.48
2020,CB2020,081,4,Queens,40125002002,20,11,9,1.6
2020,CB2020,081,4,Queens,40125002003,0,0,0,0.8
2020,CB2020,081,4,Queens,40125002004,0,0,0,1.63
2020,CB2020,081,4,Queens,40126011000,405,189,216,5.89
2020,CB2020,081,4,Queens,40126011001,688,353,335,9.91
2020,CB2020,081,4,Queens,40126011002,386,205,181,5.51
2020,CB2020,081,4,Queens,40126011003,0,0,0,0.39
2020,CB2020,081,4,Queens,40126011004,0,0,0,0.37
2020,CB2020,081,4,Queens,40126012000,500,265,235,5.86
2020,CB2020,081,4,Queens,40126012001,251,136,115,3.72
2020,CB2020,081,4,Queens,40126012002,366,160,206,4.64
2020,CB2020,081,4,Queens,40126012003,0,0,0,0.47
2020,CB2020,081,4,Queens,40126012004,0,0,0,0.37
2020,CB2020,081,4,Queens,40126021000,418,208,210,6.23
2020,CB2020,081,4,Queens,40126021001,413,173,240,4.52
2020,CB2020,081,4,Queens,40126021002,412,211,201,4.46
2020,CB2020,081,4,Queens,40126022000,374,197,177,4.39
2020,CB2020,081,4,Queens,40126022001,264,130,134,4.31
2020,CB2020,081,4,Queens,40126022002,289,146,143,4.24
2020,CB2020,081,4,Queens,40126022003,175,108,67,2.67
2020,CB2020,081,4,Queens,40126022004,223,94,129,3.56
2020,CB2020,081,4,Queens,40126022005,147,65,82,1.47
2020,CB2020,081,4,Queens,40126022006,0,0,0,0.97
2020,CB2020,081,4,Queens,40128001000,73,41,32,2.19
2020,CB2020,081,4,Queens,40128001001,357,158,199,3.01
2020,CB2020,081,4,Queens,40128001002,154,67,87,2.74
2020,CB2020,081,4,Queens,40128001003,182,94,88,3.74
2020,CB2020,081,4,Queens,40128001004,215,105,110,3.91
2020,CB2020,081,4,Queens,40128001005,171,71,100,3.82
2020,CB2020,081,4,Queens,40128002000,220,99,121,4.44
2020,CB2020,081,4,Queens,40128002001,229,116,113,4.89
2020,CB2020,081,4,Queens,40128002002,326,131,195,5.38
2020,CB2020,081,4,Queens,40128002003,285,161,124,5.22
2020,CB2020,081,4,Queens,40130001000,37,23,14,2.44
2020,CB2020,081,4,Queens,40130001001,47,25,22,2.35
2020,CB2020,081,4,Queens,40130001002,270,136,134,4.85
2020,CB2020,081,4,Queens,40130001003,105,46,59,2.6
2020,CB2020,081,4,Queens,40130001004,86,52,34,2.59
2020,CB2020,081,4,Queens,40130001005,85,30,55,1.6
2020,CB2020,081,4,Queens,40130001006,67,30,37,2.45
2020,CB2020,081,4,Queens,40130001007,16,11,5,0.8
2020,CB2020,081,4,Queens,40130002000,109,69,40,2.78
2020,CB2020,081,4,Queens,40130002001,129,78,51,3.66
2020,CB2020,081,4,Queens,40130002002,156,62,94,4.55
2020,CB2020,081,4,Queens,40130002003,145,88,57,5.46
2020,CB2020,081,4,Queens,40130002004,197,88,109,3.97
2020,CB2020,081,4,Queens,40130002005,308,148,160,6.29
2020,CB2020,081,4,Queens,40132001000,87,32,55,3.59
2020,CB2020,081,4,Queens,40132001001,123,63,60,3.86
2020,CB2020,081,4,Queens,40132001002,53,21,32,1.63
2020,CB2020,081,4,Queens,40132001003,0,0,0,0.54
2020,CB2020,081,4,Queens,40132001004,0,0,0,0.58
2020,CB2020,081,4,Queens,40132001005,0,0,0,0.25
2020,CB2020,081,4,Queens,40132001006,61,32,29,1.8
2020,CB2020,081,4,Queens,40132001007,72,43,29,1.8
2020,CB2020,081,4,Queens,40132001008,245,124,121,3.47
2020,CB2020,081,4,Queens,40132001009,162,94,68,1.66
2020,CB2020,081,4,Queens,40132001010,11,3,8,1.55
2020,CB2020,081,4,Queens,40132001011,0,0,0,0.46
2020,CB2020,081,4,Queens,40132002000,0,0,0,1.38
2020,CB2020,081,4,Queens,40132002001,0,0,0,0.77
2020,CB2020,081,4,Queens,40132002002,0,0,0,0.53
2020,CB2020,081,4,Queens,40132002003,65,31,34,2.71
2020,CB2020,081,4,Queens,40132002004,40,25,15,0.96
2020,CB2020,081,4,Queens,40132002005,122,62,60,3.36
2020,CB2020,081,4,Queens,40132002006,159,75,84,3.27
2020,CB2020,081,4,Queens,40132002007,157,74,83,2.83
2020,CB2020,081,4,Queens,40132002008,405,177,228,5.16
2020,CB2020,081,4,Queens,40132002009,49,26,23,1.9
2020,CB2020,081,4,Queens,40132002010,72,35,37,2.52
2020,CB2020,081,4,Queens,40132002011,36,18,18,0.95
2020,CB2020,081,4,Queens,40134001000,1110,514,596,6.13
2020,CB2020,081,4,Queens,40134001001,1214,564,650,5.35
2020,CB2020,081,4,Queens,40134002000,391,213,178,2.04
2020,CB2020,081,4,Queens,40134002001,384,175,209,2.36
2020,CB2020,081,4,Queens,40134002002,60,28,32,1.01
2020,CB2020,081,4,Queens,40134002003,224,119,105,2.95
2020,CB2020,081,4,Queens,40134002004,41,23,18,3.76
2020,CB2020,081,4,Queens,40134002005,81,32,49,3.12
2020,CB2020,081,4,Queens,40134002006,282,107,175,4.63
2020,CB2020,081,4,Queens,40134003000,348,179,169,1.19
2020,CB2020,081,4,Queens,40134003001,480,206,274,2.22
2020,CB2020,081,4,Queens,40134003002,302,192,110,2.2
2020,CB2020,081,4,Queens,40134003003,463,199,264,2.95
2020,CB2020,081,4,Queens,40134004000,382,188,194,3.61
2020,CB2020,081,4,Queens,40134004001,82,34,48,2.15
2020,CB2020,081,4,Queens,40134004002,60,42,18,1.47
2020,CB2020,081,4,Queens,40135001000,269,138,131,5.46
2020,CB2020,081,4,Queens,40135001001,127,40,87,2.07
2020,CB2020,081,4,Queens,40135001002,155,65,90,3.41
2020,CB2020,081,4,Queens,40135001003,191,87,104,5.68
2020,CB2020,081,4,Queens,40135001004,240,130,110,5.65
2020,CB2020,081,4,Queens,40135001005,233,110,123,5.64
2020,CB2020,081,4,Queens,40135001006,311,152,159,5.64
2020,CB2020,081,4,Queens,40136001000,686,323,363,9.47
2020,CB2020,081,4,Queens,40136001001,233,125,108,8.26
2020,CB2020,081,4,Queens,40136001002,139,53,86,4.08
2020,CB2020,081,4,Queens,40136001003,85,34,51,3.1
2020,CB2020,081,4,Queens,40136002000,292,156,136,3.45
2020,CB2020,081,4,Queens,40136002001,132,52,80,4.1
2020,CB2020,081,4,Queens,40136002002,427,215,212,4.95
2020,CB2020,081,4,Queens,40137001000,370,184,186,5.49
2020,CB2020,081,4,Queens,40137001001,177,72,105,5.26
2020,CB2020,081,4,Queens,40137001002,254,129,125,4.73
2020,CB2020,081,4,Queens,40137001003,193,112,81,3.77
2020,CB2020,081,4,Queens,40137001004,81,38,43,2.76
2020,CB2020,081,4,Queens,40137001005,0,0,0,0.39
2020,CB2020,081,4,Queens,40137001006,0,0,0,0.71
2020,CB2020,081,4,Queens,40137001007,16,13,3,1.41
2020,CB2020,081,4,Queens,40137001008,0,0,0,1.87
2020,CB2020,081,4,Queens,40137001009,41,20,21,1.93
2020,CB2020,081,4,Queens,40137001010,241,142,99,2.76
2020,CB2020,081,4,Queens,40137001011,106,43,63,1.67
2020,CB2020,081,4,Queens,40137001012,0,0,0,0.88
2020,CB2020,081,4,Queens,40137001013,0,0,0,0.73
2020,CB2020,081,4,Queens,40137001014,0,0,0,0.76
2020,CB2020,081,4,Queens,40137001015,0,0,0,1.64
2020,CB2020,081,4,Queens,40137001016,0,0,0,2.2
2020,CB2020,081,4,Queens,40137001017,0,0,0,1.35
2020,CB2020,081,4,Queens,40137001018,0,0,0,0.47
2020,CB2020,081,4,Queens,40137001019,0,0,0,1.24
2020,CB2020,081,4,Queens,40137001020,0,0,0,0.39
2020,CB2020,081,4,Queens,40137001021,0,0,0,0.39
2020,CB2020,081,4,Queens,40137001022,79,54,25,1.26
2020,CB2020,081,4,Queens,40137001023,27,1,26,1.89
2020,CB2020,081,4,Queens,40137001024,85,32,53,1.68
2020,CB2020,081,4,Queens,40137001025,50,31,19,0.98
2020,CB2020,081,4,Queens,40137001026,16,10,6,0.32
2020,CB2020,081,4,Queens,40137001027,11,4,7,0.49
2020,CB2020,081,4,Queens,40138001000,274,136,138,2.58
2020,CB2020,081,4,Queens,40138001001,824,436,388,4.37
2020,CB2020,081,4,Queens,40138001002,249,117,132,2.15
2020,CB2020,081,4,Queens,40138001003,249,92,157,1.8
2020,CB2020,081,4,Queens,40138002000,209,87,122,3.81
2020,CB2020,081,4,Queens,40138002001,132,61,71,1.19
2020,CB2020,081,4,Queens,40138002002,0,0,0,0.29
2020,CB2020,081,4,Queens,40138002003,355,166,189,5.97
2020,CB2020,081,4,Queens,40138002004,613,306,307,7.25
2020,CB2020,081,4,Queens,40138002005,525,271,254,6.17
2020,CB2020,081,4,Queens,40138002006,318,165,153,4.11
2020,CB2020,081,4,Queens,40138002007,37,19,18,2.25
2020,CB2020,081,4,Queens,40140001000,0,0,0,0.38
2020,CB2020,081,4,Queens,40140001001,0,0,0,3.71
2020,CB2020,081,4,Queens,40140001002,201,111,90,2.37
2020,CB2020,081,4,Queens,40140001003,370,203,167,4.17
2020,CB2020,081,4,Queens,40140001004,172,92,80,2.33
2020,CB2020,081,4,Queens,40140001005,169,85,84,3.23
2020,CB2020,081,4,Queens,40140001006,124,65,59,2.23
2020,CB2020,081,4,Queens,40140001007,526,239,287,4.21
2020,CB2020,081,4,Queens,40140001008,351,153,198,3.23
2020,CB2020,081,4,Queens,40140001009,54,10,44,0.88
2020,CB2020,081,4,Queens,40140001010,100,49,51,0.85
2020,CB2020,081,4,Queens,40140002000,0,0,0,0.28
2020,CB2020,081,4,Queens,40140002001,132,58,74,2.75
2020,CB2020,081,4,Queens,40140002002,176,112,64,3.26
2020,CB2020,081,4,Queens,40140002003,226,124,102,3.98
2020,CB2020,081,4,Queens,40140002004,681,332,349,6.94
2020,CB2020,081,4,Queens,40140002005,130,66,64,2.24
2020,CB2020,081,4,Queens,40140002006,252,81,171,4.16
2020,CB2020,081,4,Queens,40140002007,288,145,143,3.67
2020,CB2020,081,4,Queens,40141001000,202,99,103,3.13
2020,CB2020,081,4,Queens,40141001001,420,206,214,2.55
2020,CB2020,081,4,Queens,40141002000,17,5,12,2.94
2020,CB2020,081,4,Queens,40141002001,0,0,0,0.72
2020,CB2020,081,4,Queens,40141002002,14,3,11,0.45
2020,CB2020,081,4,Queens,40141002003,0,0,0,0.52
2020,CB2020,081,4,Queens,40141002004,0,0,0,1.7
2020,CB2020,081,4,Queens,40141002005,0,0,0,3.78
2020,CB2020,081,4,Queens,40141002006,19,8,11,2.35
2020,CB2020,081,4,Queens,40141002007,259,153,106,4.25
2020,CB2020,081,4,Queens,40141002008,411,215,196,3.71
2020,CB2020,081,4,Queens,40141002009,59,27,32,4.31
2020,CB2020,081,4,Queens,40141002010,11,6,5,5.04
2020,CB2020,081,4,Queens,40141002011,85,33,52,1.34
2020,CB2020,081,4,Queens,40141002012,98,57,41,2.35
2020,CB2020,081,4,Queens,40141002013,50,34,16,3.13
2020,CB2020,081,4,Queens,40142011000,102,43,59,3.45
2020,CB2020,081,4,Queens,40142011001,497,189,308,4.53
2020,CB2020,081,4,Queens,40142011002,270,148,122,3.89
2020,CB2020,081,4,Queens,40142011003,385,215,170,3.98
2020,CB2020,081,4,Queens,40142011004,338,169,169,3.63
2020,CB2020,081,4,Queens,40142011005,385,188,197,3.76
2020,CB2020,081,4,Queens,40142012000,307,144,163,4.98
2020,CB2020,081,4,Queens,40142012001,724,368,356,6.66
2020,CB2020,081,4,Queens,40142012002,186,115,71,1.54
2020,CB2020,081,4,Queens,40142012003,588,270,318,5.13
2020,CB2020,081,4,Queens,40142012004,488,257,231,5.25
2020,CB2020,081,4,Queens,40142012005,432,216,216,5.32
2020,CB2020,081,4,Queens,40142021000,11,8,3,0.34
2020,CB2020,081,4,Queens,40142021001,49,22,27,4.23
2020,CB2020,081,4,Queens,40142021002,199,103,96,2.61
2020,CB2020,081,4,Queens,40142021003,77,48,29,3.51
2020,CB2020,081,4,Queens,40142021004,107,62,45,2.45
2020,CB2020,081,4,Queens,40142021005,896,457,439,20.45
2020,CB2020,081,4,Queens,40142021006,295,93,202,4.47
2020,CB2020,081,4,Queens,40142021007,25,14,11,4.06
2020,CB2020,081,4,Queens,40142021008,201,110,91,5.59
2020,CB2020,081,4,Queens,40142021009,0,0,0,2.44
2020,CB2020,081,4,Queens,40142022000,104,52,52,3.01
2020,CB2020,081,4,Queens,40142022001,122,96,26,36.62
2020,CB2020,081,4,Queens,40142022002,136,64,72,3.39
2020,CB2020,081,4,Queens,40142022003,17,4,13,2.87
2020,CB2020,081,4,Queens,40142022004,87,36,51,3.15
2020,CB2020,081,4,Queens,40142022005,159,85,74,3.68
2020,CB2020,081,4,Queens,40142022006,0,0,0,0.34
2020,CB2020,081,4,Queens,40142022007,0,0,0,9.39
2020,CB2020,081,4,Queens,40142022008,157,88,69,32.59
2020,CB2020,081,4,Queens,40142022009,0,0,0,1.86
2020,CB2020,081,4,Queens,40142022010,0,0,0,1.34
2020,CB2020,081,4,Queens,40142022011,0,0,0,0.98
2020,CB2020,081,4,Queens,40142022012,228,108,120,3.39
2020,CB2020,081,4,Queens,40143001000,659,327,332,6.33
2020,CB2020,081,4,Queens,40143001001,670,320,350,6.33
2020,CB2020,081,4,Queens,40143002000,1258,639,619,8.39
2020,CB2020,081,4,Queens,40143002001,629,344,285,6.36
2020,CB2020,081,4,Queens,40143002002,791,385,406,6.32
2020,CB2020,081,4,Queens,40144001000,307,145,162,3.63
2020,CB2020,081,4,Queens,40144001001,196,106,90,3.48
2020,CB2020,081,4,Queens,40144001002,204,113,91,3.3
2020,CB2020,081,4,Queens,40144001003,195,110,85,3.21
2020,CB2020,081,4,Queens,40144001004,40,23,17,4.76
2020,CB2020,081,4,Queens,40144001005,140,83,57,7.56
2020,CB2020,081,4,Queens,40144001006,109,67,42,9.73
2020,CB2020,081,4,Queens,40144001007,178,112,66,4.06
2020,CB2020,081,4,Queens,40144001008,116,54,62,4
2020,CB2020,081,4,Queens,40144001009,289,119,170,4.64
2020,CB2020,081,4,Queens,40144001010,231,128,103,4.81
2020,CB2020,081,4,Queens,40144001011,0,0,0,0.62
2020,CB2020,081,4,Queens,40144001012,0,0,0,0.53
2020,CB2020,081,4,Queens,40145001000,437,187,250,6.32
2020,CB2020,081,4,Queens,40145001001,325,166,159,6.33
2020,CB2020,081,4,Queens,40145001002,0,0,0,1.8
2020,CB2020,081,4,Queens,40145001003,216,129,87,4.52
2020,CB2020,081,4,Queens,40145002000,784,396,388,6.27
2020,CB2020,081,4,Queens,40145002001,606,321,285,6.33
2020,CB2020,081,4,Queens,40147001000,398,210,188,4.05
2020,CB2020,081,4,Queens,40147001001,288,124,164,4.06
2020,CB2020,081,4,Queens,40147001002,310,145,165,4.06
2020,CB2020,081,4,Queens,40147002000,334,158,176,4.07
2020,CB2020,081,4,Queens,40147002001,298,156,142,4.08
2020,CB2020,081,4,Queens,40147002002,265,127,138,4.05
2020,CB2020,081,4,Queens,40147003000,324,169,155,4.07
2020,CB2020,081,4,Queens,40147003001,427,220,207,4.06
2020,CB2020,081,4,Queens,40147003002,289,130,159,4.06
2020,CB2020,081,4,Queens,40148001000,124,60,64,2.1
2020,CB2020,081,4,Queens,40148001001,106,48,58,2.13
2020,CB2020,081,4,Queens,40148001002,147,66,81,2.56
2020,CB2020,081,4,Queens,40148001003,175,98,77,2.65
2020,CB2020,081,4,Queens,40148001004,194,120,74,2.49
2020,CB2020,081,4,Queens,40148001005,7,3,4,6.82
2020,CB2020,081,4,Queens,40148001006,0,0,0,1.03
2020,CB2020,081,4,Queens,40148001007,181,74,107,2.49
2020,CB2020,081,4,Queens,40148001008,271,124,147,3.99
2020,CB2020,081,4,Queens,40148001009,388,195,193,4.05
2020,CB2020,081,4,Queens,40148001010,347,205,142,4.2
2020,CB2020,081,4,Queens,40148001011,7,5,2,0.71
2020,CB2020,081,4,Queens,40148001012,239,143,96,3.6
2020,CB2020,081,4,Queens,40149001000,473,209,264,5.72
2020,CB2020,081,4,Queens,40149001001,914,486,428,6.59
2020,CB2020,081,4,Queens,40149002000,161,85,76,5.18
2020,CB2020,081,4,Queens,40149002001,107,62,45,1.38
2020,CB2020,081,4,Queens,40149002002,594,291,303,3.94
2020,CB2020,081,4,Queens,40149002003,163,83,80,2.66
2020,CB2020,081,4,Queens,40149002004,65,26,39,0.87
2020,CB2020,081,4,Queens,40150001000,185,105,80,2.67
2020,CB2020,081,4,Queens,40150001001,162,102,60,2.67
2020,CB2020,081,4,Queens,40150001002,153,67,86,3.21
2020,CB2020,081,4,Queens,40150001003,208,112,96,3.2
2020,CB2020,081,4,Queens,40150001004,204,88,116,2.92
2020,CB2020,081,4,Queens,40150001005,246,113,133,2.79
2020,CB2020,081,4,Queens,40150002000,205,106,99,2.79
2020,CB2020,081,4,Queens,40150002001,237,101,136,2.9
2020,CB2020,081,4,Queens,40150002002,239,145,94,3.3
2020,CB2020,081,4,Queens,40150002003,163,96,67,3.3
2020,CB2020,081,4,Queens,40150002004,192,98,94,3.32
2020,CB2020,081,4,Queens,40150002005,224,110,114,3.27
2020,CB2020,081,4,Queens,40151001000,667,315,352,6.56
2020,CB2020,081,4,Queens,40151001001,525,253,272,6.57
2020,CB2020,081,4,Queens,40151002000,142,61,81,1.26
2020,CB2020,081,4,Queens,40151002001,173,71,102,1.86
2020,CB2020,081,4,Queens,40151002002,229,107,122,2.45
2020,CB2020,081,4,Queens,40151002003,266,136,130,4.13
2020,CB2020,081,4,Queens,40151002004,0,0,0,4.73
2020,CB2020,081,4,Queens,40151002005,673,331,342,5.42
2020,CB2020,081,4,Queens,40152001000,0,0,0,1.89
2020,CB2020,081,4,Queens,40152001001,177,106,71,3.43
2020,CB2020,081,4,Queens,40152001002,152,75,77,2.12
2020,CB2020,081,4,Queens,40152001003,195,82,113,2.68
2020,CB2020,081,4,Queens,40152001004,318,164,154,4.55
2020,CB2020,081,4,Queens,40152001005,330,172,158,4.91
2020,CB2020,081,4,Queens,40152001006,139,82,57,2.74
2020,CB2020,081,4,Queens,40152002000,0,0,0,1.3
2020,CB2020,081,4,Queens,40152002001,128,64,64,2.83
2020,CB2020,081,4,Queens,40152002002,230,104,126,2.99
2020,CB2020,081,4,Queens,40152002003,236,117,119,2.9
2020,CB2020,081,4,Queens,40152002004,186,82,104,4.52
2020,CB2020,081,4,Queens,40152002005,284,142,142,4.47
2020,CB2020,081,4,Queens,40152002006,263,135,128,4.46
2020,CB2020,081,4,Queens,40153001000,173,73,100,2.67
2020,CB2020,081,4,Queens,40153001001,249,138,111,3.7
2020,CB2020,081,4,Queens,40153001002,427,226,201,4.75
2020,CB2020,081,4,Queens,40153001003,0,0,0,1.24
2020,CB2020,081,4,Queens,40153001004,91,44,47,2.36
2020,CB2020,081,4,Queens,40153001005,188,80,108,3.35
2020,CB2020,081,4,Queens,40153002000,457,236,221,5.36
2020,CB2020,081,4,Queens,40153002001,0,0,0,0.62
2020,CB2020,081,4,Queens,40153002002,93,31,62,1.67
2020,CB2020,081,4,Queens,40153002003,453,216,237,4.34
2020,CB2020,081,4,Queens,40154001000,199,129,70,2.74
2020,CB2020,081,4,Queens,40154001001,0,0,0,2.74
2020,CB2020,081,4,Queens,40154001002,129,54,75,3.27
2020,CB2020,081,4,Queens,40154001003,228,92,136,3.31
2020,CB2020,081,4,Queens,40154001004,183,106,77,2.94
2020,CB2020,081,4,Queens,40154001005,258,126,132,2.85
2020,CB2020,081,4,Queens,40154002000,175,99,76,2.85
2020,CB2020,081,4,Queens,40154002001,218,116,102,2.94
2020,CB2020,081,4,Queens,40154002002,171,76,95,3.37
2020,CB2020,081,4,Queens,40154002003,200,96,104,3.36
2020,CB2020,081,4,Queens,40154002004,369,204,165,3.39
2020,CB2020,081,4,Queens,40154002005,260,151,109,3.35
2020,CB2020,081,4,Queens,40155001000,323,131,192,5.98
2020,CB2020,081,4,Queens,40155001001,680,334,346,6.01
2020,CB2020,081,4,Queens,40155001002,517,275,242,6.01
2020,CB2020,081,4,Queens,40155002000,319,161,158,6.59
2020,CB2020,081,4,Queens,40155002001,234,107,127,6.01
2020,CB2020,081,4,Queens,40155002002,271,158,113,5.86
2020,CB2020,081,4,Queens,40156001000,272,129,143,4.51
2020,CB2020,081,4,Queens,40156001001,309,139,170,4.46
2020,CB2020,081,4,Queens,40156001002,178,103,75,2.21
2020,CB2020,081,4,Queens,40156001003,124,66,58,2.06
2020,CB2020,081,4,Queens,40156001004,351,178,173,4.65
2020,CB2020,081,4,Queens,40156001005,131,66,65,2.42
2020,CB2020,081,4,Queens,40156002000,320,154,166,4.65
2020,CB2020,081,4,Queens,40156002001,226,108,118,4.82
2020,CB2020,081,4,Queens,40156002002,278,126,152,5.5
2020,CB2020,081,4,Queens,40156002003,328,193,135,5.5
2020,CB2020,081,4,Queens,40156002004,326,171,155,5.54
2020,CB2020,081,4,Queens,40156002005,367,198,169,5.44
2020,CB2020,081,4,Queens,40157001000,654,331,323,5.87
2020,CB2020,081,4,Queens,40157001001,434,206,228,3.96
2020,CB2020,081,4,Queens,40157001002,53,38,15,3.89
2020,CB2020,081,4,Queens,40157001003,285,140,145,3.88
2020,CB2020,081,4,Queens,40157001004,0,0,0,3.95
2020,CB2020,081,4,Queens,40157001005,0,0,0,3.91
2020,CB2020,081,4,Queens,40157001006,0,0,0,0.43
2020,CB2020,081,4,Queens,40157001007,209,104,105,2.23
2020,CB2020,081,4,Queens,40157001008,20,14,6,3.63
2020,CB2020,081,4,Queens,40158011000,0,0,0,1.5
2020,CB2020,081,4,Queens,40158011001,162,92,70,2.83
2020,CB2020,081,4,Queens,40158011002,133,70,63,3.01
2020,CB2020,081,4,Queens,40158011003,263,115,148,5.22
2020,CB2020,081,4,Queens,40158011004,321,175,146,5.26
2020,CB2020,081,4,Queens,40158011005,0,0,0,1.6
2020,CB2020,081,4,Queens,40158011006,200,99,101,3.55
2020,CB2020,081,4,Queens,40158011007,189,98,91,3.58
2020,CB2020,081,4,Queens,40158012000,116,60,56,2.88
2020,CB2020,081,4,Queens,40158012001,45,25,20,0.73
2020,CB2020,081,4,Queens,40158012002,61,23,38,2.17
2020,CB2020,081,4,Queens,40158012003,337,175,162,6.23
2020,CB2020,081,4,Queens,40158012004,266,127,139,5.14
2020,CB2020,081,4,Queens,40158012005,262,120,142,3.74
2020,CB2020,081,4,Queens,40158012006,128,52,76,3.72
2020,CB2020,081,4,Queens,40158013000,93,55,38,1.33
2020,CB2020,081,4,Queens,40158013001,90,45,45,1.86
2020,CB2020,081,4,Queens,40158013002,152,78,74,2.17
2020,CB2020,081,4,Queens,40158013003,461,230,231,5.95
2020,CB2020,081,4,Queens,40158013004,330,176,154,6.17
2020,CB2020,081,4,Queens,40158013005,208,101,107,4.42
2020,CB2020,081,4,Queens,40158021000,110,71,39,1.69
2020,CB2020,081,4,Queens,40158021001,202,92,110,2.69
2020,CB2020,081,4,Queens,40158021002,97,64,33,1.86
2020,CB2020,081,4,Queens,40158021003,373,197,176,5.66
2020,CB2020,081,4,Queens,40158021004,401,196,205,5.66
2020,CB2020,081,4,Queens,40158021005,264,109,155,4.57
2020,CB2020,081,4,Queens,40158022000,367,195,172,5.04
2020,CB2020,081,4,Queens,40158022001,355,179,176,5.21
2020,CB2020,081,4,Queens,40158022002,241,110,131,3.89
2020,CB2020,081,4,Queens,40158022003,372,186,186,4.85
2020,CB2020,081,4,Queens,40158022004,278,131,147,4.75
2020,CB2020,081,4,Queens,40158023000,181,97,84,2.9
2020,CB2020,081,4,Queens,40158023001,224,110,114,3.1
2020,CB2020,081,4,Queens,40158023002,218,115,103,3.89
2020,CB2020,081,4,Queens,40158023003,275,117,158,4.09
2020,CB2020,081,4,Queens,40158023004,447,201,246,4.36
2020,CB2020,081,4,Queens,40158023005,202,98,104,4.57
2020,CB2020,081,4,Queens,40159001000,462,225,237,5.86
2020,CB2020,081,4,Queens,40159001001,414,231,183,5.03
2020,CB2020,081,4,Queens,40159001002,174,79,95,0.84
2020,CB2020,081,4,Queens,40159002000,609,291,318,3.93
2020,CB2020,081,4,Queens,40159002001,636,307,329,3.93
2020,CB2020,081,4,Queens,40159002002,0,0,0,2.6
2020,CB2020,081,4,Queens,40159003000,328,168,160,3.95
2020,CB2020,081,4,Queens,40159003001,128,57,71,3.2
2020,CB2020,081,4,Queens,40159003002,0,0,0,0.87
2020,CB2020,081,4,Queens,40159004000,681,344,337,5.86
2020,CB2020,081,4,Queens,40159004001,487,252,235,5.25
2020,CB2020,081,4,Queens,40159004002,91,41,50,0.61
2020,CB2020,081,4,Queens,40161001000,385,149,236,5.86
2020,CB2020,081,4,Queens,40161001001,609,358,251,5.84
2020,CB2020,081,4,Queens,40161001002,0,0,0,1.04
2020,CB2020,081,4,Queens,40161001003,56,28,28,1.9
2020,CB2020,081,4,Queens,40161002000,688,305,383,5.93
2020,CB2020,081,4,Queens,40161002001,553,303,250,5.67
2020,CB2020,081,4,Queens,40161002002,0,0,0,0.38
2020,CB2020,081,4,Queens,40163001000,367,156,211,2.57
2020,CB2020,081,4,Queens,40163001001,259,136,123,4.07
2020,CB2020,081,4,Queens,40163001002,229,123,106,6.45
2020,CB2020,081,4,Queens,40163001003,0,0,0,0.6
2020,CB2020,081,4,Queens,40163002000,858,336,522,8.22
2020,CB2020,081,4,Queens,40163002001,0,0,0,4.18
2020,CB2020,081,4,Queens,40163002002,0,0,0,3.15
2020,CB2020,081,4,Queens,40163003000,586,218,368,11.55
2020,CB2020,081,4,Queens,40163003001,1754,746,1008,13.14
2020,CB2020,081,4,Queens,40164001000,216,119,97,3.92
2020,CB2020,081,4,Queens,40164001001,199,97,102,3.7
2020,CB2020,081,4,Queens,40164001002,229,119,110,4.07
2020,CB2020,081,4,Queens,40164001003,280,101,179,4.66
2020,CB2020,081,4,Queens,40164001004,300,125,175,4.68
2020,CB2020,081,4,Queens,40164001005,74,42,32,1.08
2020,CB2020,081,4,Queens,40164002000,250,124,126,3.96
2020,CB2020,081,4,Queens,40164002001,282,131,151,4.52
2020,CB2020,081,4,Queens,40164002002,325,158,167,4.67
2020,CB2020,081,4,Queens,40164002003,308,156,152,3.78
2020,CB2020,081,4,Queens,40164002004,484,226,258,4.9
2020,CB2020,081,4,Queens,40164002005,359,184,175,4.95
2020,CB2020,081,4,Queens,40166001000,310,163,147,4.58
2020,CB2020,081,4,Queens,40166001001,285,156,129,4.58
2020,CB2020,081,4,Queens,40166001002,391,193,198,5.15
2020,CB2020,081,4,Queens,40166001003,408,192,216,4.01
2020,CB2020,081,4,Queens,40166001004,89,33,56,0.97
2020,CB2020,081,4,Queens,40166001005,255,131,124,4.07
2020,CB2020,081,4,Queens,40166001006,402,202,200,4.2
2020,CB2020,081,4,Queens,40166002000,247,118,129,4.07
2020,CB2020,081,4,Queens,40166002001,259,130,129,4.21
2020,CB2020,081,4,Queens,40166002002,227,120,107,4.21
2020,CB2020,081,4,Queens,40166002003,254,120,134,4.06
2020,CB2020,081,4,Queens,40166002004,154,97,57,3.42
2020,CB2020,081,4,Queens,40166002005,119,54,65,2.61
2020,CB2020,081,4,Queens,40168001000,198,85,113,4
2020,CB2020,081,4,Queens,40168001001,233,134,99,4
2020,CB2020,081,4,Queens,40168001002,372,198,174,4.07
2020,CB2020,081,4,Queens,40168001003,196,94,102,4.08
2020,CB2020,081,4,Queens,40168001004,207,93,114,4.05
2020,CB2020,081,4,Queens,40168001005,169,71,98,3.61
2020,CB2020,081,4,Queens,40168001006,41,12,29,0.42
2020,CB2020,081,4,Queens,40168002000,193,94,99,4.08
2020,CB2020,081,4,Queens,40168002001,60,24,36,1.63
2020,CB2020,081,4,Queens,40168002002,147,68,79,2.48
2020,CB2020,081,4,Queens,40168002003,252,128,124,4.11
2020,CB2020,081,4,Queens,40168002004,102,48,54,1.82
2020,CB2020,081,4,Queens,40168002005,85,47,38,2.32
2020,CB2020,081,4,Queens,40168002006,244,116,128,3.99
2020,CB2020,081,4,Queens,40168002007,205,102,103,4.06
2020,CB2020,081,4,Queens,40168002008,60,28,32,2.02
2020,CB2020,081,4,Queens,40168002009,0,0,0,1.18
2020,CB2020,081,4,Queens,40168002010,0,0,0,0.32
2020,CB2020,081,4,Queens,40169001000,199,93,106,5.56
2020,CB2020,081,4,Queens,40169001001,1077,512,565,5.59
2020,CB2020,081,4,Queens,40169001002,66,34,32,5.11
2020,CB2020,081,4,Queens,40169001003,327,175,152,3.49
2020,CB2020,081,4,Queens,40169002000,241,117,124,3.8
2020,CB2020,081,4,Queens,40169002001,46,21,25,1.01
2020,CB2020,081,4,Queens,40169002002,406,201,205,5.12
2020,CB2020,081,4,Queens,40169002003,86,53,33,1.66
2020,CB2020,081,4,Queens,40169002004,371,179,192,4.5
2020,CB2020,081,4,Queens,40169002005,73,26,47,1.04
2020,CB2020,081,4,Queens,40169002006,257,129,128,1.3
2020,CB2020,081,4,Queens,40169003000,708,358,350,6.16
2020,CB2020,081,4,Queens,40169003001,675,326,349,6.13
2020,CB2020,081,4,Queens,40169004000,1045,508,537,6.63
2020,CB2020,081,4,Queens,40170001000,0,0,0,1.98
2020,CB2020,081,4,Queens,40170001001,288,145,143,5.83
2020,CB2020,081,4,Queens,40170001002,229,120,109,5.41
2020,CB2020,081,4,Queens,40170001003,240,126,114,5.29
2020,CB2020,081,4,Queens,40170001004,298,116,182,4.94
2020,CB2020,081,4,Queens,40170001005,374,171,203,4.83
2020,CB2020,081,4,Queens,40170002000,245,109,136,4.73
2020,CB2020,081,4,Queens,40170002001,15,7,8,4
2020,CB2020,081,4,Queens,40170002002,23,10,13,0.42
2020,CB2020,081,4,Queens,40170002003,140,87,53,1.76
2020,CB2020,081,4,Queens,40170002004,80,26,54,3.15
2020,CB2020,081,4,Queens,40170002005,248,128,120,4.11
2020,CB2020,081,4,Queens,40170002006,199,101,98,4.12
2020,CB2020,081,4,Queens,40170002007,125,73,52,2.27
2020,CB2020,081,4,Queens,40170002008,0,0,0,0.9
2020,CB2020,081,4,Queens,40171011000,0,0,0,5.08
2020,CB2020,081,4,Queens,40171011001,0,0,0,9.14
2020,CB2020,081,4,Queens,40171011002,0,0,0,0.68
2020,CB2020,081,4,Queens,40171011003,1,1,0,7.57
2020,CB2020,081,4,Queens,40171011004,11,9,2,24.31
2020,CB2020,081,4,Queens,40171011005,0,0,0,13.88
2020,CB2020,081,4,Queens,40171011006,2,1,1,46.44
2020,CB2020,081,4,Queens,40171011007,0,0,0,5.34
2020,CB2020,081,4,Queens,40171011008,3,1,2,29.82
2020,CB2020,081,4,Queens,40171011009,19,7,12,20.65
2020,CB2020,081,4,Queens,40171011010,0,0,0,4.28
2020,CB2020,081,4,Queens,40171011011,0,0,0,5.25
2020,CB2020,081,4,Queens,40171011012,0,0,0,3.27
2020,CB2020,081,4,Queens,40171011013,0,0,0,16.14
2020,CB2020,081,4,Queens,40171011014,0,0,0,13.47
2020,CB2020,081,4,Queens,40171011015,0,0,0,0.25
2020,CB2020,081,4,Queens,40171021000,9,3,6,24.31
2020,CB2020,081,4,Queens,40171021001,7,6,1,37.93
2020,CB2020,081,4,Queens,40171021002,0,0,0,10.92
2020,CB2020,081,4,Queens,40171021003,0,0,0,8.81
2020,CB2020,081,4,Queens,40171021004,11,5,6,10.27
2020,CB2020,081,4,Queens,40171021005,0,0,0,4.21
2020,CB2020,081,4,Queens,40171021006,0,0,0,4.18
2020,CB2020,081,4,Queens,40172001000,272,139,133,4.37
2020,CB2020,081,4,Queens,40172001001,258,147,111,4.37
2020,CB2020,081,4,Queens,40172001002,238,102,136,4.06
2020,CB2020,081,4,Queens,40172001003,233,101,132,4.03
2020,CB2020,081,4,Queens,40172001004,218,107,111,3.6
2020,CB2020,081,4,Queens,40172001005,44,29,15,0.48
2020,CB2020,081,4,Queens,40172001006,94,31,63,1.93
2020,CB2020,081,4,Queens,40172001007,100,59,41,2.15
2020,CB2020,081,4,Queens,40172002000,0,0,0,1.56
2020,CB2020,081,4,Queens,40172002001,93,47,46,3.23
2020,CB2020,081,4,Queens,40172002002,70,32,38,1.19
2020,CB2020,081,4,Queens,40172002003,33,18,15,3.44
2020,CB2020,081,4,Queens,40172002004,197,84,113,4.02
2020,CB2020,081,4,Queens,40172002005,177,92,85,4.07
2020,CB2020,081,4,Queens,40172002006,168,81,87,4.07
2020,CB2020,081,4,Queens,40172002007,29,15,14,0.64
2020,CB2020,081,4,Queens,40174001000,0,0,0,1.49
2020,CB2020,081,4,Queens,40174001001,160,77,83,4.37
2020,CB2020,081,4,Queens,40174001002,224,103,121,4.04
2020,CB2020,081,4,Queens,40174001003,135,64,71,2.85
2020,CB2020,081,4,Queens,40174001004,252,123,129,4.07
2020,CB2020,081,4,Queens,40174001005,239,107,132,4.07
2020,CB2020,081,4,Queens,40174001006,40,22,18,1.22
2020,CB2020,081,4,Queens,40174002000,263,144,119,4.38
2020,CB2020,081,4,Queens,40174002001,259,124,135,4.37
2020,CB2020,081,4,Queens,40174002002,215,97,118,4.06
2020,CB2020,081,4,Queens,40174002003,206,78,128,4.06
2020,CB2020,081,4,Queens,40174002004,206,89,117,4.06
2020,CB2020,081,4,Queens,40174002005,224,118,106,4.06
2020,CB2020,081,4,Queens,40176001000,97,49,48,4.38
2020,CB2020,081,4,Queens,40176001001,184,87,97,4.37
2020,CB2020,081,4,Queens,40176001002,188,103,85,4.06
2020,CB2020,081,4,Queens,40176001003,182,86,96,4.06
2020,CB2020,081,4,Queens,40176001004,200,74,126,4.06
2020,CB2020,081,4,Queens,40176001005,247,142,105,4.06
2020,CB2020,081,4,Queens,40176002000,0,0,0,1.38
2020,CB2020,081,4,Queens,40176002001,250,115,135,4.28
2020,CB2020,081,4,Queens,40176002002,219,104,115,4.07
2020,CB2020,081,4,Queens,40176002003,158,73,85,4.05
2020,CB2020,081,4,Queens,40176002004,200,85,115,3.24
2020,CB2020,081,4,Queens,40176002005,216,112,104,4.09
2020,CB2020,081,4,Queens,40176002006,40,17,23,0.82
2020,CB2020,081,4,Queens,40178001000,239,146,93,4.36
2020,CB2020,081,4,Queens,40178001001,205,85,120,4.37
2020,CB2020,081,4,Queens,40178001002,175,95,80,4.06
2020,CB2020,081,4,Queens,40178001003,202,86,116,4.1
2020,CB2020,081,4,Queens,40178001004,152,67,85,3.64
2020,CB2020,081,4,Queens,40178001005,90,31,59,2.78
2020,CB2020,081,4,Queens,40178001006,0,0,0,0.28
2020,CB2020,081,4,Queens,40178001007,26,10,16,1.15
2020,CB2020,081,4,Queens,40178002000,0,0,0,1.35
2020,CB2020,081,4,Queens,40178002001,160,73,87,4.22
2020,CB2020,081,4,Queens,40178002002,191,79,112,4.12
2020,CB2020,081,4,Queens,40178002003,200,98,102,4.06
2020,CB2020,081,4,Queens,40178002004,188,92,96,3.8
2020,CB2020,081,4,Queens,40178002005,39,24,15,0.52
2020,CB2020,081,4,Queens,40178002006,217,115,102,3.82
2020,CB2020,081,4,Queens,40179011000,151,83,68,3.79
2020,CB2020,081,4,Queens,40179011001,27,15,12,3.54
2020,CB2020,081,4,Queens,40179011002,0,0,0,3.38
2020,CB2020,081,4,Queens,40179011003,272,121,151,3.64
2020,CB2020,081,4,Queens,40179011004,0,0,0,0.7
2020,CB2020,081,4,Queens,40179011005,0,0,0,0.65
2020,CB2020,081,4,Queens,40179011006,0,0,0,3.9
2020,CB2020,081,4,Queens,40179011007,536,263,273,4.21
2020,CB2020,081,4,Queens,40179021000,0,0,0,3.61
2020,CB2020,081,4,Queens,40179021001,0,0,0,3
2020,CB2020,081,4,Queens,40179021002,0,0,0,2.32
2020,CB2020,081,4,Queens,40179021003,0,0,0,1.6
2020,CB2020,081,4,Queens,40179021004,0,0,0,0.99
2020,CB2020,081,4,Queens,40179021005,0,0,0,0.33
2020,CB2020,081,4,Queens,40179021006,6,6,0,3.44
2020,CB2020,081,4,Queens,40179021007,0,0,0,3.17
2020,CB2020,081,4,Queens,40179021008,1,1,0,1.43
2020,CB2020,081,4,Queens,40179021009,92,86,6,6.35
2020,CB2020,081,4,Queens,40179021010,0,0,0,4.15
2020,CB2020,081,4,Queens,40179021011,0,0,0,4.09
2020,CB2020,081,4,Queens,40179021012,0,0,0,3.48
2020,CB2020,081,4,Queens,40179021013,4,4,0,3.48
2020,CB2020,081,4,Queens,40179021014,6,5,1,3.49
2020,CB2020,081,4,Queens,40179021015,0,0,0,3.52
2020,CB2020,081,4,Queens,40179021016,0,0,0,3.52
2020,CB2020,081,4,Queens,40179021017,0,0,0,0.67
2020,CB2020,081,4,Queens,40179021018,0,0,0,0.66
2020,CB2020,081,4,Queens,40179021019,0,0,0,0.68
2020,CB2020,081,4,Queens,40179021020,0,0,0,0.68
2020,CB2020,081,4,Queens,40179021021,1,1,0,0.69
2020,CB2020,081,4,Queens,40179021022,0,0,0,0.71
2020,CB2020,081,4,Queens,40179021023,0,0,0,0.41
2020,CB2020,081,4,Queens,40179021024,7,6,1,4.3
2020,CB2020,081,4,Queens,40179021025,0,0,0,4
2020,CB2020,081,4,Queens,40179021026,7,6,1,4.12
2020,CB2020,081,4,Queens,40179021027,0,0,0,4.06
2020,CB2020,081,4,Queens,40179021028,0,0,0,4.08
2020,CB2020,081,4,Queens,40179021029,0,0,0,4.06
2020,CB2020,081,4,Queens,40179021030,0,0,0,4.05
2020,CB2020,081,4,Queens,40179021031,0,0,0,4.05
2020,CB2020,081,4,Queens,40179021032,0,0,0,4.05
2020,CB2020,081,4,Queens,40180001000,0,0,0,2.24
2020,CB2020,081,4,Queens,40180001001,198,102,96,4.17
2020,CB2020,081,4,Queens,40180001002,236,124,112,4.17
2020,CB2020,081,4,Queens,40180001003,190,84,106,4.01
2020,CB2020,081,4,Queens,40180001004,151,54,97,2.99
2020,CB2020,081,4,Queens,40180001005,242,98,144,3.7
2020,CB2020,081,4,Queens,40180001006,103,62,41,4.07
2020,CB2020,081,4,Queens,40180001007,0,0,0,2.14
2020,CB2020,081,4,Queens,40180001008,110,71,39,2.97
2020,CB2020,081,4,Queens,40180001009,101,56,45,2.09
2020,CB2020,081,4,Queens,40180001010,34,11,23,1.23
2020,CB2020,081,4,Queens,40180001011,0,0,0,0.36
2020,CB2020,081,4,Queens,40181011000,480,248,232,3.67
2020,CB2020,081,4,Queens,40181011001,529,235,294,3.68
2020,CB2020,081,4,Queens,40181012000,659,328,331,3.46
2020,CB2020,081,4,Queens,40181012001,698,317,381,3.5
2020,CB2020,081,4,Queens,40181013000,39,20,19,0.68
2020,CB2020,081,4,Queens,40181013001,0,0,0,0.68
2020,CB2020,081,4,Queens,40181013002,836,416,420,4.05
2020,CB2020,081,4,Queens,40181013003,595,274,321,4.04
2020,CB2020,081,4,Queens,40181021000,820,362,458,3.68
2020,CB2020,081,4,Queens,40181021001,313,148,165,3.5
2020,CB2020,081,4,Queens,40181022000,0,0,0,0.69
2020,CB2020,081,4,Queens,40181022001,42,17,25,0.7
2020,CB2020,081,4,Queens,40181022002,686,353,333,4.06
2020,CB2020,081,4,Queens,40181022003,514,272,242,4.07
2020,CB2020,081,4,Queens,40181023000,797,398,399,3.67
2020,CB2020,081,4,Queens,40181023001,628,290,338,3.49
2020,CB2020,081,4,Queens,40182001000,114,36,78,2.28
2020,CB2020,081,4,Queens,40182001001,473,226,247,10.8
2020,CB2020,081,4,Queens,40182001002,122,45,77,3.25
2020,CB2020,081,4,Queens,40182001003,50,13,37,2.87
2020,CB2020,081,4,Queens,40182001004,127,60,67,2.54
2020,CB2020,081,4,Queens,40182001005,0,0,0,2.97
2020,CB2020,081,4,Queens,40182001006,35,28,7,1.28
2020,CB2020,081,4,Queens,40182001007,66,27,39,1.37
2020,CB2020,081,4,Queens,40182001008,84,42,42,1.35
2020,CB2020,081,4,Queens,40182001009,144,81,63,3.42
2020,CB2020,081,4,Queens,40182001010,125,70,55,1.81
2020,CB2020,081,4,Queens,40182001011,46,26,20,0.85
2020,CB2020,081,4,Queens,40182002000,188,94,94,4.24
2020,CB2020,081,4,Queens,40182002001,256,113,143,5.36
2020,CB2020,081,4,Queens,40182002002,249,138,111,5.02
2020,CB2020,081,4,Queens,40182002003,224,85,139,4.73
2020,CB2020,081,4,Queens,40182002004,237,105,132,4.37
2020,CB2020,081,4,Queens,40182002005,0,0,0,0.51
2020,CB2020,081,4,Queens,40182002006,0,0,0,3.6
2020,CB2020,081,4,Queens,40182002007,0,0,0,1.79
2020,CB2020,081,4,Queens,40183001000,329,168,161,6.13
2020,CB2020,081,4,Queens,40183001001,234,124,110,5.97
2020,CB2020,081,4,Queens,40183001002,304,144,160,5.31
2020,CB2020,081,4,Queens,40183002000,534,262,272,3.67
2020,CB2020,081,4,Queens,40183002001,528,259,269,3.67
2020,CB2020,081,4,Queens,40183003000,738,371,367,3.66
2020,CB2020,081,4,Queens,40183003001,660,325,335,3.51
2020,CB2020,081,4,Queens,40183003002,0,0,0,0.68
2020,CB2020,081,4,Queens,40183004000,890,416,474,3.5
2020,CB2020,081,4,Queens,40183004001,643,315,328,3.5
2020,CB2020,081,4,Queens,40183004002,0,0,0,0.69
2020,CB2020,081,4,Queens,40183004003,17,14,3,0.7
2020,CB2020,081,4,Queens,40183005000,109,48,61,2.31
2020,CB2020,081,4,Queens,40183005001,203,100,103,3.44
2020,CB2020,081,4,Queens,40183005002,608,299,309,4.05
2020,CB2020,081,4,Queens,40183005003,188,92,96,1.74
2020,CB2020,081,4,Queens,40183005004,59,38,21,0.6
2020,CB2020,081,4,Queens,40184011000,226,102,124,3
2020,CB2020,081,4,Queens,40184011001,108,56,52,2.23
2020,CB2020,081,4,Queens,40184011002,151,69,82,3.67
2020,CB2020,081,4,Queens,40184011003,148,76,72,3.57
2020,CB2020,081,4,Queens,40184011004,151,75,76,3.68
2020,CB2020,081,4,Queens,40184011005,199,101,98,3.97
2020,CB2020,081,4,Queens,40184011006,124,59,65,2.8
2020,CB2020,081,4,Queens,40184011007,161,68,93,3.55
2020,CB2020,081,4,Queens,40184011008,182,65,117,4.41
2020,CB2020,081,4,Queens,40184011009,235,118,117,5.04
2020,CB2020,081,4,Queens,40184011010,231,90,141,5.28
2020,CB2020,081,4,Queens,40184011011,258,102,156,5.28
2020,CB2020,081,4,Queens,40184011012,0,0,0,0.56
2020,CB2020,081,4,Queens,40184021000,150,79,71,4.59
2020,CB2020,081,4,Queens,40184021001,297,137,160,4.56
2020,CB2020,081,4,Queens,40184021002,127,51,76,2.57
2020,CB2020,081,4,Queens,40184021003,48,28,20,1.78
2020,CB2020,081,4,Queens,40184021004,167,93,74,2.87
2020,CB2020,081,4,Queens,40184021005,169,75,94,3.04
2020,CB2020,081,4,Queens,40184021006,64,28,36,3.17
2020,CB2020,081,4,Queens,40184021007,125,45,80,3.18
2020,CB2020,081,4,Queens,40184021008,135,78,57,3.29
2020,CB2020,081,4,Queens,40184022000,167,99,68,5.37
2020,CB2020,081,4,Queens,40184022001,231,104,127,3.83
2020,CB2020,081,4,Queens,40184022002,207,86,121,3.89
2020,CB2020,081,4,Queens,40184022003,215,106,109,3.75
2020,CB2020,081,4,Queens,40184022004,154,75,79,3.43
2020,CB2020,081,4,Queens,40184022005,156,77,79,3.2
2020,CB2020,081,4,Queens,40185011000,423,216,207,4.06
2020,CB2020,081,4,Queens,40185011001,397,196,201,3.68
2020,CB2020,081,4,Queens,40185011002,37,12,25,0.37
2020,CB2020,081,4,Queens,40185012000,922,450,472,4.05
2020,CB2020,081,4,Queens,40185012001,170,80,90,1.07
2020,CB2020,081,4,Queens,40185012002,263,113,150,2.99
2020,CB2020,081,4,Queens,40185013000,745,421,324,4.07
2020,CB2020,081,4,Queens,40185013001,545,263,282,4.06
2020,CB2020,081,4,Queens,40185021000,751,365,386,4.07
2020,CB2020,081,4,Queens,40185022000,720,311,409,4.06
2020,CB2020,081,4,Queens,40185022001,879,459,420,4.04
2020,CB2020,081,4,Queens,40185023000,0,0,0,0.65
2020,CB2020,081,4,Queens,40185023001,0,0,0,1.91
2020,CB2020,081,4,Queens,40185023002,477,233,244,3.13
2020,CB2020,081,4,Queens,40185023003,0,0,0,0.9
2020,CB2020,081,4,Queens,40185023004,164,85,79,2.15
2020,CB2020,081,4,Queens,40185023005,462,214,248,3.41
2020,CB2020,081,4,Queens,40186001000,242,109,133,4.35
2020,CB2020,081,4,Queens,40186001001,194,88,106,4.17
2020,CB2020,081,4,Queens,40186001002,182,80,102,4.08
2020,CB2020,081,4,Queens,40186001003,131,65,66,4.05
2020,CB2020,081,4,Queens,40186001004,133,77,56,4.26
2020,CB2020,081,4,Queens,40186001005,149,77,72,3.19
2020,CB2020,081,4,Queens,40186001006,180,94,86,3.96
2020,CB2020,081,4,Queens,40186001007,163,63,100,4.02
2020,CB2020,081,4,Queens,40186001008,198,95,103,4.02
2020,CB2020,081,4,Queens,40186001009,117,52,65,2.71
2020,CB2020,081,4,Queens,40186001010,0,0,0,2.36
2020,CB2020,081,4,Queens,40186001011,0,0,0,1.06
2020,CB2020,081,4,Queens,40186001012,113,43,70,2.49
2020,CB2020,081,4,Queens,40187001000,544,299,245,4.79
2020,CB2020,081,4,Queens,40187001001,307,163,144,4.79
2020,CB2020,081,4,Queens,40187001002,300,145,155,4.03
2020,CB2020,081,4,Queens,40187001003,70,39,31,0.77
2020,CB2020,081,4,Queens,40187001004,0,0,0,0.89
2020,CB2020,081,4,Queens,40187001005,0,0,0,0.84
2020,CB2020,081,4,Queens,40187001006,0,0,0,4.92
2020,CB2020,081,4,Queens,40187001007,0,0,0,1.22
2020,CB2020,081,4,Queens,40187001008,0,0,0,0.3
2020,CB2020,081,4,Queens,40187001009,0,0,0,0.3
2020,CB2020,081,4,Queens,40187001010,0,0,0,1.45
2020,CB2020,081,4,Queens,40187002000,362,191,171,4.69
2020,CB2020,081,4,Queens,40187002001,426,214,212,4.51
2020,CB2020,081,4,Queens,40187002002,326,143,183,4.16
2020,CB2020,081,4,Queens,40187003000,335,160,175,3.93
2020,CB2020,081,4,Queens,40187003001,296,151,145,4.01
2020,CB2020,081,4,Queens,40187003002,78,44,34,1.52
2020,CB2020,081,4,Queens,40187003003,456,208,248,1.93
2020,CB2020,081,4,Queens,40187003004,99,49,50,2.45
2020,CB2020,081,4,Queens,40187003005,12,4,8,1.88
2020,CB2020,081,4,Queens,40187003006,0,0,0,2.04
2020,CB2020,081,4,Queens,40187003007,0,0,0,1.95
2020,CB2020,081,4,Queens,40187003008,0,0,0,2.31
2020,CB2020,081,4,Queens,40188001000,215,89,126,4.05
2020,CB2020,081,4,Queens,40188001001,202,96,106,4.07
2020,CB2020,081,4,Queens,40188001002,177,89,88,4.05
2020,CB2020,081,4,Queens,40188001003,245,131,114,4.04
2020,CB2020,081,4,Queens,40188001004,162,81,81,4.22
2020,CB2020,081,4,Queens,40188001005,178,82,96,4.34
2020,CB2020,081,4,Queens,40188001006,155,62,93,4.06
2020,CB2020,081,4,Queens,40188001007,167,70,97,4.05
2020,CB2020,081,4,Queens,40188001008,9,7,2,7.98
2020,CB2020,081,4,Queens,40188001009,0,0,0,2.34
2020,CB2020,081,4,Queens,40188001010,0,0,0,1
2020,CB2020,081,4,Queens,40189001000,557,286,271,4.04
2020,CB2020,081,4,Queens,40189001001,544,279,265,4.21
2020,CB2020,081,4,Queens,40189002000,299,167,132,2.6
2020,CB2020,081,4,Queens,40189002001,133,73,60,1.31
2020,CB2020,081,4,Queens,40189002002,120,37,83,4.06
2020,CB2020,081,4,Queens,40189002003,0,0,0,4.06
2020,CB2020,081,4,Queens,40189002004,0,0,0,4.07
2020,CB2020,081,4,Queens,40189002005,0,0,0,5.88
2020,CB2020,081,4,Queens,40189002006,408,203,205,6.22
2020,CB2020,081,4,Queens,40189002007,424,223,201,5.06
2020,CB2020,081,4,Queens,40189003000,80,37,43,4.53
2020,CB2020,081,4,Queens,40189003001,128,60,68,2.74
2020,CB2020,081,4,Queens,40189003002,68,29,39,1.16
2020,CB2020,081,4,Queens,40189003003,380,213,167,1.37
2020,CB2020,081,4,Queens,40189003004,316,157,159,2.49
2020,CB2020,081,4,Queens,40190001000,150,72,78,3.79
2020,CB2020,081,4,Queens,40190001001,155,80,75,3.71
2020,CB2020,081,4,Queens,40190001002,107,59,48,2.76
2020,CB2020,081,4,Queens,40190001003,76,37,39,1.25
2020,CB2020,081,4,Queens,40190001004,87,39,48,0.95
2020,CB2020,081,4,Queens,40190001005,219,112,107,4.09
2020,CB2020,081,4,Queens,40190001006,247,133,114,4.07
2020,CB2020,081,4,Queens,40190001007,90,39,51,2.22
2020,CB2020,081,4,Queens,40190001008,22,12,10,1.03
2020,CB2020,081,4,Queens,40190002000,320,135,185,5.38
2020,CB2020,081,4,Queens,40190002001,321,171,150,5.12
2020,CB2020,081,4,Queens,40190002002,220,115,105,4.05
2020,CB2020,081,4,Queens,40190002003,249,136,113,4.05
2020,CB2020,081,4,Queens,40190002004,182,88,94,4.06
2020,CB2020,081,4,Queens,40192001000,270,111,159,4.08
2020,CB2020,081,4,Queens,40192001001,177,83,94,4.21
2020,CB2020,081,4,Queens,40192001002,51,26,25,4.21
2020,CB2020,081,4,Queens,40192001003,179,62,117,4.05
2020,CB2020,081,4,Queens,40192001004,164,84,80,4.06
2020,CB2020,081,4,Queens,40192001005,203,96,107,4.06
2020,CB2020,081,4,Queens,40192001006,177,80,97,4.08
2020,CB2020,081,4,Queens,40192001007,0,0,0,2.25
2020,CB2020,081,4,Queens,40192001008,0,0,0,0.91
2020,CB2020,081,4,Queens,40192002000,257,103,154,4.97
2020,CB2020,081,4,Queens,40192002001,383,175,208,4.67
2020,CB2020,081,4,Queens,40192002002,271,147,124,4.06
2020,CB2020,081,4,Queens,40192002003,227,119,108,4.07
2020,CB2020,081,4,Queens,40194001000,41,17,24,0.62
2020,CB2020,081,4,Queens,40194001001,133,78,55,2.04
2020,CB2020,081,4,Queens,40194001002,151,79,72,2.65
2020,CB2020,081,4,Queens,40194001003,131,63,68,2.7
2020,CB2020,081,4,Queens,40194001004,0,0,0,4.43
2020,CB2020,081,4,Queens,40194001005,0,0,0,2.47
2020,CB2020,081,4,Queens,40194001006,201,117,84,4.55
2020,CB2020,081,4,Queens,40194001007,126,53,73,3.48
2020,CB2020,081,4,Queens,40194001008,140,77,63,4.06
2020,CB2020,081,4,Queens,40194001009,168,54,114,4.06
2020,CB2020,081,4,Queens,40194001010,129,59,70,4.08
2020,CB2020,081,4,Queens,40194002000,188,80,108,3.63
2020,CB2020,081,4,Queens,40194002001,186,71,115,3.79
2020,CB2020,081,4,Queens,40194002002,140,51,89,2.94
2020,CB2020,081,4,Queens,40194002003,0,0,0,0.34
2020,CB2020,081,4,Queens,40194002004,310,148,162,6.3
2020,CB2020,081,4,Queens,40194002005,128,70,58,3.95
2020,CB2020,081,4,Queens,40194002006,120,74,46,2.35
2020,CB2020,081,4,Queens,40194002007,123,59,64,4.27
2020,CB2020,081,4,Queens,40194002008,180,103,77,4.35
2020,CB2020,081,4,Queens,40194002009,227,101,126,4.46
2020,CB2020,081,4,Queens,40194002010,193,95,98,4.05
2020,CB2020,081,4,Queens,40196001000,246,129,117,4.52
2020,CB2020,081,4,Queens,40196001001,284,135,149,4.31
2020,CB2020,081,4,Queens,40196001002,210,112,98,3.83
2020,CB2020,081,4,Queens,40196001003,225,100,125,3.56
2020,CB2020,081,4,Queens,40196001004,199,91,108,3.08
2020,CB2020,081,4,Queens,40196001005,148,66,82,3.85
2020,CB2020,081,4,Queens,40196001006,265,131,134,5.01
2020,CB2020,081,4,Queens,40196001007,214,101,113,3.45
2020,CB2020,081,4,Queens,40196002000,236,141,95,4.12
2020,CB2020,081,4,Queens,40196002001,232,116,116,4.08
2020,CB2020,081,4,Queens,40196002002,256,128,128,3.99
2020,CB2020,081,4,Queens,40196002003,107,38,69,1.82
2020,CB2020,081,4,Queens,40196002004,153,80,73,2.37
2020,CB2020,081,4,Queens,40196002005,71,41,30,1.28
2020,CB2020,081,4,Queens,40196002006,85,31,54,1.18
2020,CB2020,081,4,Queens,40196002007,71,42,29,1.79
2020,CB2020,081,4,Queens,40196002008,120,48,72,2.84
2020,CB2020,081,4,Queens,40198001000,114,64,50,1.76
2020,CB2020,081,4,Queens,40198001001,204,111,93,2.1
2020,CB2020,081,4,Queens,40198001002,143,65,78,2.11
2020,CB2020,081,4,Queens,40198001003,172,78,94,2.08
2020,CB2020,081,4,Queens,40198001004,164,88,76,2.35
2020,CB2020,081,4,Queens,40198001005,62,32,30,0.42
2020,CB2020,081,4,Queens,40198001006,179,92,87,2.02
2020,CB2020,081,4,Queens,40198001007,87,52,35,1.72
2020,CB2020,081,4,Queens,40198002000,155,80,75,2.69
2020,CB2020,081,4,Queens,40198002001,188,74,114,3.24
2020,CB2020,081,4,Queens,40198002002,226,107,119,2.2
2020,CB2020,081,4,Queens,40198002003,337,162,175,4.66
2020,CB2020,081,4,Queens,40198002004,145,96,49,2.33
2020,CB2020,081,4,Queens,40198002005,189,106,83,2.75
2020,CB2020,081,4,Queens,40198002006,150,67,83,1.97
2020,CB2020,081,4,Queens,40198002007,76,50,26,1.41
2020,CB2020,081,4,Queens,40198003000,171,66,105,2.11
2020,CB2020,081,4,Queens,40198003001,174,103,71,2.12
2020,CB2020,081,4,Queens,40198003002,147,81,66,2.11
2020,CB2020,081,4,Queens,40198003003,94,37,57,1.5
2020,CB2020,081,4,Queens,40198003004,75,43,32,1.47
2020,CB2020,081,4,Queens,40198003005,129,54,75,2.07
2020,CB2020,081,4,Queens,40198003006,160,99,61,2.06
2020,CB2020,081,4,Queens,40198003007,141,60,81,2.07
2020,CB2020,081,4,Queens,40199011000,0,0,0,1.2
2020,CB2020,081,4,Queens,40199011001,71,52,19,3.47
2020,CB2020,081,4,Queens,40199011002,0,0,0,0.63
2020,CB2020,081,4,Queens,40199011003,353,155,198,3.92
2020,CB2020,081,4,Queens,40199011004,128,64,64,2.79
2020,CB2020,081,4,Queens,40199011005,17,7,10,1.71
2020,CB2020,081,4,Queens,40199011006,29,17,12,1.66
2020,CB2020,081,4,Queens,40199011007,20,12,8,1.46
2020,CB2020,081,4,Queens,40199011008,53,25,28,1.95
2020,CB2020,081,4,Queens,40199011009,154,76,78,3.01
2020,CB2020,081,4,Queens,40199011010,38,30,8,2.75
2020,CB2020,081,4,Queens,40199012000,0,0,0,4.06
2020,CB2020,081,4,Queens,40199012001,0,0,0,4.06
2020,CB2020,081,4,Queens,40199012002,0,0,0,4.07
2020,CB2020,081,4,Queens,40199012003,12,9,3,4.05
2020,CB2020,081,4,Queens,40199012004,186,172,14,2
2020,CB2020,081,4,Queens,40199012005,15,8,7,2.07
2020,CB2020,081,4,Queens,40199012006,0,0,0,3.95
2020,CB2020,081,4,Queens,40199012007,0,0,0,3.3
2020,CB2020,081,4,Queens,40199012008,0,0,0,1.31
2020,CB2020,081,4,Queens,40199012009,0,0,0,3.13
2020,CB2020,081,4,Queens,40199012010,0,0,0,5.25
2020,CB2020,081,4,Queens,40199012011,0,0,0,4.59
2020,CB2020,081,4,Queens,40199012012,12,8,4,4.52
2020,CB2020,081,4,Queens,40199012013,0,0,0,2.67
2020,CB2020,081,4,Queens,40199012014,0,0,0,1.64
2020,CB2020,081,4,Queens,40199012015,0,0,0,1.46
2020,CB2020,081,4,Queens,40199012016,0,0,0,1.35
2020,CB2020,081,4,Queens,40199012017,0,0,0,0.94
2020,CB2020,081,4,Queens,40199021000,0,0,0,0.89
2020,CB2020,081,4,Queens,40199021001,0,0,0,2.5
2020,CB2020,081,4,Queens,40199021002,0,0,0,13.85
2020,CB2020,081,4,Queens,40199021003,0,0,0,0.54
2020,CB2020,081,4,Queens,40199021004,0,0,0,2.2
2020,CB2020,081,4,Queens,40199021005,0,0,0,7.4
2020,CB2020,081,4,Queens,40199021006,0,0,0,0
2020,CB2020,081,4,Queens,40199021007,0,0,0,0
2020,CB2020,081,4,Queens,40199021008,5,1,4,2.77
2020,CB2020,081,4,Queens,40199021009,301,139,162,1.07
2020,CB2020,081,4,Queens,40199021010,0,0,0,0
2020,CB2020,081,4,Queens,40199021011,0,0,0,16.85
2020,CB2020,081,4,Queens,40199021012,2,1,1,11.17
2020,CB2020,081,4,Queens,40199021013,0,0,0,2.05
2020,CB2020,081,4,Queens,40199021014,0,0,0,0.29
2020,CB2020,081,4,Queens,40199021015,0,0,0,0.35
2020,CB2020,081,4,Queens,40199021016,0,0,0,29.97
2020,CB2020,081,4,Queens,40199021017,0,0,0,0.28
2020,CB2020,081,4,Queens,40199021018,0,0,0,0
2020,CB2020,081,4,Queens,40199021019,6,2,4,19.31
2020,CB2020,081,4,Queens,40199021020,0,0,0,0.53
2020,CB2020,081,4,Queens,40199022000,1,0,1,4.04
2020,CB2020,081,4,Queens,40199022001,0,0,0,4.07
2020,CB2020,081,4,Queens,40199022002,0,0,0,4.07
2020,CB2020,081,4,Queens,40199022003,0,0,0,1.98
2020,CB2020,081,4,Queens,40199022004,0,0,0,1.97
2020,CB2020,081,4,Queens,40199022005,0,0,0,2.17
2020,CB2020,081,4,Queens,40199022006,0,0,0,2.65
2020,CB2020,081,4,Queens,40199022007,0,0,0,4.38
2020,CB2020,081,4,Queens,40199022008,0,0,0,4.81
2020,CB2020,081,4,Queens,40199022009,2,1,1,5.05
2020,CB2020,081,4,Queens,40199022010,0,0,0,4.81
2020,CB2020,081,4,Queens,40199022011,0,0,0,0.71
2020,CB2020,081,4,Queens,40199022012,0,0,0,1.25
2020,CB2020,081,4,Queens,40199022013,0,0,0,0.7
2020,CB2020,081,4,Queens,40199031000,0,0,0,153.42
2020,CB2020,081,4,Queens,40199031001,0,0,0,0.47
2020,CB2020,081,4,Queens,40199031002,0,0,0,2.32
2020,CB2020,081,4,Queens,40199031003,0,0,0,0.88
2020,CB2020,081,4,Queens,40199031004,0,0,0,1.12
2020,CB2020,081,4,Queens,40202001000,223,156,67,2.14
2020,CB2020,081,4,Queens,40202001001,56,16,40,1.01
2020,CB2020,081,4,Queens,40202001002,0,0,0,4.17
2020,CB2020,081,4,Queens,40202001003,0,0,0,2.38
2020,CB2020,081,4,Queens,40202001004,0,0,0,2.88
2020,CB2020,081,4,Queens,40202001005,124,62,62,1.98
2020,CB2020,081,4,Queens,40202001006,580,267,313,10.71
2020,CB2020,081,4,Queens,40202001007,278,135,143,3.58
2020,CB2020,081,4,Queens,40202001008,367,178,189,6.46
2020,CB2020,081,4,Queens,40202001009,65,44,21,2.55
2020,CB2020,081,4,Queens,40204001000,0,0,0,6.71
2020,CB2020,081,4,Queens,40204001001,0,0,0,1.5
2020,CB2020,081,4,Queens,40204001002,23,12,11,2.03
2020,CB2020,081,4,Queens,40204001003,47,14,33,2.62
2020,CB2020,081,4,Queens,40204001004,17,9,8,2.47
2020,CB2020,081,4,Queens,40204001005,65,31,34,2.38
2020,CB2020,081,4,Queens,40204001006,9,3,6,2.36
2020,CB2020,081,4,Queens,40204001007,28,14,14,4.6
2020,CB2020,081,4,Queens,40204001008,0,0,0,2.86
2020,CB2020,081,4,Queens,40204001009,0,0,0,3.31
2020,CB2020,081,4,Queens,40204001010,100,49,51,2.4
2020,CB2020,081,4,Queens,40204001011,56,28,28,2.49
2020,CB2020,081,4,Queens,40204001012,34,15,19,2.58
2020,CB2020,081,4,Queens,40204001013,145,88,57,2.42
2020,CB2020,081,4,Queens,40204001014,219,116,103,2.51
2020,CB2020,081,4,Queens,40204001015,194,71,123,2.47
2020,CB2020,081,4,Queens,40204001016,112,60,52,2.47
2020,CB2020,081,4,Queens,40204002000,86,29,57,2.52
2020,CB2020,081,4,Queens,40204002001,105,46,59,2.58
2020,CB2020,081,4,Queens,40204002002,135,65,70,2.63
2020,CB2020,081,4,Queens,40204002003,131,78,53,2.45
2020,CB2020,081,4,Queens,40204002004,165,78,87,2.47
2020,CB2020,081,4,Queens,40204002005,185,83,102,2.45
2020,CB2020,081,4,Queens,40204002006,87,46,41,2.52
2020,CB2020,081,4,Queens,40204002007,188,118,70,2.52
2020,CB2020,081,4,Queens,40204002008,147,56,91,2.51
2020,CB2020,081,4,Queens,40205001000,0,0,0,1.13
2020,CB2020,081,4,Queens,40205001001,0,0,0,13.96
2020,CB2020,081,4,Queens,40205001002,0,0,0,1.81
2020,CB2020,081,4,Queens,40205001003,35,24,11,2.48
2020,CB2020,081,4,Queens,40205001004,44,18,26,3.8
2020,CB2020,081,4,Queens,40205001005,17,9,8,4.72
2020,CB2020,081,4,Queens,40205001006,10,7,3,2.45
2020,CB2020,081,4,Queens,40205001007,14,3,11,2.29
2020,CB2020,081,4,Queens,40205001008,0,0,0,1.35
2020,CB2020,081,4,Queens,40205001009,0,0,0,7.41
2020,CB2020,081,4,Queens,40205001010,0,0,0,2.28
2020,CB2020,081,4,Queens,40205001011,37,16,21,2.41
2020,CB2020,081,4,Queens,40205001012,0,0,0,2.35
2020,CB2020,081,4,Queens,40205001013,0,0,0,0.51
2020,CB2020,081,4,Queens,40205001014,13,9,4,1.06
2020,CB2020,081,4,Queens,40205001015,0,0,0,0.54
2020,CB2020,081,4,Queens,40205001016,36,20,16,2.06
2020,CB2020,081,4,Queens,40205001017,0,0,0,10.66
2020,CB2020,081,4,Queens,40205001018,25,14,11,2.52
2020,CB2020,081,4,Queens,40205001019,0,0,0,2.16
2020,CB2020,081,4,Queens,40205001020,0,0,0,37.92
2020,CB2020,081,4,Queens,40205001021,0,0,0,1.14
2020,CB2020,081,4,Queens,40205001022,0,0,0,4.77
2020,CB2020,081,4,Queens,40205001023,0,0,0,3.46
2020,CB2020,081,4,Queens,40205001024,0,0,0,1.18
2020,CB2020,081,4,Queens,40205001025,0,0,0,10.47
2020,CB2020,081,4,Queens,40205002000,0,0,0,0.33
2020,CB2020,081,4,Queens,40205002001,86,35,51,5.8
2020,CB2020,081,4,Queens,40205002002,0,0,0,0.23
2020,CB2020,081,4,Queens,40205002003,0,0,0,0.13
2020,CB2020,081,4,Queens,40205002004,867,468,399,7.82
2020,CB2020,081,4,Queens,40205002005,0,0,0,3.99
2020,CB2020,081,4,Queens,40206001000,0,0,0,0.43
2020,CB2020,081,4,Queens,40206001001,0,0,0,3.34
2020,CB2020,081,4,Queens,40206001002,65,26,39,1.53
2020,CB2020,081,4,Queens,40206001003,279,136,143,2.75
2020,CB2020,081,4,Queens,40206001004,195,97,98,2.75
2020,CB2020,081,4,Queens,40206001005,215,129,86,2.64
2020,CB2020,081,4,Queens,40206001006,204,101,103,2.74
2020,CB2020,081,4,Queens,40206001007,206,88,118,1.67
2020,CB2020,081,4,Queens,40206001008,97,49,48,0.93
2020,CB2020,081,4,Queens,40206001009,280,153,127,4.62
2020,CB2020,081,4,Queens,40206001010,272,144,128,4.92
2020,CB2020,081,4,Queens,40206001011,62,27,35,1.1
2020,CB2020,081,4,Queens,40206001012,37,17,20,0.96
2020,CB2020,081,4,Queens,40206001013,32,8,24,1.45
2020,CB2020,081,4,Queens,40206001014,0,0,0,1.19
2020,CB2020,081,4,Queens,40206001015,55,35,20,2.69
2020,CB2020,081,4,Queens,40206001016,47,17,30,0.99
2020,CB2020,081,4,Queens,40208001000,0,0,0,3.43
2020,CB2020,081,4,Queens,40208001001,0,0,0,3.15
2020,CB2020,081,4,Queens,40208001002,0,0,0,2.98
2020,CB2020,081,4,Queens,40208001003,0,0,0,11.36
2020,CB2020,081,4,Queens,40208001004,0,0,0,5.41
2020,CB2020,081,4,Queens,40208001005,121,46,75,2.37
2020,CB2020,081,4,Queens,40208001006,34,15,19,2.99
2020,CB2020,081,4,Queens,40208001007,79,53,26,2.92
2020,CB2020,081,4,Queens,40208001008,276,115,161,5.03
2020,CB2020,081,4,Queens,40208001009,159,83,76,2.69
2020,CB2020,081,4,Queens,40208001010,277,115,162,2.7
2020,CB2020,081,4,Queens,40208001011,214,114,100,2.65
2020,CB2020,081,4,Queens,40208001012,173,90,83,2.76
2020,CB2020,081,4,Queens,40208001013,106,51,55,1.75
2020,CB2020,081,4,Queens,40208001014,0,0,0,2.04
2020,CB2020,081,4,Queens,40208001015,0,0,0,0.57
2020,CB2020,081,4,Queens,40208001016,0,0,0,0.54
2020,CB2020,081,4,Queens,40208001017,0,0,0,1.77
2020,CB2020,081,4,Queens,40208002000,0,0,0,4.01
2020,CB2020,081,4,Queens,40208002001,15,6,9,4.37
2020,CB2020,081,4,Queens,40208002002,0,0,0,8.37
2020,CB2020,081,4,Queens,40208002003,0,0,0,1.53
2020,CB2020,081,4,Queens,40208002004,0,0,0,4.42
2020,CB2020,081,4,Queens,40208002005,0,0,0,1.28
2020,CB2020,081,4,Queens,40208002006,38,15,23,7.44
2020,CB2020,081,4,Queens,40208002007,0,0,0,2.23
2020,CB2020,081,4,Queens,40208002008,78,30,48,3.22
2020,CB2020,081,4,Queens,40208002009,105,6,99,3.71
2020,CB2020,081,4,Queens,40208002010,613,265,348,2.97
2020,CB2020,081,4,Queens,40208002011,159,79,80,2.64
2020,CB2020,081,4,Queens,40208002012,65,25,40,2.63
2020,CB2020,081,4,Queens,40208002013,81,43,38,2.96
2020,CB2020,081,4,Queens,40208002014,66,35,31,3.12
2020,CB2020,081,4,Queens,40208002015,121,60,61,2.45
2020,CB2020,081,4,Queens,40208002016,0,0,0,2.21
2020,CB2020,081,4,Queens,40208002017,108,58,50,2.52
2020,CB2020,081,4,Queens,40208002018,82,53,29,2.81
2020,CB2020,081,4,Queens,40208002019,72,47,25,2.98
2020,CB2020,081,4,Queens,40208002020,197,93,104,2.7
2020,CB2020,081,4,Queens,40208002021,200,109,91,2.86
2020,CB2020,081,4,Queens,40208002022,74,19,55,3.02
2020,CB2020,081,4,Queens,40208002023,0,0,0,0.69
2020,CB2020,081,4,Queens,40212001000,32,15,17,1.96
2020,CB2020,081,4,Queens,40212001001,0,0,0,1.55
2020,CB2020,081,4,Queens,40212001002,29,15,14,1.49
2020,CB2020,081,4,Queens,40212001003,41,25,16,2.51
2020,CB2020,081,4,Queens,40212001004,28,18,10,1.66
2020,CB2020,081,4,Queens,40212001005,139,65,74,3.77
2020,CB2020,081,4,Queens,40212001006,297,170,127,3.71
2020,CB2020,081,4,Queens,40212001007,270,125,145,2.73
2020,CB2020,081,4,Queens,40212001008,54,36,18,2.12
2020,CB2020,081,4,Queens,40212001009,80,47,33,2.12
2020,CB2020,081,4,Queens,40212001010,43,26,17,2.78
2020,CB2020,081,4,Queens,40212001011,15,8,7,1.66
2020,CB2020,081,4,Queens,40212002000,147,69,78,1.95
2020,CB2020,081,4,Queens,40212002001,141,82,59,2.64
2020,CB2020,081,4,Queens,40212002002,154,71,83,3.27
2020,CB2020,081,4,Queens,40212002003,213,130,83,3.84
2020,CB2020,081,4,Queens,40212002004,25,8,17,2.86
2020,CB2020,081,4,Queens,40212002005,0,0,0,1.74
2020,CB2020,081,4,Queens,40212002006,197,85,112,2.94
2020,CB2020,081,4,Queens,40212002007,237,105,132,2.69
2020,CB2020,081,4,Queens,40212002008,598,297,301,2.68
2020,CB2020,081,4,Queens,40212002009,72,38,34,2.08
2020,CB2020,081,4,Queens,40212002010,0,0,0,2.1
2020,CB2020,081,4,Queens,40212002011,0,0,0,2.41
2020,CB2020,081,4,Queens,40214001000,1367,683,684,7.05
2020,CB2020,081,4,Queens,40214001001,870,420,450,6.3
2020,CB2020,081,4,Queens,40214002000,351,158,193,5.61
2020,CB2020,081,4,Queens,40214002001,38,19,19,1.22
2020,CB2020,081,4,Queens,40214002002,205,95,110,3.34
2020,CB2020,081,4,Queens,40214002003,0,0,0,0.89
2020,CB2020,081,4,Queens,40214002004,169,70,99,2.68
2020,CB2020,081,4,Queens,40214002005,0,0,0,1
2020,CB2020,081,4,Queens,40214002006,0,0,0,0.52
2020,CB2020,081,4,Queens,40214002007,102,78,24,1.18
2020,CB2020,081,4,Queens,40214002008,330,158,172,4.98
2020,CB2020,081,4,Queens,40214002009,0,0,0,0.45
2020,CB2020,081,4,Queens,40214002010,0,0,0,0.48
2020,CB2020,081,4,Queens,40214002011,417,163,254,3.52
2020,CB2020,081,4,Queens,40214003000,426,239,187,4.25
2020,CB2020,081,4,Queens,40214003001,356,227,129,4.52
2020,CB2020,081,4,Queens,40214003002,92,53,39,4.3
2020,CB2020,081,4,Queens,40214003003,0,0,0,1.35
2020,CB2020,081,4,Queens,40214003004,83,44,39,5.17
2020,CB2020,081,4,Queens,40214003005,33,19,14,2.16
2020,CB2020,081,4,Queens,40214003006,0,0,0,0.96
2020,CB2020,081,4,Queens,40214003007,0,0,0,0.66
2020,CB2020,081,4,Queens,40214003008,0,0,0,1.71
2020,CB2020,081,4,Queens,40214003009,156,75,81,4.04
2020,CB2020,081,4,Queens,40214003010,177,108,69,4.5
2020,CB2020,081,4,Queens,40214003011,335,170,165,4.36
2020,CB2020,081,4,Queens,40214003012,158,48,110,4.13
2020,CB2020,081,4,Queens,40214003013,316,156,160,3.9
2020,CB2020,081,4,Queens,40214003014,71,24,47,1.32
2020,CB2020,081,4,Queens,40214003015,183,148,35,1.66
2020,CB2020,081,4,Queens,40214003016,230,123,107,2.46
2020,CB2020,081,4,Queens,40214003017,208,95,113,3.41
2020,CB2020,081,4,Queens,40216011000,0,0,0,0.69
2020,CB2020,081,4,Queens,40216011001,0,0,0,1.18
2020,CB2020,081,4,Queens,40216011002,0,0,0,1.28
2020,CB2020,081,4,Queens,40216011003,0,0,0,4.33
2020,CB2020,081,4,Queens,40216011004,0,0,0,1.96
2020,CB2020,081,4,Queens,40216011005,0,0,0,2.86
2020,CB2020,081,4,Queens,40216011006,0,0,0,12.13
2020,CB2020,081,4,Queens,40216011007,363,188,175,3.74
2020,CB2020,081,4,Queens,40216011008,528,235,293,5.07
2020,CB2020,081,4,Queens,40216011009,1053,471,582,4.66
2020,CB2020,081,4,Queens,40216011010,734,367,367,2.65
2020,CB2020,081,4,Queens,40216012000,0,0,0,6.42
2020,CB2020,081,4,Queens,40216012001,0,0,0,1.84
2020,CB2020,081,4,Queens,40216013000,0,0,0,7.48
2020,CB2020,081,4,Queens,40216021000,245,112,133,3.8
2020,CB2020,081,4,Queens,40216021001,75,46,29,1.85
2020,CB2020,081,4,Queens,40216021002,182,86,96,1.19
2020,CB2020,081,4,Queens,40216021003,244,101,143,2.49
2020,CB2020,081,4,Queens,40216021004,169,74,95,3.04
2020,CB2020,081,4,Queens,40216021005,109,73,36,3.46
2020,CB2020,081,4,Queens,40216021006,0,0,0,0.47
2020,CB2020,081,4,Queens,40216021007,0,0,0,1.24
2020,CB2020,081,4,Queens,40216021008,0,0,0,1.54
2020,CB2020,081,4,Queens,40216021009,108,75,33,1.55
2020,CB2020,081,4,Queens,40216021010,35,15,20,0.8
2020,CB2020,081,4,Queens,40216021011,339,171,168,5.95
2020,CB2020,081,4,Queens,40216021012,0,0,0,0.34
2020,CB2020,081,4,Queens,40216031000,0,0,0,3.68
2020,CB2020,081,4,Queens,40216031001,0,0,0,0.24
2020,CB2020,081,4,Queens,40216031002,0,0,0,0.86
2020,CB2020,081,4,Queens,40216032000,0,0,0,70.06
2020,CB2020,081,4,Queens,40219001000,0,0,0,1.52
2020,CB2020,081,4,Queens,40219001001,0,0,0,2.88
2020,CB2020,081,4,Queens,40219001002,3,1,2,24.51
2020,CB2020,081,4,Queens,40219001003,0,0,0,5.07
2020,CB2020,081,4,Queens,40219001004,0,0,0,32.17
2020,CB2020,081,4,Queens,40219001005,0,0,0,7.82
2020,CB2020,081,4,Queens,40219001006,0,0,0,3.96
2020,CB2020,081,4,Queens,40219001007,7,6,1,66.95
2020,CB2020,081,4,Queens,40219001008,0,0,0,0
2020,CB2020,081,4,Queens,40219001009,0,0,0,23.97
2020,CB2020,081,4,Queens,40219001010,8,6,2,39.6
2020,CB2020,081,4,Queens,40219001011,0,0,0,2.23
2020,CB2020,081,4,Queens,40219001012,0,0,0,26.95
2020,CB2020,081,4,Queens,40219001013,0,0,0,7.8
2020,CB2020,081,4,Queens,40219001014,0,0,0,33.96
2020,CB2020,081,4,Queens,40219001015,0,0,0,8.25
2020,CB2020,081,4,Queens,40219001016,0,0,0,0
2020,CB2020,081,4,Queens,40219001017,0,0,0,0.21
2020,CB2020,081,4,Queens,40219001018,0,0,0,10.69
2020,CB2020,081,4,Queens,40219001019,2,0,2,11.7
2020,CB2020,081,4,Queens,40219001020,11,6,5,3.74
2020,CB2020,081,4,Queens,40219001021,0,0,0,1.49
2020,CB2020,081,4,Queens,40219001022,0,0,0,1.84
2020,CB2020,081,4,Queens,40220011000,0,0,0,3.21
2020,CB2020,081,4,Queens,40220011001,101,60,41,2.98
2020,CB2020,081,4,Queens,40220011002,63,38,25,3.03
2020,CB2020,081,4,Queens,40220011003,73,38,35,2.53
2020,CB2020,081,4,Queens,40220011004,84,31,53,2.63
2020,CB2020,081,4,Queens,40220011005,81,33,48,4.56
2020,CB2020,081,4,Queens,40220011006,67,28,39,1.59
2020,CB2020,081,4,Queens,40220011007,183,81,102,4.1
2020,CB2020,081,4,Queens,40220011008,119,72,47,2.66
2020,CB2020,081,4,Queens,40220012000,0,0,0,2.25
2020,CB2020,081,4,Queens,40220012001,0,0,0,1.6
2020,CB2020,081,4,Queens,40220012002,0,0,0,0.92
2020,CB2020,081,4,Queens,40220012003,534,267,267,4.23
2020,CB2020,081,4,Queens,40220012004,378,148,230,4.47
2020,CB2020,081,4,Queens,40220012005,613,235,378,3.84
2020,CB2020,081,4,Queens,40220012006,407,216,191,3.15
2020,CB2020,081,4,Queens,40220012007,470,225,245,3.66
2020,CB2020,081,4,Queens,40220012008,284,137,147,1.82
2020,CB2020,081,4,Queens,40220012009,0,0,0,0.27
2020,CB2020,081,4,Queens,40220013000,639,299,340,3.81
2020,CB2020,081,4,Queens,40220013001,501,204,297,3.36
2020,CB2020,081,4,Queens,40220013002,15,8,7,7.57
2020,CB2020,081,4,Queens,40220013003,0,0,0,9.49
2020,CB2020,081,4,Queens,40220013004,0,0,0,2.1
2020,CB2020,081,4,Queens,40220013005,0,0,0,0.23
2020,CB2020,081,4,Queens,40220013006,0,0,0,0.66
2020,CB2020,081,4,Queens,40220013007,0,0,0,1.31
2020,CB2020,081,4,Queens,40220013008,0,0,0,0.54
2020,CB2020,081,4,Queens,40220013009,20,6,14,0.9
2020,CB2020,081,4,Queens,40220013010,0,0,0,2.36
2020,CB2020,081,4,Queens,40220013011,0,0,0,0.54
2020,CB2020,081,4,Queens,40220013012,0,0,0,0.16
2020,CB2020,081,4,Queens,40220014000,1109,513,596,6.03
2020,CB2020,081,4,Queens,40220014001,440,208,232,3.22
2020,CB2020,081,4,Queens,40220014002,370,166,204,2
2020,CB2020,081,4,Queens,40220021000,0,0,0,2.37
2020,CB2020,081,4,Queens,40220021001,0,0,0,2.51
2020,CB2020,081,4,Queens,40220021002,232,121,111,4.43
2020,CB2020,081,4,Queens,40220021003,117,64,53,3.78
2020,CB2020,081,4,Queens,40220021004,46,22,24,1.96
2020,CB2020,081,4,Queens,40220021005,70,20,50,2.07
2020,CB2020,081,4,Queens,40220021006,83,49,34,3.87
2020,CB2020,081,4,Queens,40220021007,254,141,113,4.44
2020,CB2020,081,4,Queens,40220022000,206,135,71,4.92
2020,CB2020,081,4,Queens,40220022001,465,226,239,3.79
2020,CB2020,081,4,Queens,40220022002,660,307,353,6.66
2020,CB2020,081,4,Queens,40220022003,150,55,95,3.53
2020,CB2020,081,4,Queens,40220022004,194,109,85,4.62
2020,CB2020,081,4,Queens,40220023000,1193,582,611,9.58
2020,CB2020,081,4,Queens,40220023001,652,275,377,4.64
2020,CB2020,081,4,Queens,40220024000,0,0,0,0.64
2020,CB2020,081,4,Queens,40220024001,327,137,190,2.68
2020,CB2020,081,4,Queens,40220024002,880,411,469,6.76
2020,CB2020,081,4,Queens,40220024003,481,227,254,1.9
2020,CB2020,081,4,Queens,40220024004,0,0,0,0.26
2020,CB2020,081,4,Queens,40220024005,0,0,0,0.24
2020,CB2020,081,4,Queens,40229001000,0,0,0,107.08
2020,CB2020,081,4,Queens,40229001001,0,0,0,1.18
2020,CB2020,081,4,Queens,40229001002,0,0,0,2.16
2020,CB2020,081,4,Queens,40229001003,0,0,0,0.73
2020,CB2020,081,4,Queens,40229001004,0,0,0,86.12
2020,CB2020,081,4,Queens,40229001005,0,0,0,89.14
2020,CB2020,081,4,Queens,40229001006,0,0,0,12.42
2020,CB2020,081,4,Queens,40229001007,0,0,0,0.75
2020,CB2020,081,4,Queens,40229001008,0,0,0,1.55
2020,CB2020,081,4,Queens,40229001009,0,0,0,30.15
2020,CB2020,081,4,Queens,40230001000,234,132,102,4.11
2020,CB2020,081,4,Queens,40230001001,318,147,171,4.4
2020,CB2020,081,4,Queens,40230001002,143,53,90,2.89
2020,CB2020,081,4,Queens,40230001003,38,20,18,1.9
2020,CB2020,081,4,Queens,40230001004,120,73,47,3
2020,CB2020,081,4,Queens,40230001005,37,23,14,1.55
2020,CB2020,081,4,Queens,40230001006,51,27,24,1.52
2020,CB2020,081,4,Queens,40230001007,31,11,20,2.06
2020,CB2020,081,4,Queens,40230002000,38,27,11,1.83
2020,CB2020,081,4,Queens,40230002001,55,20,35,1.52
2020,CB2020,081,4,Queens,40230002002,46,14,32,1.55
2020,CB2020,081,4,Queens,40230002003,146,71,75,3.02
2020,CB2020,081,4,Queens,40230002004,206,114,92,4.83
2020,CB2020,081,4,Queens,40230002005,304,132,172,4.87
2020,CB2020,081,4,Queens,40230002006,113,66,47,1.92
2020,CB2020,081,4,Queens,40232001000,242,119,123,4.79
2020,CB2020,081,4,Queens,40232001001,575,261,314,6.64
2020,CB2020,081,4,Queens,40232002000,321,165,156,9.66
2020,CB2020,081,4,Queens,40232002001,1461,712,749,7.68
2020,CB2020,081,4,Queens,40232002002,348,165,183,4.31
2020,CB2020,081,4,Queens,40232003000,69,26,43,1.87
2020,CB2020,081,4,Queens,40232003001,183,124,59,2.78
2020,CB2020,081,4,Queens,40232003002,46,14,32,1.77
2020,CB2020,081,4,Queens,40232003003,163,59,104,2.78
2020,CB2020,081,4,Queens,40232003004,219,113,106,5.05
2020,CB2020,081,4,Queens,40232003005,727,342,385,21.05
2020,CB2020,081,4,Queens,40232003006,298,160,138,4.25
2020,CB2020,081,4,Queens,40232003007,295,143,152,4.4
2020,CB2020,081,4,Queens,40232003008,317,167,150,4.62
2020,CB2020,081,4,Queens,40235011000,1452,706,746,4.06
2020,CB2020,081,4,Queens,40235011001,445,234,211,4.55
2020,CB2020,081,4,Queens,40235011002,604,317,287,7.91
2020,CB2020,081,4,Queens,40235011003,0,0,0,1.9
2020,CB2020,081,4,Queens,40235011004,0,0,0,0.29
2020,CB2020,081,4,Queens,40235011005,0,0,0,0.5
2020,CB2020,081,4,Queens,40235011006,0,0,0,0.25
2020,CB2020,081,4,Queens,40235012000,114,48,66,2.15
2020,CB2020,081,4,Queens,40235012001,948,472,476,4.08
2020,CB2020,081,4,Queens,40235012002,130,84,46,4.37
2020,CB2020,081,4,Queens,40235012003,710,368,342,4.06
2020,CB2020,081,4,Queens,40235021000,0,0,0,4.73
2020,CB2020,081,4,Queens,40235021001,335,166,169,4.01
2020,CB2020,081,4,Queens,40235021002,1265,676,589,4.08
2020,CB2020,081,4,Queens,40235021003,498,251,247,3.61
2020,CB2020,081,4,Queens,40235021004,0,0,0,0.41
2020,CB2020,081,4,Queens,40235022000,35,12,23,1.32
2020,CB2020,081,4,Queens,40235022001,390,188,202,2.76
2020,CB2020,081,4,Queens,40235022002,264,134,130,4.05
2020,CB2020,081,4,Queens,40235022003,586,283,303,4.06
2020,CB2020,081,4,Queens,40236001000,262,151,111,4.48
2020,CB2020,081,4,Queens,40236001001,301,149,152,5.05
2020,CB2020,081,4,Queens,40236001002,24,13,11,0.5
2020,CB2020,081,4,Queens,40236001003,363,196,167,5.9
2020,CB2020,081,4,Queens,40236001004,144,60,84,7.28
2020,CB2020,081,4,Queens,40236002000,152,78,74,4.55
2020,CB2020,081,4,Queens,40236002001,435,225,210,5.24
2020,CB2020,081,4,Queens,40236002002,681,320,361,5.56
2020,CB2020,081,4,Queens,40236002003,904,431,473,4.99
2020,CB2020,081,4,Queens,40238001000,233,102,131,4.67
2020,CB2020,081,4,Queens,40238001001,665,357,308,5.46
2020,CB2020,081,4,Queens,40238002000,543,289,254,4.66
2020,CB2020,081,4,Queens,40238002001,438,220,218,2.86
2020,CB2020,081,4,Queens,40238002002,113,45,68,2.11
2020,CB2020,081,4,Queens,40238002003,238,130,108,3.38
2020,CB2020,081,4,Queens,40238003000,1952,952,1000,5.18
2020,CB2020,081,4,Queens,40238003001,0,0,0,3.23
2020,CB2020,081,4,Queens,40238004000,16,8,8,1.2
2020,CB2020,081,4,Queens,40238004001,129,77,52,1.22
2020,CB2020,081,4,Queens,40238004002,178,72,106,2.37
2020,CB2020,081,4,Queens,40238004003,358,178,180,2.39
2020,CB2020,081,4,Queens,40240001000,241,125,116,2.78
2020,CB2020,081,4,Queens,40240001001,268,155,113,4.33
2020,CB2020,081,4,Queens,40240001002,394,200,194,3.6
2020,CB2020,081,4,Queens,40240001003,363,174,189,3.25
2020,CB2020,081,4,Queens,40240001004,402,196,206,3.38
2020,CB2020,081,4,Queens,40240002000,1263,570,693,4.8
2020,CB2020,081,4,Queens,40240002001,49,16,33,13.87
2020,CB2020,081,4,Queens,40240002002,600,325,275,4.6
2020,CB2020,081,4,Queens,40240002003,399,179,220,2.45
2020,CB2020,081,4,Queens,40240002004,128,39,89,6.08
2020,CB2020,081,4,Queens,40240002005,0,0,0,4.28
2020,CB2020,081,4,Queens,40240002006,0,0,0,4.14
2020,CB2020,081,4,Queens,40240003000,974,478,496,4.46
2020,CB2020,081,4,Queens,40240003001,716,323,393,2.24
2020,CB2020,081,4,Queens,40240003002,455,232,223,2.36
2020,CB2020,081,4,Queens,40243001000,0,0,0,0.44
2020,CB2020,081,4,Queens,40243001001,0,0,0,0.66
2020,CB2020,081,4,Queens,40243001002,111,45,66,1.98
2020,CB2020,081,4,Queens,40243001003,15,10,5,0.74
2020,CB2020,081,4,Queens,40243001004,0,0,0,0.81
2020,CB2020,081,4,Queens,40243001005,0,0,0,0.4
2020,CB2020,081,4,Queens,40243001006,0,0,0,0.74
2020,CB2020,081,4,Queens,40243001007,0,0,0,0.32
2020,CB2020,081,4,Queens,40243001008,0,0,0,0.31
2020,CB2020,081,4,Queens,40243001009,23,12,11,0.56
2020,CB2020,081,4,Queens,40243001010,71,31,40,1.53
2020,CB2020,081,4,Queens,40243001011,168,89,79,2.33
2020,CB2020,081,4,Queens,40243001012,114,61,53,3.03
2020,CB2020,081,4,Queens,40243001013,174,87,87,3.12
2020,CB2020,081,4,Queens,40243001014,230,98,132,3.23
2020,CB2020,081,4,Queens,40243002000,192,87,105,3.04
2020,CB2020,081,4,Queens,40243002001,190,107,83,3.04
2020,CB2020,081,4,Queens,40243002002,235,110,125,3.09
2020,CB2020,081,4,Queens,40243002003,149,71,78,2.83
2020,CB2020,081,4,Queens,40243002004,0,0,0,4.82
2020,CB2020,081,4,Queens,40243002005,0,0,0,0.85
2020,CB2020,081,4,Queens,40243002006,38,19,19,3.06
2020,CB2020,081,4,Queens,40243002007,6,2,4,2.78
2020,CB2020,081,4,Queens,40243002008,0,0,0,2.14
2020,CB2020,081,4,Queens,40243002009,0,0,0,1.46
2020,CB2020,081,4,Queens,40243002010,0,0,0,1.44
2020,CB2020,081,4,Queens,40243002011,0,0,0,1.42
2020,CB2020,081,4,Queens,40243002012,0,0,0,2.97
2020,CB2020,081,4,Queens,40243002013,62,41,21,1.52
2020,CB2020,081,4,Queens,40243002014,115,77,38,2.43
2020,CB2020,081,4,Queens,40243002015,21,6,15,0.52
2020,CB2020,081,4,Queens,40243002016,0,0,0,13.95
2020,CB2020,081,4,Queens,40243003000,61,45,16,1.27
2020,CB2020,081,4,Queens,40243003001,204,99,105,1.96
2020,CB2020,081,4,Queens,40243003002,187,104,83,3.4
2020,CB2020,081,4,Queens,40243003003,176,67,109,3.16
2020,CB2020,081,4,Queens,40243003004,193,103,90,3.16
2020,CB2020,081,4,Queens,40243003005,227,115,112,3.05
2020,CB2020,081,4,Queens,40243003006,196,110,86,3.23
2020,CB2020,081,4,Queens,40243003007,130,70,60,2.62
2020,CB2020,081,4,Queens,40243003008,45,31,14,1.37
2020,CB2020,081,4,Queens,40243003009,103,57,46,1.63
2020,CB2020,081,4,Queens,40243003010,162,74,88,1.96
2020,CB2020,081,4,Queens,40243003011,239,112,127,2.54
2020,CB2020,081,4,Queens,40243004000,0,0,0,1.27
2020,CB2020,081,4,Queens,40243004001,491,261,230,4.69
2020,CB2020,081,4,Queens,40243004002,90,51,39,1.94
2020,CB2020,081,4,Queens,40243004003,0,0,0,1.91
2020,CB2020,081,4,Queens,40243004004,0,0,0,0.25
2020,CB2020,081,4,Queens,40243004005,16,4,12,0.17
2020,CB2020,081,4,Queens,40243004006,287,143,144,3.53
2020,CB2020,081,4,Queens,40243004007,236,128,108,2.65
2020,CB2020,081,4,Queens,40243004008,228,128,100,3.22
2020,CB2020,081,4,Queens,40243004009,157,63,94,1.98
2020,CB2020,081,4,Queens,40243004010,237,119,118,2.99
2020,CB2020,081,4,Queens,40243004011,242,108,134,2.99
2020,CB2020,081,4,Queens,40243004012,275,106,169,2.99
2020,CB2020,081,4,Queens,40243004013,135,71,64,1.97
2020,CB2020,081,4,Queens,40245001000,297,119,178,1.5
2020,CB2020,081,4,Queens,40245001001,1157,517,640,8.57
2020,CB2020,081,4,Queens,40245001002,624,277,347,3.8
2020,CB2020,081,4,Queens,40245001003,0,0,0,1.38
2020,CB2020,081,4,Queens,40245001004,0,0,0,0.4
2020,CB2020,081,4,Queens,40245001005,0,0,0,0.32
2020,CB2020,081,4,Queens,40245002000,329,142,187,3.15
2020,CB2020,081,4,Queens,40245002001,195,98,97,3.29
2020,CB2020,081,4,Queens,40245002002,634,299,335,4.23
2020,CB2020,081,4,Queens,40245002003,268,133,135,3.71
2020,CB2020,081,4,Queens,40245002004,136,80,56,3.3
2020,CB2020,081,4,Queens,40245003000,0,0,0,0.32
2020,CB2020,081,4,Queens,40245003001,81,37,44,2.02
2020,CB2020,081,4,Queens,40245003002,255,119,136,3.48
2020,CB2020,081,4,Queens,40245003003,432,183,249,6.5
2020,CB2020,081,4,Queens,40245003004,25,13,12,1.21
2020,CB2020,081,4,Queens,40245003005,0,0,0,0.28
2020,CB2020,081,4,Queens,40245003006,0,0,0,0.26
2020,CB2020,081,4,Queens,40245004000,127,67,60,1.53
2020,CB2020,081,4,Queens,40245004001,189,97,92,2.49
2020,CB2020,081,4,Queens,40245004002,369,183,186,3.37
2020,CB2020,081,4,Queens,40245004003,320,167,153,3.73
2020,CB2020,081,4,Queens,40245004004,84,44,40,1.94
2020,CB2020,081,4,Queens,40245004005,0,0,0,1.36
2020,CB2020,081,4,Queens,40245004006,22,10,12,1.53
2020,CB2020,081,4,Queens,40246001000,1,1,0,13.07
2020,CB2020,081,4,Queens,40246001001,0,0,0,13.06
2020,CB2020,081,4,Queens,40246001002,0,0,0,7.98
2020,CB2020,081,4,Queens,40246001003,0,0,0,9.39
2020,CB2020,081,4,Queens,40246001004,0,0,0,3.47
2020,CB2020,081,4,Queens,40246001005,0,0,0,5.21
2020,CB2020,081,4,Queens,40246001006,0,0,0,6.79
2020,CB2020,081,4,Queens,40246001007,0,0,0,10.94
2020,CB2020,081,4,Queens,40246001008,0,0,0,5.1
2020,CB2020,081,4,Queens,40247001000,331,173,158,4.93
2020,CB2020,081,4,Queens,40247001001,348,203,145,2.18
2020,CB2020,081,4,Queens,40247001002,108,7,101,1.74
2020,CB2020,081,4,Queens,40247001003,262,129,133,4.11
2020,CB2020,081,4,Queens,40247001004,0,0,0,0.46
2020,CB2020,081,4,Queens,40247001005,283,136,147,3.91
2020,CB2020,081,4,Queens,40247001006,31,19,12,2.54
2020,CB2020,081,4,Queens,40247001007,0,0,0,0.58
2020,CB2020,081,4,Queens,40247001008,21,13,8,0.84
2020,CB2020,081,4,Queens,40247001009,73,53,20,0.9
2020,CB2020,081,4,Queens,40247001010,80,44,36,1.8
2020,CB2020,081,4,Queens,40247001011,0,0,0,0.14
2020,CB2020,081,4,Queens,40249001000,532,259,273,4.31
2020,CB2020,081,4,Queens,40249001001,661,317,344,4.62
2020,CB2020,081,4,Queens,40249001002,868,432,436,5.09
2020,CB2020,081,4,Queens,40249001003,0,0,0,0.89
2020,CB2020,081,4,Queens,40249001004,0,0,0,0.92
2020,CB2020,081,4,Queens,40249001005,531,230,301,2.8
2020,CB2020,081,4,Queens,40249001006,197,90,107,1.43
2020,CB2020,081,4,Queens,40249001007,0,0,0,0.89
2020,CB2020,081,4,Queens,40249001008,0,0,0,0.73
2020,CB2020,081,4,Queens,40249002000,734,375,359,4.84
2020,CB2020,081,4,Queens,40249002001,336,140,196,2.18
2020,CB2020,081,4,Queens,40249002002,0,0,0,1.79
2020,CB2020,081,4,Queens,40249002003,0,0,0,0.75
2020,CB2020,081,4,Queens,40249002004,220,108,112,0.93
2020,CB2020,081,4,Queens,40249003000,300,146,154,4.39
2020,CB2020,081,4,Queens,40249003001,437,214,223,3.1
2020,CB2020,081,4,Queens,40249003002,46,16,30,1.89
2020,CB2020,081,4,Queens,40249003003,26,12,14,0.29
2020,CB2020,081,4,Queens,40249003004,254,120,134,3.45
2020,CB2020,081,4,Queens,40249003005,582,274,308,5.16
2020,CB2020,081,4,Queens,40251001000,240,107,133,2.82
2020,CB2020,081,4,Queens,40251001001,0,0,0,9.44
2020,CB2020,081,4,Queens,40251001002,1395,595,800,5.72
2020,CB2020,081,4,Queens,40251001003,221,113,108,1.93
2020,CB2020,081,4,Queens,40251001004,35,17,18,0.83
2020,CB2020,081,4,Queens,40251002000,278,129,149,4.61
2020,CB2020,081,4,Queens,40251002001,349,177,172,3.53
2020,CB2020,081,4,Queens,40251002002,262,116,146,2.66
2020,CB2020,081,4,Queens,40251002003,267,150,117,2.4
2020,CB2020,081,4,Queens,40251002004,0,0,0,0.73
2020,CB2020,081,4,Queens,40251002005,0,0,0,0.88
2020,CB2020,081,4,Queens,40251003000,197,89,108,0.42
2020,CB2020,081,4,Queens,40251003001,567,309,258,5.84
2020,CB2020,081,4,Queens,40251003002,497,225,272,5.22
2020,CB2020,081,4,Queens,40251003003,444,214,230,4.46
2020,CB2020,081,4,Queens,40251003004,0,0,0,0.78
2020,CB2020,081,4,Queens,40251003005,0,0,0,0.79
2020,CB2020,081,4,Queens,40251003006,0,0,0,0.84
2020,CB2020,081,4,Queens,40251004000,396,193,203,2.3
2020,CB2020,081,4,Queens,40251004001,219,113,106,1.52
2020,CB2020,081,4,Queens,40251004002,451,224,227,2.35
2020,CB2020,081,4,Queens,40251004003,0,0,0,0.63
2020,CB2020,081,4,Queens,40253011000,292,155,137,3.67
2020,CB2020,081,4,Queens,40253011001,673,298,375,3.67
2020,CB2020,081,4,Queens,40253012000,286,130,156,2.7
2020,CB2020,081,4,Queens,40253012001,785,412,373,3.52
2020,CB2020,081,4,Queens,40253012002,0,0,0,0.26
2020,CB2020,081,4,Queens,40253012003,0,0,0,0.46
2020,CB2020,081,4,Queens,40253012004,16,15,1,0.73
2020,CB2020,081,4,Queens,40253012005,0,0,0,0.75
2020,CB2020,081,4,Queens,40253013000,515,236,279,3.41
2020,CB2020,081,4,Queens,40253013001,620,283,337,3.56
2020,CB2020,081,4,Queens,40253013002,0,0,0,0.68
2020,CB2020,081,4,Queens,40253013003,0,0,0,0.66
2020,CB2020,081,4,Queens,40253014000,570,278,292,2.43
2020,CB2020,081,4,Queens,40253014001,567,265,302,3.67
2020,CB2020,081,4,Queens,40253014002,186,102,84,1.23
2020,CB2020,081,4,Queens,40253021000,781,384,397,3.19
2020,CB2020,081,4,Queens,40253021001,1012,480,532,4.99
2020,CB2020,081,4,Queens,40253022000,564,295,269,3.66
2020,CB2020,081,4,Queens,40253022001,0,0,0,1.77
2020,CB2020,081,4,Queens,40253022002,0,0,0,0.87
2020,CB2020,081,4,Queens,40253022003,177,97,80,3.6
2020,CB2020,081,4,Queens,40253022004,479,234,245,3.61
2020,CB2020,081,4,Queens,40253022005,0,0,0,0.81
2020,CB2020,081,4,Queens,40253022006,0,0,0,0.76
2020,CB2020,081,4,Queens,40253022007,0,0,0,1.01
2020,CB2020,081,4,Queens,40253022008,0,0,0,1.69
2020,CB2020,081,4,Queens,40254011000,27,18,9,2.63
2020,CB2020,081,4,Queens,40254011001,198,108,90,3.86
2020,CB2020,081,4,Queens,40254011002,372,202,170,3.33
2020,CB2020,081,4,Queens,40254011003,148,59,89,2.75
2020,CB2020,081,4,Queens,40254011004,151,61,90,2.28
2020,CB2020,081,4,Queens,40254011005,80,27,53,1.43
2020,CB2020,081,4,Queens,40254011006,119,77,42,0.89
2020,CB2020,081,4,Queens,40254011007,393,165,228,3.92
2020,CB2020,081,4,Queens,40254011008,335,158,177,3.95
2020,CB2020,081,4,Queens,40254011009,356,182,174,3.94
2020,CB2020,081,4,Queens,40254011010,175,104,71,3.27
2020,CB2020,081,4,Queens,40254012000,205,82,123,3.19
2020,CB2020,081,4,Queens,40254012001,0,0,0,7.91
2020,CB2020,081,4,Queens,40254012002,96,42,54,2.1
2020,CB2020,081,4,Queens,40254012003,118,67,51,2.57
2020,CB2020,081,4,Queens,40254012004,284,157,127,2.47
2020,CB2020,081,4,Queens,40254012005,205,91,114,2.52
2020,CB2020,081,4,Queens,40254012006,261,123,138,2.69
2020,CB2020,081,4,Queens,40254012007,91,54,37,0.76
2020,CB2020,081,4,Queens,40254012008,74,24,50,0.7
2020,CB2020,081,4,Queens,40254012009,211,98,113,5.12
2020,CB2020,081,4,Queens,40254021000,0,0,0,0.6
2020,CB2020,081,4,Queens,40254021001,0,0,0,1.1
2020,CB2020,081,4,Queens,40254021002,0,0,0,0.65
2020,CB2020,081,4,Queens,40254021003,146,81,65,9.93
2020,CB2020,081,4,Queens,40254021004,322,176,146,4.45
2020,CB2020,081,4,Queens,40254021005,394,194,200,4.17
2020,CB2020,081,4,Queens,40254021006,324,150,174,3.09
2020,CB2020,081,4,Queens,40254021007,375,144,231,4.03
2020,CB2020,081,4,Queens,40254021008,98,45,53,2.85
2020,CB2020,081,4,Queens,40254021009,284,111,173,3.74
2020,CB2020,081,4,Queens,40254021010,177,67,110,2.4
2020,CB2020,081,4,Queens,40254022000,249,112,137,3.76
2020,CB2020,081,4,Queens,40254022001,233,121,112,3.94
2020,CB2020,081,4,Queens,40254022002,305,160,145,4.41
2020,CB2020,081,4,Queens,40254022003,273,112,161,4.51
2020,CB2020,081,4,Queens,40254022004,237,92,145,5.77
2020,CB2020,081,4,Queens,40254022005,238,129,109,5.41
2020,CB2020,081,4,Queens,40254022006,324,153,171,5.43
2020,CB2020,081,4,Queens,40254023000,391,161,230,3.92
2020,CB2020,081,4,Queens,40254023001,767,308,459,8.59
2020,CB2020,081,4,Queens,40254023002,315,133,182,3.38
2020,CB2020,081,4,Queens,40254023003,395,145,250,3.83
2020,CB2020,081,4,Queens,40254023004,333,133,200,3.99
2020,CB2020,081,4,Queens,40255001000,0,0,0,1.61
2020,CB2020,081,4,Queens,40255001001,0,0,0,0.58
2020,CB2020,081,4,Queens,40255001002,0,0,0,4.88
2020,CB2020,081,4,Queens,40255001003,0,0,0,8.03
2020,CB2020,081,4,Queens,40255001004,0,0,0,3.25
2020,CB2020,081,4,Queens,40255001005,59,22,37,1.98
2020,CB2020,081,4,Queens,40255001006,37,23,14,2.34
2020,CB2020,081,4,Queens,40255001007,44,27,17,2.76
2020,CB2020,081,4,Queens,40255001008,31,22,9,4.57
2020,CB2020,081,4,Queens,40255001009,61,40,21,1.59
2020,CB2020,081,4,Queens,40255001010,136,60,76,3.88
2020,CB2020,081,4,Queens,40255001011,140,53,87,5.16
2020,CB2020,081,4,Queens,40255001012,92,35,57,2.09
2020,CB2020,081,4,Queens,40255001013,280,139,141,3.73
2020,CB2020,081,4,Queens,40255001014,208,125,83,2.89
2020,CB2020,081,4,Queens,40255001015,515,256,259,4.59
2020,CB2020,081,4,Queens,40257001000,263,125,138,3.38
2020,CB2020,081,4,Queens,40257001001,83,35,48,3.79
2020,CB2020,081,4,Queens,40257001002,0,0,0,2.69
2020,CB2020,081,4,Queens,40257001003,151,75,76,4.3
2020,CB2020,081,4,Queens,40257001004,180,95,85,4.07
2020,CB2020,081,4,Queens,40257001005,159,100,59,3.81
2020,CB2020,081,4,Queens,40257001006,0,0,0,3.26
2020,CB2020,081,4,Queens,40257001007,0,0,0,1.41
2020,CB2020,081,4,Queens,40257001008,273,140,133,5.11
2020,CB2020,081,4,Queens,40257001009,520,258,262,5.08
2020,CB2020,081,4,Queens,40257001010,19,3,16,0.33
2020,CB2020,081,4,Queens,40258001000,35,27,8,1.27
2020,CB2020,081,4,Queens,40258001001,0,0,0,0.77
2020,CB2020,081,4,Queens,40258001002,0,0,0,0.77
2020,CB2020,081,4,Queens,40258001003,0,0,0,1.6
2020,CB2020,081,4,Queens,40258001004,265,108,157,5.48
2020,CB2020,081,4,Queens,40258001005,65,14,51,5.68
2020,CB2020,081,4,Queens,40258001006,136,57,79,3.55
2020,CB2020,081,4,Queens,40258001007,94,45,49,3.1
2020,CB2020,081,4,Queens,40258001008,157,74,83,3.22
2020,CB2020,081,4,Queens,40258001009,114,67,47,1.62
2020,CB2020,081,4,Queens,40258001010,65,37,28,2.04
2020,CB2020,081,4,Queens,40258001011,192,80,112,3.47
2020,CB2020,081,4,Queens,40258001012,203,76,127,4.27
2020,CB2020,081,4,Queens,40258002000,277,132,145,3.8
2020,CB2020,081,4,Queens,40258002001,190,76,114,3.93
2020,CB2020,081,4,Queens,40258002002,237,123,114,3.94
2020,CB2020,081,4,Queens,40258002003,259,122,137,3.83
2020,CB2020,081,4,Queens,40259001000,348,157,191,2.93
2020,CB2020,081,4,Queens,40259001001,59,37,22,0.77
2020,CB2020,081,4,Queens,40259001002,0,0,0,0.45
2020,CB2020,081,4,Queens,40259001003,291,138,153,3.68
2020,CB2020,081,4,Queens,40259001004,220,100,120,3.45
2020,CB2020,081,4,Queens,40259001005,195,100,95,3.27
2020,CB2020,081,4,Queens,40259001006,190,85,105,4.18
2020,CB2020,081,4,Queens,40259001007,391,226,165,4.1
2020,CB2020,081,4,Queens,40259001008,227,122,105,4.1
2020,CB2020,081,4,Queens,40259001009,68,34,34,1.11
2020,CB2020,081,4,Queens,40259001010,81,41,40,1.1
2020,CB2020,081,4,Queens,40259001011,65,25,40,1.14
2020,CB2020,081,4,Queens,40259002000,178,82,96,2.82
2020,CB2020,081,4,Queens,40259002001,1099,556,543,11.55
2020,CB2020,081,4,Queens,40259002002,18,8,10,0.46
2020,CB2020,081,4,Queens,40259002003,112,55,57,1.13
2020,CB2020,081,4,Queens,40260001000,177,83,94,4.41
2020,CB2020,081,4,Queens,40260001001,407,190,217,4.41
2020,CB2020,081,4,Queens,40260001002,0,0,0,5.42
2020,CB2020,081,4,Queens,40260001003,727,281,446,7.16
2020,CB2020,081,4,Queens,40260002000,141,67,74,3.63
2020,CB2020,081,4,Queens,40260002001,303,159,144,3.96
2020,CB2020,081,4,Queens,40260002002,240,106,134,3.92
2020,CB2020,081,4,Queens,40260002003,208,109,99,2.29
2020,CB2020,081,4,Queens,40260002004,197,96,101,2.26
2020,CB2020,081,4,Queens,40260002005,56,38,18,0.72
2020,CB2020,081,4,Queens,40260002006,117,48,69,1.53
2020,CB2020,081,4,Queens,40260002007,131,43,88,0.8
2020,CB2020,081,4,Queens,40260002008,63,42,21,1.4
2020,CB2020,081,4,Queens,40260002009,148,62,86,2.18
2020,CB2020,081,4,Queens,40261001000,655,334,321,1.95
2020,CB2020,081,4,Queens,40261001001,213,112,101,2.26
2020,CB2020,081,4,Queens,40261001002,384,178,206,2.53
2020,CB2020,081,4,Queens,40261001003,331,177,154,3.47
2020,CB2020,081,4,Queens,40261002000,651,338,313,5.23
2020,CB2020,081,4,Queens,40261002001,1361,689,672,6.34
2020,CB2020,081,4,Queens,40261003000,1200,575,625,5.2
2020,CB2020,081,4,Queens,40261003001,806,383,423,5.22
2020,CB2020,081,4,Queens,40261004000,83,63,20,0.79
2020,CB2020,081,4,Queens,40261004001,116,54,62,1.56
2020,CB2020,081,4,Queens,40261004002,352,180,172,2.31
2020,CB2020,081,4,Queens,40261004003,260,128,132,3.85
2020,CB2020,081,4,Queens,40261004004,167,99,68,2.88
2020,CB2020,081,4,Queens,40261004005,655,320,335,4.81
2020,CB2020,081,4,Queens,40261004006,26,14,12,2.87
2020,CB2020,081,4,Queens,40261004007,542,277,265,3.47
2020,CB2020,081,4,Queens,40262001000,121,56,65,4.39
2020,CB2020,081,4,Queens,40262001001,310,153,157,5.28
2020,CB2020,081,4,Queens,40262001002,218,122,96,3.48
2020,CB2020,081,4,Queens,40262001003,45,16,29,1.56
2020,CB2020,081,4,Queens,40262001004,97,54,43,2.51
2020,CB2020,081,4,Queens,40262001005,155,72,83,3.12
2020,CB2020,081,4,Queens,40262001006,236,105,131,3.91
2020,CB2020,081,4,Queens,40262001007,126,77,49,3.78
2020,CB2020,081,4,Queens,40262001008,153,71,82,2.36
2020,CB2020,081,4,Queens,40262001009,135,43,92,2.53
2020,CB2020,081,4,Queens,40262001010,31,7,24,1.22
2020,CB2020,081,4,Queens,40262001011,25,11,14,1.3
2020,CB2020,081,4,Queens,40263001000,22,18,4,1.68
2020,CB2020,081,4,Queens,40263001001,0,0,0,0.48
2020,CB2020,081,4,Queens,40263001002,201,111,90,1.16
2020,CB2020,081,4,Queens,40263001003,285,165,120,1.67
2020,CB2020,081,4,Queens,40263001004,422,213,209,3.27
2020,CB2020,081,4,Queens,40263001005,0,0,0,0.89
2020,CB2020,081,4,Queens,40263001006,0,0,0,1.8
2020,CB2020,081,4,Queens,40263001007,117,52,65,1.4
2020,CB2020,081,4,Queens,40263001008,264,127,137,4.21
2020,CB2020,081,4,Queens,40263001009,481,243,238,2.82
2020,CB2020,081,4,Queens,40263002000,202,81,121,2.04
2020,CB2020,081,4,Queens,40263002001,624,314,310,3.76
2020,CB2020,081,4,Queens,40263002002,467,257,210,3.77
2020,CB2020,081,4,Queens,40263002003,617,278,339,3.48
2020,CB2020,081,4,Queens,40263002004,578,299,279,3.19
2020,CB2020,081,4,Queens,40263002005,367,184,183,2.95
2020,CB2020,081,4,Queens,40263002006,204,84,120,1.94
2020,CB2020,081,4,Queens,40263003000,868,418,450,6.07
2020,CB2020,081,4,Queens,40263003001,270,141,129,1.09
2020,CB2020,081,4,Queens,40263003002,642,346,296,3.68
2020,CB2020,081,4,Queens,40264001000,118,60,58,2.98
2020,CB2020,081,4,Queens,40264001001,127,53,74,3.35
2020,CB2020,081,4,Queens,40264001002,104,47,57,2.12
2020,CB2020,081,4,Queens,40264001003,182,76,106,3.25
2020,CB2020,081,4,Queens,40264001004,99,58,41,2.83
2020,CB2020,081,4,Queens,40264001005,349,169,180,8.55
2020,CB2020,081,4,Queens,40264001006,119,57,62,2.46
2020,CB2020,081,4,Queens,40264001007,79,38,41,2.58
2020,CB2020,081,4,Queens,40264001008,84,27,57,2.42
2020,CB2020,081,4,Queens,40264002000,151,105,46,4.34
2020,CB2020,081,4,Queens,40264002001,257,118,139,6.04
2020,CB2020,081,4,Queens,40264002002,140,54,86,3.83
2020,CB2020,081,4,Queens,40264002003,331,158,173,6.31
2020,CB2020,081,4,Queens,40264002004,92,38,54,2.14
2020,CB2020,081,4,Queens,40264002005,214,88,126,3.27
2020,CB2020,081,4,Queens,40264002006,146,54,92,2.73
2020,CB2020,081,4,Queens,40264002007,144,49,95,3.68
2020,CB2020,081,4,Queens,40265011000,374,203,171,2.71
2020,CB2020,081,4,Queens,40265011001,879,452,427,5.17
2020,CB2020,081,4,Queens,40265011002,234,115,119,1.73
2020,CB2020,081,4,Queens,40265012000,25,8,17,0.53
2020,CB2020,081,4,Queens,40265012001,0,0,0,0.26
2020,CB2020,081,4,Queens,40265012002,29,20,9,2.16
2020,CB2020,081,4,Queens,40265012003,247,149,98,4.18
2020,CB2020,081,4,Queens,40265012004,36,28,8,2.06
2020,CB2020,081,4,Queens,40265012005,959,536,423,4.87
2020,CB2020,081,4,Queens,40265012006,287,139,148,1.7
2020,CB2020,081,4,Queens,40265012007,143,60,83,1.24
2020,CB2020,081,4,Queens,40265021000,55,28,27,2.5
2020,CB2020,081,4,Queens,40265021001,0,0,0,0.75
2020,CB2020,081,4,Queens,40265021002,0,0,0,0.29
2020,CB2020,081,4,Queens,40265021003,670,354,316,4.3
2020,CB2020,081,4,Queens,40265021004,667,352,315,3.83
2020,CB2020,081,4,Queens,40265021005,0,0,0,2.44
2020,CB2020,081,4,Queens,40265021006,191,99,92,2.15
2020,CB2020,081,4,Queens,40265021007,0,0,0,0.34
2020,CB2020,081,4,Queens,40265021008,0,0,0,0.21
2020,CB2020,081,4,Queens,40265021009,39,21,18,0.44
2020,CB2020,081,4,Queens,40266001000,23,12,11,2.92
2020,CB2020,081,4,Queens,40266001001,125,56,69,3.9
2020,CB2020,081,4,Queens,40266001002,213,93,120,3.93
2020,CB2020,081,4,Queens,40266001003,194,113,81,3.99
2020,CB2020,081,4,Queens,40266001004,140,62,78,3.95
2020,CB2020,081,4,Queens,40266001005,182,55,127,1.46
2020,CB2020,081,4,Queens,40266001006,232,103,129,3.17
2020,CB2020,081,4,Queens,40266001007,164,56,108,3.16
2020,CB2020,081,4,Queens,40266001008,45,15,30,5.95
2020,CB2020,081,4,Queens,40266001009,192,64,128,1.59
2020,CB2020,081,4,Queens,40266001010,290,120,170,4.5
2020,CB2020,081,4,Queens,40266001011,149,101,48,4.22
2020,CB2020,081,4,Queens,40267001000,1377,718,659,3.61
2020,CB2020,081,4,Queens,40267001001,690,374,316,4.08
2020,CB2020,081,4,Queens,40267001002,397,196,201,3.45
2020,CB2020,081,4,Queens,40267002000,23,15,8,9.6
2020,CB2020,081,4,Queens,40267002001,0,0,0,0.86
2020,CB2020,081,4,Queens,40267002002,597,302,295,3.26
2020,CB2020,081,4,Queens,40267002003,563,271,292,4.2
2020,CB2020,081,4,Queens,40267002004,0,0,0,0.99
2020,CB2020,081,4,Queens,40267002005,0,0,0,2.2
2020,CB2020,081,4,Queens,40267003000,334,168,166,3.14
2020,CB2020,081,4,Queens,40267003001,187,99,88,2.16
2020,CB2020,081,4,Queens,40267003002,17,10,7,1
2020,CB2020,081,4,Queens,40267003003,436,217,219,2.6
2020,CB2020,081,4,Queens,40267003004,141,72,69,1.43
2020,CB2020,081,4,Queens,40267003005,0,0,0,0.29
2020,CB2020,081,4,Queens,40267003006,707,359,348,4.52
2020,CB2020,081,4,Queens,40267003007,727,381,346,4.46
2020,CB2020,081,4,Queens,40269011000,0,0,0,0.32
2020,CB2020,081,4,Queens,40269011001,37,28,9,0.61
2020,CB2020,081,4,Queens,40269011002,495,210,285,3.8
2020,CB2020,081,4,Queens,40269011003,1015,546,469,3.62
2020,CB2020,081,4,Queens,40269011004,75,28,47,1.58
2020,CB2020,081,4,Queens,40269012000,1304,632,672,5.03
2020,CB2020,081,4,Queens,40269013000,1620,848,772,5.14
2020,CB2020,081,4,Queens,40269014000,0,0,0,0.87
2020,CB2020,081,4,Queens,40269014001,206,113,93,2.73
2020,CB2020,081,4,Queens,40269014002,458,252,206,4.53
2020,CB2020,081,4,Queens,40269021000,325,176,149,2.42
2020,CB2020,081,4,Queens,40269021001,337,178,159,2.26
2020,CB2020,081,4,Queens,40269021002,940,476,464,2.25
2020,CB2020,081,4,Queens,40269021003,531,264,267,2.25
2020,CB2020,081,4,Queens,40269022000,626,279,347,2.55
2020,CB2020,081,4,Queens,40269022001,486,234,252,2.45
2020,CB2020,081,4,Queens,40269022002,330,170,160,2.5
2020,CB2020,081,4,Queens,40269022003,669,326,343,2.71
2020,CB2020,081,4,Queens,40270001000,50,33,17,5.14
2020,CB2020,081,4,Queens,40270001001,105,32,73,2.38
2020,CB2020,081,4,Queens,40270001002,111,50,61,2.24
2020,CB2020,081,4,Queens,40270001003,28,21,7,0.96
2020,CB2020,081,4,Queens,40270001004,258,109,149,5.83
2020,CB2020,081,4,Queens,40270001005,247,121,126,4.68
2020,CB2020,081,4,Queens,40270001006,201,112,89,3.98
2020,CB2020,081,4,Queens,40270001007,163,76,87,4.12
2020,CB2020,081,4,Queens,40270001008,62,15,47,2.02
2020,CB2020,081,4,Queens,40270001009,36,26,10,1.06
2020,CB2020,081,4,Queens,40270001010,66,29,37,1.16
2020,CB2020,081,4,Queens,40270001011,115,43,72,2.24
2020,CB2020,081,4,Queens,40270001012,121,50,71,3.15
2020,CB2020,081,4,Queens,40270001013,22,17,5,0.84
2020,CB2020,081,4,Queens,40270001014,111,65,46,1.22
2020,CB2020,081,4,Queens,40270001015,83,41,42,1.5
2020,CB2020,081,4,Queens,40270001016,76,38,38,1.84
2020,CB2020,081,4,Queens,40270001017,105,44,61,1.38
2020,CB2020,081,4,Queens,40271011000,568,317,251,3.65
2020,CB2020,081,4,Queens,40271011001,620,297,323,3.68
2020,CB2020,081,4,Queens,40271011002,848,454,394,3.69
2020,CB2020,081,4,Queens,40271012000,1107,531,576,4.62
2020,CB2020,081,4,Queens,40271013000,2311,1090,1221,6.58
2020,CB2020,081,4,Queens,40271021000,1382,652,730,5.29
2020,CB2020,081,4,Queens,40271022000,884,452,432,3.35
2020,CB2020,081,4,Queens,40271022001,846,417,429,3.45
2020,CB2020,081,4,Queens,40272001000,159,73,86,4.67
2020,CB2020,081,4,Queens,40272001001,148,68,80,3.21
2020,CB2020,081,4,Queens,40272001002,185,88,97,3.34
2020,CB2020,081,4,Queens,40272001003,223,65,158,3.95
2020,CB2020,081,4,Queens,40272001004,267,133,134,4.86
2020,CB2020,081,4,Queens,40272002000,329,150,179,5.6
2020,CB2020,081,4,Queens,40272002001,383,181,202,6.03
2020,CB2020,081,4,Queens,40272002002,371,150,221,6.31
2020,CB2020,081,4,Queens,40273011000,26,16,10,2.7
2020,CB2020,081,4,Queens,40273011001,384,197,187,2.63
2020,CB2020,081,4,Queens,40273011002,820,461,359,5.48
2020,CB2020,081,4,Queens,40273011003,737,414,323,4.47
2020,CB2020,081,4,Queens,40273012000,1161,601,560,4.46
2020,CB2020,081,4,Queens,40273012001,0,0,0,0.65
2020,CB2020,081,4,Queens,40273012002,545,308,237,3.97
2020,CB2020,081,4,Queens,40273021000,508,215,293,3.78
2020,CB2020,081,4,Queens,40273021001,0,0,0,4.02
2020,CB2020,081,4,Queens,40273021002,256,119,137,4.27
2020,CB2020,081,4,Queens,40273022000,801,356,445,3.76
2020,CB2020,081,4,Queens,40273022001,814,390,424,2.79
2020,CB2020,081,4,Queens,40273023000,855,447,408,5.47
2020,CB2020,081,4,Queens,40273023001,1531,760,771,4.74
2020,CB2020,081,4,Queens,40274001000,232,130,102,4.55
2020,CB2020,081,4,Queens,40274001001,235,115,120,3.73
2020,CB2020,081,4,Queens,40274001002,269,131,138,4.23
2020,CB2020,081,4,Queens,40274001003,289,155,134,4.98
2020,CB2020,081,4,Queens,40274001004,277,113,164,5.52
2020,CB2020,081,4,Queens,40274001005,220,64,156,4.23
2020,CB2020,081,4,Queens,40274001006,205,76,129,4.2
2020,CB2020,081,4,Queens,40274001007,200,93,107,4.07
2020,CB2020,081,4,Queens,40275001000,706,317,389,4.01
2020,CB2020,081,4,Queens,40275001001,778,351,427,4.01
2020,CB2020,081,4,Queens,40275002000,1010,507,503,4.28
2020,CB2020,081,4,Queens,40275002001,795,432,363,4.27
2020,CB2020,081,4,Queens,40275002002,795,439,356,4.48
2020,CB2020,081,4,Queens,40275003000,628,364,264,4.47
2020,CB2020,081,4,Queens,40275003001,639,341,298,4.48
2020,CB2020,081,4,Queens,40275003002,581,309,272,3.89
2020,CB2020,081,4,Queens,40275003003,122,82,40,1.81
2020,CB2020,081,4,Queens,40275003004,126,49,77,1.14
2020,CB2020,081,4,Queens,40275003005,432,218,214,3.49
2020,CB2020,081,4,Queens,40275003006,161,99,62,2.83
2020,CB2020,081,4,Queens,40275003007,0,0,0,0.73
2020,CB2020,081,4,Queens,40276001000,138,52,86,3.72
2020,CB2020,081,4,Queens,40276001001,26,12,14,7.21
2020,CB2020,081,4,Queens,40276001002,0,0,0,3.29
2020,CB2020,081,4,Queens,40276001003,209,88,121,3.09
2020,CB2020,081,4,Queens,40276001004,122,47,75,2.73
2020,CB2020,081,4,Queens,40276001005,167,72,95,3.56
2020,CB2020,081,4,Queens,40276001006,0,0,0,0.76
2020,CB2020,081,4,Queens,40276001007,159,94,65,3.74
2020,CB2020,081,4,Queens,40276001008,180,83,97,3.68
2020,CB2020,081,4,Queens,40276001009,194,99,95,3.71
2020,CB2020,081,4,Queens,40276001010,170,79,91,3.73
2020,CB2020,081,4,Queens,40277011000,929,508,421,4.46
2020,CB2020,081,4,Queens,40277011001,555,314,241,4.65
2020,CB2020,081,4,Queens,40277012000,710,345,365,4.48
2020,CB2020,081,4,Queens,40277012001,1254,637,617,4.79
2020,CB2020,081,4,Queens,40277021000,723,350,373,4.02
2020,CB2020,081,4,Queens,40277022000,862,443,419,4.01
2020,CB2020,081,4,Queens,40277022001,461,215,246,4
2020,CB2020,081,4,Queens,40277022002,722,346,376,4.26
2020,CB2020,081,4,Queens,40277023000,1318,670,648,4.27
2020,CB2020,081,4,Queens,40277023001,1110,551,559,4.27
2020,CB2020,081,4,Queens,40278001000,51,25,26,3.95
2020,CB2020,081,4,Queens,40278001001,186,86,100,3.94
2020,CB2020,081,4,Queens,40278001002,173,71,102,3.22
2020,CB2020,081,4,Queens,40278001003,311,207,104,6.06
2020,CB2020,081,4,Queens,40278001004,100,56,44,2.32
2020,CB2020,081,4,Queens,40278001005,198,76,122,3.83
2020,CB2020,081,4,Queens,40278002000,427,167,260,8.03
2020,CB2020,081,4,Queens,40278002001,1083,431,652,12
2020,CB2020,081,4,Queens,40279001000,345,162,183,4.02
2020,CB2020,081,4,Queens,40279001001,358,178,180,4.01
2020,CB2020,081,4,Queens,40279001002,388,201,187,4.25
2020,CB2020,081,4,Queens,40279001003,526,238,288,4.26
2020,CB2020,081,4,Queens,40279002000,620,295,325,4.48
2020,CB2020,081,4,Queens,40279002001,661,333,328,4.49
2020,CB2020,081,4,Queens,40279002002,1335,689,646,4.5
2020,CB2020,081,4,Queens,40279003000,824,419,405,4.64
2020,CB2020,081,4,Queens,40279003001,597,273,324,4.64
2020,CB2020,081,4,Queens,40279004000,704,325,379,4.48
2020,CB2020,081,4,Queens,40280001000,136,53,83,5.43
2020,CB2020,081,4,Queens,40280001001,231,83,148,3.93
2020,CB2020,081,4,Queens,40280001002,201,97,104,3.96
2020,CB2020,081,4,Queens,40280001003,179,100,79,4.09
2020,CB2020,081,4,Queens,40280001004,156,83,73,3.95
2020,CB2020,081,4,Queens,40280001005,165,104,61,3.87
2020,CB2020,081,4,Queens,40280001006,226,119,107,3.86
2020,CB2020,081,4,Queens,40280001007,221,93,128,3.89
2020,CB2020,081,4,Queens,40280001008,218,90,128,3.93
2020,CB2020,081,4,Queens,40280001009,168,66,102,3.94
2020,CB2020,081,4,Queens,40281001000,376,200,176,4.02
2020,CB2020,081,4,Queens,40281001001,396,188,208,4.02
2020,CB2020,081,4,Queens,40281001002,685,359,326,4.02
2020,CB2020,081,4,Queens,40281002000,719,343,376,4.27
2020,CB2020,081,4,Queens,40281002001,466,200,266,4.27
2020,CB2020,081,4,Queens,40281002002,500,255,245,4.27
2020,CB2020,081,4,Queens,40281003000,913,440,473,4.49
2020,CB2020,081,4,Queens,40281003001,356,177,179,4.65
2020,CB2020,081,4,Queens,40281004000,874,430,444,4.48
2020,CB2020,081,4,Queens,40281004001,706,343,363,4.63
2020,CB2020,081,4,Queens,40282001000,183,67,116,3.95
2020,CB2020,081,4,Queens,40282001001,198,81,117,3.91
2020,CB2020,081,4,Queens,40282001002,156,91,65,4.47
2020,CB2020,081,4,Queens,40282001003,171,86,85,4.34
2020,CB2020,081,4,Queens,40282001004,180,75,105,4.36
2020,CB2020,081,4,Queens,40282001005,36,20,16,1.85
2020,CB2020,081,4,Queens,40282001006,150,66,84,5.74
2020,CB2020,081,4,Queens,40282001007,119,60,59,2.84
2020,CB2020,081,4,Queens,40282001008,126,42,84,3.03
2020,CB2020,081,4,Queens,40282001009,153,65,88,3.36
2020,CB2020,081,4,Queens,40282001010,115,55,60,2.54
2020,CB2020,081,4,Queens,40282001011,214,111,103,4.7
2020,CB2020,081,4,Queens,40283001000,640,324,316,4.01
2020,CB2020,081,4,Queens,40283001001,550,249,301,4.01
2020,CB2020,081,4,Queens,40283002000,708,325,383,4.27
2020,CB2020,081,4,Queens,40283002001,969,446,523,4.26
2020,CB2020,081,4,Queens,40283003000,491,247,244,4.49
2020,CB2020,081,4,Queens,40283003001,425,205,220,4.66
2020,CB2020,081,4,Queens,40283004000,618,302,316,4.48
2020,CB2020,081,4,Queens,40283004001,668,339,329,4.62
2020,CB2020,081,4,Queens,40283005000,969,455,514,4.47
2020,CB2020,081,4,Queens,40283005001,1485,757,728,4.64
2020,CB2020,081,4,Queens,40284001000,119,33,86,2.99
2020,CB2020,081,4,Queens,40284001001,153,79,74,3.6
2020,CB2020,081,4,Queens,40284001002,167,70,97,4.66
2020,CB2020,081,4,Queens,40284001003,189,84,105,6.54
2020,CB2020,081,4,Queens,40284001004,87,26,61,2.5
2020,CB2020,081,4,Queens,40284001005,203,85,118,4.75
2020,CB2020,081,4,Queens,40284001006,195,105,90,4.13
2020,CB2020,081,4,Queens,40284001007,192,105,87,4.02
2020,CB2020,081,4,Queens,40284001008,202,80,122,4.84
2020,CB2020,081,4,Queens,40284001009,238,106,132,4.73
2020,CB2020,081,4,Queens,40284001010,395,192,203,15.57
2020,CB2020,081,4,Queens,40284001011,26,16,10,0.75
2020,CB2020,081,4,Queens,40284001012,159,58,101,5.1
2020,CB2020,081,4,Queens,40284001013,103,33,70,5.52
2020,CB2020,081,4,Queens,40284001014,9,7,2,0.44
2020,CB2020,081,4,Queens,40284002000,70,27,43,1.81
2020,CB2020,081,4,Queens,40284002001,103,44,59,4.34
2020,CB2020,081,4,Queens,40284002002,211,91,120,3.99
2020,CB2020,081,4,Queens,40284002003,117,71,46,4.09
2020,CB2020,081,4,Queens,40284002004,144,49,95,3.98
2020,CB2020,081,4,Queens,40284002005,177,80,97,3.93
2020,CB2020,081,4,Queens,40284002006,118,57,61,3.13
2020,CB2020,081,4,Queens,40284002007,187,80,107,3.76
2020,CB2020,081,4,Queens,40284002008,157,102,55,3.97
2020,CB2020,081,4,Queens,40284002009,45,17,28,3
2020,CB2020,081,4,Queens,40285001000,258,113,145,4.01
2020,CB2020,081,4,Queens,40285001001,43,27,16,4.01
2020,CB2020,081,4,Queens,40285001002,590,305,285,4.27
2020,CB2020,081,4,Queens,40285002000,579,275,304,4.26
2020,CB2020,081,4,Queens,40285002001,641,314,327,4.28
2020,CB2020,081,4,Queens,40285003000,831,414,417,4.48
2020,CB2020,081,4,Queens,40285003001,561,257,304,4.49
2020,CB2020,081,4,Queens,40285004000,1026,521,505,4.64
2020,CB2020,081,4,Queens,40285004001,329,161,168,4.64
2020,CB2020,081,4,Queens,40287001000,286,136,150,4.02
2020,CB2020,081,4,Queens,40287001001,34,22,12,4
2020,CB2020,081,4,Queens,40287001002,1067,504,563,4.27
2020,CB2020,081,4,Queens,40287002000,714,327,387,4.52
2020,CB2020,081,4,Queens,40287002001,311,176,135,5.18
2020,CB2020,081,4,Queens,40287003000,438,214,224,4.46
2020,CB2020,081,4,Queens,40287003001,899,424,475,4.45
2020,CB2020,081,4,Queens,40287003002,244,123,121,3.61
2020,CB2020,081,4,Queens,40287003003,735,362,373,3.77
2020,CB2020,081,4,Queens,40287003004,0,0,0,0.89
2020,CB2020,081,4,Queens,40287003005,0,0,0,0.86
2020,CB2020,081,4,Queens,40287004000,838,438,400,4.02
2020,CB2020,081,4,Queens,40287004001,978,435,543,4.27
2020,CB2020,081,4,Queens,40288011000,397,195,202,7.11
2020,CB2020,081,4,Queens,40288011001,344,158,186,5.48
2020,CB2020,081,4,Queens,40288011002,134,66,68,1.99
2020,CB2020,081,4,Queens,40288011003,160,69,91,2.45
2020,CB2020,081,4,Queens,40288011004,226,122,104,4
2020,CB2020,081,4,Queens,40288011005,188,95,93,2.94
2020,CB2020,081,4,Queens,40288012000,111,60,51,2.9
2020,CB2020,081,4,Queens,40288012001,156,75,81,3.81
2020,CB2020,081,4,Queens,40288012002,159,49,110,3.68
2020,CB2020,081,4,Queens,40288012003,147,77,70,2.86
2020,CB2020,081,4,Queens,40288012004,108,44,64,2.81
2020,CB2020,081,4,Queens,40288012005,199,67,132,3.56
2020,CB2020,081,4,Queens,40288012006,160,88,72,3.34
2020,CB2020,081,4,Queens,40288012007,85,37,48,2.59
2020,CB2020,081,4,Queens,40288012008,74,27,47,2.25
2020,CB2020,081,4,Queens,40288012009,117,87,30,2.76
2020,CB2020,081,4,Queens,40288012010,112,49,63,2.37
2020,CB2020,081,4,Queens,40288012011,63,47,16,2.02
2020,CB2020,081,4,Queens,40288021000,73,19,54,2.86
2020,CB2020,081,4,Queens,40288021001,111,39,72,2.9
2020,CB2020,081,4,Queens,40288021002,44,30,14,1.21
2020,CB2020,081,4,Queens,40288021003,70,32,38,1.67
2020,CB2020,081,4,Queens,40288021004,118,47,71,2.9
2020,CB2020,081,4,Queens,40288021005,136,87,49,2.87
2020,CB2020,081,4,Queens,40288021006,94,51,43,2.92
2020,CB2020,081,4,Queens,40288021007,97,45,52,2.59
2020,CB2020,081,4,Queens,40288021008,106,38,68,2.12
2020,CB2020,081,4,Queens,40288021009,103,42,61,3.02
2020,CB2020,081,4,Queens,40288022000,121,68,53,2.86
2020,CB2020,081,4,Queens,40288022001,93,38,55,2.89
2020,CB2020,081,4,Queens,40288022002,105,63,42,2.9
2020,CB2020,081,4,Queens,40288022003,158,70,88,3.45
2020,CB2020,081,4,Queens,40288022004,159,55,104,3.94
2020,CB2020,081,4,Queens,40288022005,116,62,54,3.09
2020,CB2020,081,4,Queens,40288022006,142,75,67,2.85
2020,CB2020,081,4,Queens,40288022007,106,44,62,2.44
2020,CB2020,081,4,Queens,40288031000,0,0,0,6.73
2020,CB2020,081,4,Queens,40288031001,8,2,6,60.61
2020,CB2020,081,4,Queens,40289001000,209,91,118,4.03
2020,CB2020,081,4,Queens,40289001001,167,110,57,3.99
2020,CB2020,081,4,Queens,40289001002,302,166,136,4.01
2020,CB2020,081,4,Queens,40289001003,685,318,367,4.25
2020,CB2020,081,4,Queens,40289002000,386,191,195,4.27
2020,CB2020,081,4,Queens,40289002001,852,400,452,4.27
2020,CB2020,081,4,Queens,40289003000,872,431,441,4.47
2020,CB2020,081,4,Queens,40289003001,1081,513,568,4.55
2020,CB2020,081,4,Queens,40289003002,126,82,44,3.78
2020,CB2020,081,4,Queens,40289003003,502,246,256,3.6
2020,CB2020,081,4,Queens,40289003004,20,6,14,0.57
2020,CB2020,081,4,Queens,40289003005,0,0,0,0.87
2020,CB2020,081,4,Queens,40291001000,481,208,273,2.86
2020,CB2020,081,4,Queens,40291001001,0,0,0,1.64
2020,CB2020,081,4,Queens,40291001002,0,0,0,1.95
2020,CB2020,081,4,Queens,40291001003,0,0,0,0.62
2020,CB2020,081,4,Queens,40291001004,738,365,373,2.09
2020,CB2020,081,4,Queens,40291001005,105,66,39,1.8
2020,CB2020,081,4,Queens,40291001006,589,311,278,4.15
2020,CB2020,081,4,Queens,40291002000,871,454,417,4.4
2020,CB2020,081,4,Queens,40291002001,967,508,459,5.55
2020,CB2020,081,4,Queens,40291003000,543,293,250,4.27
2020,CB2020,081,4,Queens,40291003001,520,250,270,4.25
2020,CB2020,081,4,Queens,40291003002,474,215,259,4.2
2020,CB2020,081,4,Queens,40291003003,501,281,220,4.29
2020,CB2020,081,4,Queens,40291003004,39,29,10,1.59
2020,CB2020,081,4,Queens,40291003005,0,0,0,1.06
2020,CB2020,081,4,Queens,40291004000,358,181,177,4.01
2020,CB2020,081,4,Queens,40291004001,388,180,208,4.01
2020,CB2020,081,4,Queens,40291004002,428,236,192,4.02
2020,CB2020,081,4,Queens,40291004003,158,89,69,3.05
2020,CB2020,081,4,Queens,40291004004,112,48,64,1.15
2020,CB2020,081,4,Queens,40291004005,69,36,33,2.87
2020,CB2020,081,4,Queens,40291004006,0,0,0,0.78
2020,CB2020,081,4,Queens,40293001000,0,0,0,4.54
2020,CB2020,081,4,Queens,40293001001,0,0,0,3.89
2020,CB2020,081,4,Queens,40293001002,106,45,61,3.99
2020,CB2020,081,4,Queens,40293001003,378,210,168,5.52
2020,CB2020,081,4,Queens,40293001004,309,166,143,4.45
2020,CB2020,081,4,Queens,40293001005,232,95,137,3.81
2020,CB2020,081,4,Queens,40293001006,0,0,0,2.28
2020,CB2020,081,4,Queens,40293001007,0,0,0,0.89
2020,CB2020,081,4,Queens,40293001008,0,0,0,1.3
2020,CB2020,081,4,Queens,40293001009,179,103,76,1.93
2020,CB2020,081,4,Queens,40293001010,0,0,0,0.55
2020,CB2020,081,4,Queens,40293001011,0,0,0,0.44
2020,CB2020,081,4,Queens,40293001012,253,130,123,3.8
2020,CB2020,081,4,Queens,40294001000,72,36,36,3.38
2020,CB2020,081,4,Queens,40294001001,158,74,84,3.39
2020,CB2020,081,4,Queens,40294001002,81,28,53,2.93
2020,CB2020,081,4,Queens,40294001003,187,74,113,4.88
2020,CB2020,081,4,Queens,40294001004,75,29,46,2.1
2020,CB2020,081,4,Queens,40294001005,115,72,43,2.12
2020,CB2020,081,4,Queens,40294001006,95,49,46,2.07
2020,CB2020,081,4,Queens,40294001007,75,32,43,2.09
2020,CB2020,081,4,Queens,40294001008,93,24,69,2.32
2020,CB2020,081,4,Queens,40294001009,28,7,21,1.47
2020,CB2020,081,4,Queens,40294001010,89,47,42,2.13
2020,CB2020,081,4,Queens,40294001011,56,30,26,2.2
2020,CB2020,081,4,Queens,40294001012,61,36,25,2.36
2020,CB2020,081,4,Queens,40294001013,168,88,80,3.94
2020,CB2020,081,4,Queens,40294001014,28,13,15,1.18
2020,CB2020,081,4,Queens,40294002000,183,70,113,9.48
2020,CB2020,081,4,Queens,40294002001,97,43,54,3.44
2020,CB2020,081,4,Queens,40294002002,173,88,85,3.51
2020,CB2020,081,4,Queens,40294002003,119,70,49,4.01
2020,CB2020,081,4,Queens,40294002004,111,64,47,4
2020,CB2020,081,4,Queens,40294002005,141,75,66,4
2020,CB2020,081,4,Queens,40294002006,164,83,81,3.99
2020,CB2020,081,4,Queens,40294002007,206,84,122,3.95
2020,CB2020,081,4,Queens,40294002008,97,53,44,4.23
2020,CB2020,081,4,Queens,40294003000,135,53,82,2.96
2020,CB2020,081,4,Queens,40294003001,163,60,103,2.82
2020,CB2020,081,4,Queens,40294003002,115,31,84,2.79
2020,CB2020,081,4,Queens,40294003003,217,103,114,4.52
2020,CB2020,081,4,Queens,40294003004,250,105,145,5.72
2020,CB2020,081,4,Queens,40294003005,123,46,77,2.56
2020,CB2020,081,4,Queens,40294003006,97,64,33,2.98
2020,CB2020,081,4,Queens,40294003007,163,101,62,3.9
2020,CB2020,081,4,Queens,40294004000,145,55,90,2.67
2020,CB2020,081,4,Queens,40294004001,140,61,79,2.47
2020,CB2020,081,4,Queens,40294004002,102,47,55,2.28
2020,CB2020,081,4,Queens,40294004003,88,37,51,2.06
2020,CB2020,081,4,Queens,40294004004,59,26,33,1.92
2020,CB2020,081,4,Queens,40294004005,0,0,0,1.2
2020,CB2020,081,4,Queens,40294004006,33,16,17,1.87
2020,CB2020,081,4,Queens,40294004007,441,178,263,4.49
2020,CB2020,081,4,Queens,40294004008,127,54,73,2.9
2020,CB2020,081,4,Queens,40294004009,155,75,80,3.27
2020,CB2020,081,4,Queens,40294005000,18,4,14,12.54
2020,CB2020,081,4,Queens,40294005001,61,49,12,1.33
2020,CB2020,081,4,Queens,40294005002,148,84,64,3.99
2020,CB2020,081,4,Queens,40294005003,174,100,74,4.01
2020,CB2020,081,4,Queens,40294005004,144,65,79,3.99
2020,CB2020,081,4,Queens,40294005005,162,82,80,3.93
2020,CB2020,081,4,Queens,40294005006,120,56,64,3.89
2020,CB2020,081,4,Queens,40294005007,17,5,12,2.03
2020,CB2020,081,4,Queens,40294005008,78,41,37,5.36
2020,CB2020,081,4,Queens,40294005009,139,30,109,3.93
2020,CB2020,081,4,Queens,40294005010,127,59,68,4.06
2020,CB2020,081,4,Queens,40294005011,167,63,104,4.01
2020,CB2020,081,4,Queens,40294005012,143,59,84,3.99
2020,CB2020,081,4,Queens,40294006000,24,11,13,2.42
2020,CB2020,081,4,Queens,40294006001,23,13,10,32.89
2020,CB2020,081,4,Queens,40294006002,0,0,0,7.29
2020,CB2020,081,4,Queens,40294006003,0,0,0,1.81
2020,CB2020,081,4,Queens,40294006004,41,11,30,2.48
2020,CB2020,081,4,Queens,40294006005,80,35,45,2.62
2020,CB2020,081,4,Queens,40294006006,170,101,69,3.57
2020,CB2020,081,4,Queens,40294006007,152,63,89,3.42
2020,CB2020,081,4,Queens,40294006008,134,74,60,4.69
2020,CB2020,081,4,Queens,40294006009,335,321,14,1.88
2020,CB2020,081,4,Queens,40294006010,21,14,7,2.71
2020,CB2020,081,4,Queens,40294006011,326,148,178,5.36
2020,CB2020,081,4,Queens,40294006012,43,17,26,2.27
2020,CB2020,081,4,Queens,40295001000,908,429,479,6.67
2020,CB2020,081,4,Queens,40295001001,797,370,427,7.55
2020,CB2020,081,4,Queens,40295001002,46,16,30,0.5
2020,CB2020,081,4,Queens,40295002000,230,135,95,3.27
2020,CB2020,081,4,Queens,40295002001,325,142,183,3.3
2020,CB2020,081,4,Queens,40295002002,444,217,227,3.42
2020,CB2020,081,4,Queens,40295002003,285,130,155,4.49
2020,CB2020,081,4,Queens,40295002004,223,93,130,2.8
2020,CB2020,081,4,Queens,40295002005,0,0,0,1.67
2020,CB2020,081,4,Queens,40295002006,270,154,116,2.96
2020,CB2020,081,4,Queens,40295002007,298,162,136,4.15
2020,CB2020,081,4,Queens,40295002008,0,0,0,4.42
2020,CB2020,081,4,Queens,40297001000,0,0,0,0.69
2020,CB2020,081,4,Queens,40297001001,0,0,0,3.01
2020,CB2020,081,4,Queens,40297001002,0,0,0,2.86
2020,CB2020,081,4,Queens,40297001003,131,83,48,2.44
2020,CB2020,081,4,Queens,40297001004,82,39,43,1.49
2020,CB2020,081,4,Queens,40297001005,0,0,0,9.94
2020,CB2020,081,4,Queens,40297001006,0,0,0,1.23
2020,CB2020,081,4,Queens,40297001007,0,0,0,10.37
2020,CB2020,081,4,Queens,40297001008,189,86,103,7.1
2020,CB2020,081,4,Queens,40297001009,16,6,10,18.06
2020,CB2020,081,4,Queens,40297001010,191,88,103,4.02
2020,CB2020,081,4,Queens,40297001011,112,60,52,2.25
2020,CB2020,081,4,Queens,40297001012,188,94,94,3.89
2020,CB2020,081,4,Queens,40297001013,0,0,0,1.32
2020,CB2020,081,4,Queens,40297001014,0,0,0,7.48
2020,CB2020,081,4,Queens,40297001015,0,0,0,0.79
2020,CB2020,081,4,Queens,40297002000,0,0,0,0.98
2020,CB2020,081,4,Queens,40297002001,0,0,0,0.46
2020,CB2020,081,4,Queens,40297002002,0,0,0,1.76
2020,CB2020,081,4,Queens,40297002003,21,7,14,4.43
2020,CB2020,081,4,Queens,40297002004,11,4,7,3.26
2020,CB2020,081,4,Queens,40297002005,330,165,165,3.27
2020,CB2020,081,4,Queens,40297002006,56,31,25,4.58
2020,CB2020,081,4,Queens,40297002007,59,37,22,2.35
2020,CB2020,081,4,Queens,40297002008,13,8,5,4.86
2020,CB2020,081,4,Queens,40297002009,66,39,27,4.71
2020,CB2020,081,4,Queens,40297002010,325,167,158,4.42
2020,CB2020,081,4,Queens,40297002011,358,186,172,4.51
2020,CB2020,081,4,Queens,40297002012,110,39,71,4.53
2020,CB2020,081,4,Queens,40297002013,0,0,0,5.51
2020,CB2020,081,4,Queens,40297002014,0,0,0,0.37
2020,CB2020,081,4,Queens,40297002015,0,0,0,0.78
2020,CB2020,081,4,Queens,40297002016,0,0,0,0.58
2020,CB2020,081,4,Queens,40299001000,5,3,2,98.94
2020,CB2020,081,4,Queens,40299001001,0,0,0,1.48
2020,CB2020,081,4,Queens,40299001002,0,0,0,0.45
2020,CB2020,081,4,Queens,40306001000,0,0,0,7.52
2020,CB2020,081,4,Queens,40306001001,0,0,0,2.53
2020,CB2020,081,4,Queens,40306001002,0,0,0,3.51
2020,CB2020,081,4,Queens,40306001003,0,0,0,1.61
2020,CB2020,081,4,Queens,40306001004,0,0,0,1.16
2020,CB2020,081,4,Queens,40306001005,0,0,0,1.2
2020,CB2020,081,4,Queens,40306001006,0,0,0,0.5
2020,CB2020,081,4,Queens,40306001007,0,0,0,1.06
2020,CB2020,081,4,Queens,40306001008,21,7,14,15.2
2020,CB2020,081,4,Queens,40306001009,0,0,0,1.19
2020,CB2020,081,4,Queens,40306001010,0,0,0,0.18
2020,CB2020,081,4,Queens,40306001011,0,0,0,0.28
2020,CB2020,081,4,Queens,40306001012,0,0,0,2.24
2020,CB2020,081,4,Queens,40306001013,0,0,0,10.61
2020,CB2020,081,4,Queens,40306001014,0,0,0,2.37
2020,CB2020,081,4,Queens,40306001015,292,209,83,12.68
2020,CB2020,081,4,Queens,40306001016,103,50,53,3.85
2020,CB2020,081,4,Queens,40306001017,0,0,0,43.76
2020,CB2020,081,4,Queens,40306001018,0,0,0,2.19
2020,CB2020,081,4,Queens,40306001019,0,0,0,4.26
2020,CB2020,081,4,Queens,40306001020,0,0,0,0.2
2020,CB2020,081,4,Queens,40306001021,0,0,0,0.2
2020,CB2020,081,4,Queens,40306001022,0,0,0,0.94
2020,CB2020,081,4,Queens,40306001023,0,0,0,0.83
2020,CB2020,081,4,Queens,40306001024,0,0,0,3.49
2020,CB2020,081,4,Queens,40306001025,0,0,0,2.44
2020,CB2020,081,4,Queens,40306001026,0,0,0,13.11
2020,CB2020,081,4,Queens,40306001027,0,0,0,0.45
2020,CB2020,081,4,Queens,40306001028,0,0,0,2.58
2020,CB2020,081,4,Queens,40306001029,0,0,0,18.3
2020,CB2020,081,4,Queens,40306001030,0,0,0,0.35
2020,CB2020,081,4,Queens,40306002000,19,11,8,3.09
2020,CB2020,081,4,Queens,40306002001,74,50,24,3.99
2020,CB2020,081,4,Queens,40306002002,153,73,80,2.9
2020,CB2020,081,4,Queens,40306002003,174,73,101,3.18
2020,CB2020,081,4,Queens,40306002004,118,58,60,3.18
2020,CB2020,081,4,Queens,40306002005,8,2,6,4.26
2020,CB2020,081,4,Queens,40306003000,183,95,88,2.95
2020,CB2020,081,4,Queens,40306003001,130,54,76,2.88
2020,CB2020,081,4,Queens,40306003002,132,72,60,2.87
2020,CB2020,081,4,Queens,40306003003,107,44,63,2.88
2020,CB2020,081,4,Queens,40306003004,94,37,57,3.32
2020,CB2020,081,4,Queens,40306003005,111,50,61,3.31
2020,CB2020,081,4,Queens,40306003006,128,27,101,2.88
2020,CB2020,081,4,Queens,40306003007,68,49,19,2.96
2020,CB2020,081,4,Queens,40306003008,83,46,37,3.23
2020,CB2020,081,4,Queens,40306003009,102,51,51,3.14
2020,CB2020,081,4,Queens,40306003010,47,13,34,3.1
2020,CB2020,081,4,Queens,40306003011,135,80,55,3.24
2020,CB2020,081,4,Queens,40306004000,0,0,0,4.51
2020,CB2020,081,4,Queens,40306004001,0,0,0,1.05
2020,CB2020,081,4,Queens,40306004002,0,0,0,2.7
2020,CB2020,081,4,Queens,40306004003,308,133,175,8.12
2020,CB2020,081,4,Queens,40306004004,92,38,54,1.33
2020,CB2020,081,4,Queens,40306004005,64,30,34,2.57
2020,CB2020,081,4,Queens,40306004006,22,12,10,1.98
2020,CB2020,081,4,Queens,40306004007,129,42,87,2.79
2020,CB2020,081,4,Queens,40306004008,152,67,85,3.58
2020,CB2020,081,4,Queens,40306004009,198,97,101,4.12
2020,CB2020,081,4,Queens,40306004010,199,91,108,3.27
2020,CB2020,081,4,Queens,40306004011,35,16,19,1.14
2020,CB2020,081,4,Queens,40306004012,15,5,10,1.61
2020,CB2020,081,4,Queens,40306004013,0,0,0,3.02
2020,CB2020,081,4,Queens,40306004014,0,0,0,6.97
2020,CB2020,081,4,Queens,40306004015,52,36,16,3.32
2020,CB2020,081,4,Queens,40306004016,0,0,0,4.73
2020,CB2020,081,4,Queens,40306005000,0,0,0,8.11
2020,CB2020,081,4,Queens,40306005001,0,0,0,3.24
2020,CB2020,081,4,Queens,40306005002,0,0,0,7.31
2020,CB2020,081,4,Queens,40306005003,72,39,33,1.45
2020,CB2020,081,4,Queens,40306005004,0,0,0,0.7
2020,CB2020,081,4,Queens,40306005005,155,56,99,3.99
2020,CB2020,081,4,Queens,40306005006,149,67,82,3.14
2020,CB2020,081,4,Queens,40306005007,384,189,195,6.52
2020,CB2020,081,4,Queens,40306005008,162,82,80,2.78
2020,CB2020,081,4,Queens,40306005009,141,60,81,3.09
2020,CB2020,081,4,Queens,40306005010,97,54,43,3.41
2020,CB2020,081,4,Queens,40306005011,68,39,29,2.78
2020,CB2020,081,4,Queens,40306005012,170,68,102,3.93
2020,CB2020,081,4,Queens,40306005013,180,91,89,3.74
2020,CB2020,081,4,Queens,40306005014,33,21,12,2.41
2020,CB2020,081,4,Queens,40306005015,128,49,79,2.89
2020,CB2020,081,4,Queens,40309031000,412,208,204,4.35
2020,CB2020,081,4,Queens,40309031001,337,139,198,4.36
2020,CB2020,081,4,Queens,40309031002,351,184,167,4.35
2020,CB2020,081,4,Queens,40309031003,320,148,172,4.41
2020,CB2020,081,4,Queens,40309031004,34,15,19,8.63
2020,CB2020,081,4,Queens,40309031005,313,186,127,4.39
2020,CB2020,081,4,Queens,40309032000,454,234,220,3.4
2020,CB2020,081,4,Queens,40309032001,430,237,193,3.41
2020,CB2020,081,4,Queens,40309032002,295,123,172,3.39
2020,CB2020,081,4,Queens,40309032003,202,100,102,3.43
2020,CB2020,081,4,Queens,40309032004,241,111,130,3.38
2020,CB2020,081,4,Queens,40309032005,213,113,100,3.39
2020,CB2020,081,4,Queens,40309032006,252,146,106,3.44
2020,CB2020,081,4,Queens,40309033000,620,310,310,4.66
2020,CB2020,081,4,Queens,40309033001,653,356,297,4.66
2020,CB2020,081,4,Queens,40309033002,362,174,188,4.66
2020,CB2020,081,4,Queens,40309034000,293,145,148,4.65
2020,CB2020,081,4,Queens,40309034001,339,178,161,4.67
2020,CB2020,081,4,Queens,40309034002,235,117,118,4.66
2020,CB2020,081,4,Queens,40309034003,392,194,198,4.62
2020,CB2020,081,4,Queens,40309041000,0,0,0,0.28
2020,CB2020,081,4,Queens,40309041001,0,0,0,2.07
2020,CB2020,081,4,Queens,40309041002,110,61,49,2.03
2020,CB2020,081,4,Queens,40309041003,57,30,27,2.35
2020,CB2020,081,4,Queens,40309041004,0,0,0,0.59
2020,CB2020,081,4,Queens,40309041005,31,13,18,1.15
2020,CB2020,081,4,Queens,40309041006,116,56,60,1.63
2020,CB2020,081,4,Queens,40309041007,0,0,0,2.14
2020,CB2020,081,4,Queens,40309041008,0,0,0,1.34
2020,CB2020,081,4,Queens,40309041009,0,0,0,1.3
2020,CB2020,081,4,Queens,40309041010,0,0,0,0.9
2020,CB2020,081,4,Queens,40309041011,78,39,39,4.01
2020,CB2020,081,4,Queens,40309041012,138,57,81,3.99
2020,CB2020,081,4,Queens,40309041013,259,137,122,3.99
2020,CB2020,081,4,Queens,40309041014,393,201,192,4.68
2020,CB2020,081,4,Queens,40309041015,82,48,34,29.81
2020,CB2020,081,4,Queens,40309041016,0,0,0,2.03
2020,CB2020,081,4,Queens,40309041017,0,0,0,2.05
2020,CB2020,081,4,Queens,40309041018,254,103,151,3.98
2020,CB2020,081,4,Queens,40309041019,421,218,203,3.94
2020,CB2020,081,4,Queens,40309042000,362,195,167,4.04
2020,CB2020,081,4,Queens,40309042001,356,188,168,4.03
2020,CB2020,081,4,Queens,40309042002,14,7,7,4.03
2020,CB2020,081,4,Queens,40309042003,132,41,91,4.02
2020,CB2020,081,4,Queens,40309042004,342,157,185,4.05
2020,CB2020,081,4,Queens,40309042005,301,134,167,3.98
2020,CB2020,081,4,Queens,40309042006,278,129,149,4
2020,CB2020,081,4,Queens,40309051000,0,0,0,7.97
2020,CB2020,081,4,Queens,40309051001,261,118,143,4.03
2020,CB2020,081,4,Queens,40309051002,272,127,145,3.98
2020,CB2020,081,4,Queens,40309051003,253,149,104,3.15
2020,CB2020,081,4,Queens,40309051004,0,0,0,0.66
2020,CB2020,081,4,Queens,40309051005,0,0,0,0.99
2020,CB2020,081,4,Queens,40309051006,0,0,0,0.8
2020,CB2020,081,4,Queens,40309052000,461,225,236,4.35
2020,CB2020,081,4,Queens,40309052001,388,208,180,4.38
2020,CB2020,081,4,Queens,40309052002,498,267,231,4.34
2020,CB2020,081,4,Queens,40309052003,571,316,255,4.35
2020,CB2020,081,4,Queens,40309052004,334,153,181,3.08
2020,CB2020,081,4,Queens,40309052005,185,77,108,1.42
2020,CB2020,081,4,Queens,40309052006,201,103,98,3.17
2020,CB2020,081,4,Queens,40309052007,0,0,0,1.19
2020,CB2020,081,4,Queens,40309061000,409,220,189,3.43
2020,CB2020,081,4,Queens,40309061001,13,9,4,6.79
2020,CB2020,081,4,Queens,40309061002,323,188,135,3.41
2020,CB2020,081,4,Queens,40309061003,144,69,75,2.27
2020,CB2020,081,4,Queens,40309061004,254,127,127,3.73
2020,CB2020,081,4,Queens,40309061005,282,145,137,2.18
2020,CB2020,081,4,Queens,40309061006,76,20,56,1.4
2020,CB2020,081,4,Queens,40309062000,325,155,170,4.67
2020,CB2020,081,4,Queens,40309062001,333,160,173,4.64
2020,CB2020,081,4,Queens,40309062002,450,217,233,4.65
2020,CB2020,081,4,Queens,40309062003,440,248,192,4.67
2020,CB2020,081,4,Queens,40309063000,750,366,384,3.45
2020,CB2020,081,4,Queens,40309063001,481,243,238,1.53
2020,CB2020,081,4,Queens,40309063002,569,297,272,4.93
2020,CB2020,081,4,Queens,40309063003,75,31,44,1.88
2020,CB2020,081,4,Queens,40317001000,0,0,0,23.07
2020,CB2020,081,4,Queens,40317001001,0,0,0,24.5
2020,CB2020,081,4,Queens,40317001002,0,0,0,0.82
2020,CB2020,081,4,Queens,40317002000,353,151,202,5.58
2020,CB2020,081,4,Queens,40317002001,219,105,114,3.86
2020,CB2020,081,4,Queens,40317002002,40,24,16,3.05
2020,CB2020,081,4,Queens,40317002003,173,89,84,3.38
2020,CB2020,081,4,Queens,40317002004,233,128,105,3.38
2020,CB2020,081,4,Queens,40317002005,338,151,187,5.2
2020,CB2020,081,4,Queens,40317002006,475,267,208,5.75
2020,CB2020,081,4,Queens,40317002007,199,96,103,4.48
2020,CB2020,081,4,Queens,40317003000,235,103,132,4.45
2020,CB2020,081,4,Queens,40317003001,221,89,132,4.12
2020,CB2020,081,4,Queens,40317003002,241,136,105,4.12
2020,CB2020,081,4,Queens,40317003003,200,61,139,4.12
2020,CB2020,081,4,Queens,40317003004,238,137,101,4.12
2020,CB2020,081,4,Queens,40317003005,135,58,77,4.12
2020,CB2020,081,4,Queens,40317004000,0,0,0,2.06
2020,CB2020,081,4,Queens,40317004001,141,66,75,4.36
2020,CB2020,081,4,Queens,40317004002,257,82,175,4.58
2020,CB2020,081,4,Queens,40317004003,274,117,157,4.69
2020,CB2020,081,4,Queens,40317004004,278,150,128,4.49
2020,CB2020,081,4,Queens,40317004005,299,164,135,4.07
2020,CB2020,081,4,Queens,40317004006,193,102,91,3.75
2020,CB2020,081,4,Queens,40317004007,310,128,182,2.74
2020,CB2020,081,4,Queens,40317004008,0,0,0,0.55
2020,CB2020,081,4,Queens,40317004009,0,0,0,0.81
2020,CB2020,081,4,Queens,40317004010,0,0,0,1.38
2020,CB2020,081,4,Queens,40317004011,0,0,0,0.75
2020,CB2020,081,4,Queens,40317004012,0,0,0,1.21
2020,CB2020,081,4,Queens,40317004013,0,0,0,0.43
2020,CB2020,081,4,Queens,40317004014,0,0,0,0.26
2020,CB2020,081,4,Queens,40317004015,0,0,0,0.13
2020,CB2020,081,4,Queens,40317004016,0,0,0,0.52
2020,CB2020,081,4,Queens,40317004017,0,0,0,0.46
2020,CB2020,081,4,Queens,40317005000,169,70,99,3.35
2020,CB2020,081,4,Queens,40317005001,62,19,43,1.85
2020,CB2020,081,4,Queens,40317005002,14,4,10,0.64
2020,CB2020,081,4,Queens,40317005003,142,72,70,4.15
2020,CB2020,081,4,Queens,40317005004,151,70,81,4.13
2020,CB2020,081,4,Queens,40317005005,198,98,100,4.12
2020,CB2020,081,4,Queens,40317005006,230,127,103,3.54
2020,CB2020,081,4,Queens,40317005007,136,93,43,3.19
2020,CB2020,081,4,Queens,40317005008,246,101,145,2.68
2020,CB2020,081,4,Queens,40317005009,39,9,30,2.15
2020,CB2020,081,4,Queens,40317005010,169,83,86,3.55
2020,CB2020,081,4,Queens,40317005011,86,26,60,2.68
2020,CB2020,081,4,Queens,40317005012,53,34,19,2.09
2020,CB2020,081,4,Queens,40317005013,34,19,15,1.69
2020,CB2020,081,4,Queens,40317005014,0,0,0,1.67
2020,CB2020,081,4,Queens,40317005015,0,0,0,1.3
2020,CB2020,081,4,Queens,40317005016,0,0,0,1.56
2020,CB2020,081,4,Queens,40320001000,0,0,0,3.44
2020,CB2020,081,4,Queens,40320001001,0,0,0,5.78
2020,CB2020,081,4,Queens,40320001002,0,0,0,2.27
2020,CB2020,081,4,Queens,40320001003,0,0,0,5.28
2020,CB2020,081,4,Queens,40320001004,20,3,17,1.21
2020,CB2020,081,4,Queens,40320001005,50,14,36,1.44
2020,CB2020,081,4,Queens,40320001006,35,14,21,0.97
2020,CB2020,081,4,Queens,40320001007,39,28,11,1.45
2020,CB2020,081,4,Queens,40320001008,49,25,24,1.43
2020,CB2020,081,4,Queens,40320001009,48,19,29,1.43
2020,CB2020,081,4,Queens,40320001010,55,16,39,1.43
2020,CB2020,081,4,Queens,40320001011,81,42,39,1.72
2020,CB2020,081,4,Queens,40320001012,92,39,53,1.9
2020,CB2020,081,4,Queens,40320001013,149,64,85,2.15
2020,CB2020,081,4,Queens,40320001014,139,49,90,2.39
2020,CB2020,081,4,Queens,40320001015,108,66,42,7.38
2020,CB2020,081,4,Queens,40320001016,0,0,0,1.31
2020,CB2020,081,4,Queens,40320001017,40,17,23,1.43
2020,CB2020,081,4,Queens,40320001018,54,24,30,1.44
2020,CB2020,081,4,Queens,40320001019,54,16,38,1.42
2020,CB2020,081,4,Queens,40320001020,165,74,91,3.89
2020,CB2020,081,4,Queens,40320001021,139,69,70,2.72
2020,CB2020,081,4,Queens,40320001022,120,68,52,2.7
2020,CB2020,081,4,Queens,40320001023,70,24,46,3.02
2020,CB2020,081,4,Queens,40320001024,76,26,50,2.71
2020,CB2020,081,4,Queens,40320001025,115,63,52,2.7
2020,CB2020,081,4,Queens,40320001026,127,59,68,2.7
2020,CB2020,081,4,Queens,40320001027,0,0,0,0.5
2020,CB2020,081,4,Queens,40320002000,144,67,77,18.37
2020,CB2020,081,4,Queens,40320002001,0,0,0,2.66
2020,CB2020,081,4,Queens,40320002002,0,0,0,2.87
2020,CB2020,081,4,Queens,40320002003,128,46,82,7.7
2020,CB2020,081,4,Queens,40320002004,0,0,0,2.08
2020,CB2020,081,4,Queens,40320002005,0,0,0,2.8
2020,CB2020,081,4,Queens,40320002006,0,0,0,4.08
2020,CB2020,081,4,Queens,40320002007,0,0,0,5.15
2020,CB2020,081,4,Queens,40320002008,0,0,0,1.84
2020,CB2020,081,4,Queens,40320002009,0,0,0,3.87
2020,CB2020,081,4,Queens,40320002010,0,0,0,4.63
2020,CB2020,081,4,Queens,40320002011,0,0,0,4.09
2020,CB2020,081,4,Queens,40320002012,0,0,0,2.46
2020,CB2020,081,4,Queens,40320002013,0,0,0,2.18
2020,CB2020,081,4,Queens,40320002014,0,0,0,13.91
2020,CB2020,081,4,Queens,40320002015,0,0,0,2.26
2020,CB2020,081,4,Queens,40320002016,0,0,0,2.36
2020,CB2020,081,4,Queens,40320002017,0,0,0,1.94
2020,CB2020,081,4,Queens,40320002018,0,0,0,1.8
2020,CB2020,081,4,Queens,40320002019,445,176,269,1.97
2020,CB2020,081,4,Queens,40320002020,0,0,0,0.71
2020,CB2020,081,4,Queens,40320002021,0,0,0,1.41
2020,CB2020,081,4,Queens,40320002022,0,0,0,3.15
2020,CB2020,081,4,Queens,40320002023,214,203,11,2.87
2020,CB2020,081,4,Queens,40320002024,0,0,0,2.22
2020,CB2020,081,4,Queens,40320002025,0,0,0,1.67
2020,CB2020,081,4,Queens,40320002026,0,0,0,0.25
2020,CB2020,081,4,Queens,40320002027,0,0,0,2.79
2020,CB2020,081,4,Queens,40320003000,699,325,374,14.22
2020,CB2020,081,4,Queens,40320003001,49,24,25,3.7
2020,CB2020,081,4,Queens,40320003002,96,37,59,4.33
2020,CB2020,081,4,Queens,40320003003,147,69,78,3.62
2020,CB2020,081,4,Queens,40320003004,54,14,40,1.43
2020,CB2020,081,4,Queens,40320003005,253,85,168,2.67
2020,CB2020,081,4,Queens,40320003006,72,39,33,4.08
2020,CB2020,081,4,Queens,40320003007,38,12,26,0.77
2020,CB2020,081,4,Queens,40320003008,118,62,56,3.35
2020,CB2020,081,4,Queens,40320004000,47,21,26,21.69
2020,CB2020,081,4,Queens,40320004001,125,44,81,3.17
2020,CB2020,081,4,Queens,40320004002,27,3,24,2.78
2020,CB2020,081,4,Queens,40320004003,90,32,58,2.54
2020,CB2020,081,4,Queens,40320004004,97,53,44,2.83
2020,CB2020,081,4,Queens,40320004005,103,30,73,2.88
2020,CB2020,081,4,Queens,40320004006,60,30,30,1.43
2020,CB2020,081,4,Queens,40320004007,56,47,9,1.43
2020,CB2020,081,4,Queens,40320004008,63,35,28,1.34
2020,CB2020,081,4,Queens,40320004009,44,24,20,1.52
2020,CB2020,081,4,Queens,40320004010,62,10,52,1.9
2020,CB2020,081,4,Queens,40320004011,69,40,29,1.75
2020,CB2020,081,4,Queens,40320004012,75,40,35,1.27
2020,CB2020,081,4,Queens,40327001000,282,144,138,4.37
2020,CB2020,081,4,Queens,40327001001,422,190,232,4.35
2020,CB2020,081,4,Queens,40327001002,451,250,201,4.36
2020,CB2020,081,4,Queens,40327001003,367,205,162,3.4
2020,CB2020,081,4,Queens,40327001004,342,161,181,3.4
2020,CB2020,081,4,Queens,40327001005,303,144,159,3.4
2020,CB2020,081,4,Queens,40327002000,549,276,273,4.66
2020,CB2020,081,4,Queens,40327002001,614,328,286,4.66
2020,CB2020,081,4,Queens,40327002002,602,310,292,4.68
2020,CB2020,081,4,Queens,40328001000,197,81,116,4.68
2020,CB2020,081,4,Queens,40328001001,170,78,92,3.15
2020,CB2020,081,4,Queens,40328001002,50,15,35,3.14
2020,CB2020,081,4,Queens,40328001003,182,88,94,5.56
2020,CB2020,081,4,Queens,40328001004,124,56,68,3.01
2020,CB2020,081,4,Queens,40328001005,65,39,26,2.08
2020,CB2020,081,4,Queens,40328001006,164,74,90,4.72
2020,CB2020,081,4,Queens,40328001007,106,53,53,3.88
2020,CB2020,081,4,Queens,40328001008,0,0,0,1.52
2020,CB2020,081,4,Queens,40328002000,242,82,160,6.97
2020,CB2020,081,4,Queens,40328002001,42,24,18,1.46
2020,CB2020,081,4,Queens,40328002002,207,103,104,4.64
2020,CB2020,081,4,Queens,40328002003,29,13,16,6.82
2020,CB2020,081,4,Queens,40328002004,137,66,71,5.08
2020,CB2020,081,4,Queens,40328002005,59,37,22,2.51
2020,CB2020,081,4,Queens,40328003000,10,2,8,1.74
2020,CB2020,081,4,Queens,40328003001,181,77,104,8.69
2020,CB2020,081,4,Queens,40328003002,124,43,81,4.88
2020,CB2020,081,4,Queens,40328003003,287,130,157,9.07
2020,CB2020,081,4,Queens,40328003004,43,24,19,1.04
2020,CB2020,081,4,Queens,40328003005,55,25,30,2.63
2020,CB2020,081,4,Queens,40328003006,186,89,97,3.65
2020,CB2020,081,4,Queens,40329001000,180,55,125,4.33
2020,CB2020,081,4,Queens,40329001001,37,15,22,8.28
2020,CB2020,081,4,Queens,40329001002,123,54,69,2.31
2020,CB2020,081,4,Queens,40329001003,178,103,75,2.89
2020,CB2020,081,4,Queens,40329001004,0,0,0,1.12
2020,CB2020,081,4,Queens,40329001005,100,41,59,1.69
2020,CB2020,081,4,Queens,40329001006,47,23,24,0.86
2020,CB2020,081,4,Queens,40329001007,66,34,32,1.73
2020,CB2020,081,4,Queens,40329001008,69,40,29,1.4
2020,CB2020,081,4,Queens,40329001009,159,82,77,2.1
2020,CB2020,081,4,Queens,40329001010,144,54,90,1.93
2020,CB2020,081,4,Queens,40329001011,329,136,193,4.03
2020,CB2020,081,4,Queens,40329001012,290,176,114,4.02
2020,CB2020,081,4,Queens,40329002000,430,240,190,11.89
2020,CB2020,081,4,Queens,40329002001,246,109,137,11.23
2020,CB2020,081,4,Queens,40329002002,0,0,0,0.58
2020,CB2020,081,4,Queens,40329002003,0,0,0,0.32
2020,CB2020,081,4,Queens,40329002004,188,88,100,3.75
2020,CB2020,081,4,Queens,40329002005,178,94,84,3.98
2020,CB2020,081,4,Queens,40329002006,313,162,151,3.99
2020,CB2020,081,4,Queens,40329003000,34,14,20,7.74
2020,CB2020,081,4,Queens,40329003001,39,14,25,3.88
2020,CB2020,081,4,Queens,40329003002,221,122,99,4.17
2020,CB2020,081,4,Queens,40329003003,0,0,0,0.52
2020,CB2020,081,4,Queens,40329003004,0,0,0,1.16
2020,CB2020,081,4,Queens,40329003005,106,68,38,2.84
2020,CB2020,081,4,Queens,40329003006,177,86,91,3.13
2020,CB2020,081,4,Queens,40329003007,225,115,110,4.04
2020,CB2020,081,4,Queens,40329003008,0,0,0,4.02
2020,CB2020,081,4,Queens,40329003009,372,174,198,4.03
2020,CB2020,081,4,Queens,40330001000,184,98,86,5.9
2020,CB2020,081,4,Queens,40330001001,51,37,14,1.26
2020,CB2020,081,4,Queens,40330001002,479,193,286,10.01
2020,CB2020,081,4,Queens,40330001003,223,98,125,5.31
2020,CB2020,081,4,Queens,40330001004,182,96,86,2.92
2020,CB2020,081,4,Queens,40330001005,141,72,69,4.75
2020,CB2020,081,4,Queens,40330001006,144,62,82,4.87
2020,CB2020,081,4,Queens,40330001007,200,64,136,2.82
2020,CB2020,081,4,Queens,40330001008,95,46,49,2.23
2020,CB2020,081,4,Queens,40330001009,100,46,54,20.46
2020,CB2020,081,4,Queens,40330001010,94,55,39,2.55
2020,CB2020,081,4,Queens,40330001011,91,52,39,2.33
2020,CB2020,081,4,Queens,40330001012,95,30,65,3.34
2020,CB2020,081,4,Queens,40330001013,105,46,59,2.06
2020,CB2020,081,4,Queens,40330002000,156,85,71,5.14
2020,CB2020,081,4,Queens,40330002001,143,74,69,4.54
2020,CB2020,081,4,Queens,40330002002,161,74,87,5.3
2020,CB2020,081,4,Queens,40330002003,129,64,65,2.7
2020,CB2020,081,4,Queens,40330002004,114,47,67,2.63
2020,CB2020,081,4,Queens,40330002005,110,64,46,2.66
2020,CB2020,081,4,Queens,40330002006,300,109,191,7.63
2020,CB2020,081,4,Queens,40330003000,166,84,82,3.62
2020,CB2020,081,4,Queens,40330003001,67,49,18,1.3
2020,CB2020,081,4,Queens,40330003002,94,54,40,2.02
2020,CB2020,081,4,Queens,40330003003,108,35,73,4.14
2020,CB2020,081,4,Queens,40330003004,114,64,50,2.64
2020,CB2020,081,4,Queens,40330003005,96,34,62,2.5
2020,CB2020,081,4,Queens,40330003006,55,19,36,1.73
2020,CB2020,081,4,Queens,40330003007,42,28,14,1.06
2020,CB2020,081,4,Queens,40330003008,71,31,40,1.86
2020,CB2020,081,4,Queens,40330003009,147,61,86,2.84
2020,CB2020,081,4,Queens,40330003010,250,116,134,7.07
2020,CB2020,081,4,Queens,40330003011,99,30,69,1.87
2020,CB2020,081,4,Queens,40330003012,82,43,39,2.66
2020,CB2020,081,4,Queens,40330003013,94,39,55,1.77
2020,CB2020,081,4,Queens,40330004000,375,178,197,6.62
2020,CB2020,081,4,Queens,40330004001,171,71,100,3.67
2020,CB2020,081,4,Queens,40330004002,152,57,95,3.33
2020,CB2020,081,4,Queens,40330004003,124,50,74,3
2020,CB2020,081,4,Queens,40330004004,184,97,87,4.21
2020,CB2020,081,4,Queens,40330004005,219,119,100,6.22
2020,CB2020,081,4,Queens,40330004006,109,27,82,2.73
2020,CB2020,081,4,Queens,40330005000,117,46,71,3.34
2020,CB2020,081,4,Queens,40330005001,93,46,47,3.14
2020,CB2020,081,4,Queens,40330005002,73,36,37,4.08
2020,CB2020,081,4,Queens,40330005003,230,88,142,6.42
2020,CB2020,081,4,Queens,40330005004,70,28,42,2.21
2020,CB2020,081,4,Queens,40330005005,72,50,22,2.12
2020,CB2020,081,4,Queens,40330005006,314,147,167,7.12
2020,CB2020,081,4,Queens,40330005007,280,136,144,5.25
2020,CB2020,081,4,Queens,40331000001,0,0,0,0
2020,CB2020,081,4,Queens,40331000002,0,0,0,0
2020,CB2020,081,4,Queens,40331000003,0,0,0,0
2020,CB2020,081,4,Queens,40331000004,0,0,0,0
2020,CB2020,081,4,Queens,40331000005,0,0,0,0
2020,CB2020,081,4,Queens,40331000006,0,0,0,0
2020,CB2020,081,4,Queens,40331001000,0,0,0,670.91
2020,CB2020,081,4,Queens,40331001001,0,0,0,17.19
2020,CB2020,081,4,Queens,40331001002,0,0,0,12.97
2020,CB2020,081,4,Queens,40334011000,53,37,16,5.06
2020,CB2020,081,4,Queens,40334011001,0,0,0,1.05
2020,CB2020,081,4,Queens,40334011002,204,102,102,4.32
2020,CB2020,081,4,Queens,40334011003,177,79,98,4.41
2020,CB2020,081,4,Queens,40334011004,226,96,130,5.46
2020,CB2020,081,4,Queens,40334011005,126,52,74,2.83
2020,CB2020,081,4,Queens,40334011006,71,24,47,2.95
2020,CB2020,081,4,Queens,40334011007,152,57,95,3.61
2020,CB2020,081,4,Queens,40334011008,92,39,53,2.56
2020,CB2020,081,4,Queens,40334011009,124,83,41,2.49
2020,CB2020,081,4,Queens,40334011010,176,83,93,3.39
2020,CB2020,081,4,Queens,40334012000,226,96,130,6.59
2020,CB2020,081,4,Queens,40334012001,169,74,95,3.29
2020,CB2020,081,4,Queens,40334012002,102,43,59,2.47
2020,CB2020,081,4,Queens,40334012003,673,279,394,16.93
2020,CB2020,081,4,Queens,40334012004,98,28,70,2.54
2020,CB2020,081,4,Queens,40334012005,77,32,45,2.47
2020,CB2020,081,4,Queens,40334012006,41,14,27,1.97
2020,CB2020,081,4,Queens,40334012007,78,31,47,2.52
2020,CB2020,081,4,Queens,40334012008,37,22,15,1.23
2020,CB2020,081,4,Queens,40334012009,47,37,10,1.38
2020,CB2020,081,4,Queens,40334012010,391,170,221,9.01
2020,CB2020,081,4,Queens,40334012011,348,150,198,22.4
2020,CB2020,081,4,Queens,40334012012,101,50,51,2.71
2020,CB2020,081,4,Queens,40334012013,43,38,5,2.14
2020,CB2020,081,4,Queens,40334012014,202,91,111,6.4
2020,CB2020,081,4,Queens,40334012015,33,15,18,10.14
2020,CB2020,081,4,Queens,40334012016,129,31,98,6.22
2020,CB2020,081,4,Queens,40334031000,1570,593,977,17.28
2020,CB2020,081,4,Queens,40334031001,865,347,518,6.14
2020,CB2020,081,4,Queens,40334032000,2439,969,1470,39.54
2020,CB2020,081,4,Queens,40334041000,2349,889,1460,23.83
2020,CB2020,081,4,Queens,40334042000,2374,919,1455,33.24
2020,CB2020,081,4,Queens,40334051000,2374,932,1442,25.18
2020,CB2020,081,4,Queens,40334052000,105,54,51,2.84
2020,CB2020,081,4,Queens,40334052001,110,59,51,2.98
2020,CB2020,081,4,Queens,40334052002,98,38,60,2.89
2020,CB2020,081,4,Queens,40334052003,90,42,48,2.73
2020,CB2020,081,4,Queens,40334052004,104,34,70,4.04
2020,CB2020,081,4,Queens,40334052005,119,49,70,4.17
2020,CB2020,081,4,Queens,40334052006,73,33,40,3.17
2020,CB2020,081,4,Queens,40334052007,58,29,29,3
2020,CB2020,081,4,Queens,40334052008,89,49,40,1.48
2020,CB2020,081,4,Queens,40334052009,93,29,64,3.86
2020,CB2020,081,4,Queens,40334052010,103,56,47,3.75
2020,CB2020,081,4,Queens,40334052011,120,57,63,3.64
2020,CB2020,081,4,Queens,40334052012,117,51,66,3.48
2020,CB2020,081,4,Queens,40337001000,307,147,160,4.35
2020,CB2020,081,4,Queens,40337001001,174,85,89,2.18
2020,CB2020,081,4,Queens,40337001002,277,139,138,2.18
2020,CB2020,081,4,Queens,40337001003,407,210,197,4.36
2020,CB2020,081,4,Queens,40337001004,359,195,164,3.41
2020,CB2020,081,4,Queens,40337001005,163,87,76,1.97
2020,CB2020,081,4,Queens,40337001006,301,165,136,3.41
2020,CB2020,081,4,Queens,40337001007,166,80,86,1.43
2020,CB2020,081,4,Queens,40337002000,316,175,141,3.77
2020,CB2020,081,4,Queens,40337002001,246,123,123,2.06
2020,CB2020,081,4,Queens,40337002002,288,167,121,1.88
2020,CB2020,081,4,Queens,40337002003,580,309,271,4.66
2020,CB2020,081,4,Queens,40337002004,63,34,29,0.72
2020,CB2020,081,4,Queens,40337002005,118,51,67,0.89
2020,CB2020,081,4,Queens,40339001000,285,140,145,4.35
2020,CB2020,081,4,Queens,40339001001,285,149,136,4.37
2020,CB2020,081,4,Queens,40339001002,400,199,201,3.41
2020,CB2020,081,4,Queens,40339001003,549,255,294,3.4
2020,CB2020,081,4,Queens,40339002000,35,18,17,4.67
2020,CB2020,081,4,Queens,40339002001,793,360,433,4.66
2020,CB2020,081,4,Queens,40339003000,316,158,158,4.35
2020,CB2020,081,4,Queens,40339003001,395,214,181,3.4
2020,CB2020,081,4,Queens,40339003002,423,209,214,4.66
2020,CB2020,081,4,Queens,40347001000,233,121,112,4.15
2020,CB2020,081,4,Queens,40347001001,240,131,109,3.99
2020,CB2020,081,4,Queens,40347001002,323,156,167,5.93
2020,CB2020,081,4,Queens,40347001003,0,0,0,0.41
2020,CB2020,081,4,Queens,40347001004,0,0,0,1.22
2020,CB2020,081,4,Queens,40347001005,50,23,27,1.79
2020,CB2020,081,4,Queens,40347001006,75,33,42,2.47
2020,CB2020,081,4,Queens,40347001007,262,125,137,3.97
2020,CB2020,081,4,Queens,40347001008,363,178,185,3.8
2020,CB2020,081,4,Queens,40347001009,292,133,159,3.79
2020,CB2020,081,4,Queens,40347002000,0,0,0,6.49
2020,CB2020,081,4,Queens,40347002001,0,0,0,14.28
2020,CB2020,081,4,Queens,40347002002,240,145,95,4.66
2020,CB2020,081,4,Queens,40347002003,112,59,53,8.56
2020,CB2020,081,4,Queens,40347002004,104,75,29,9.09
2020,CB2020,081,4,Queens,40347002005,357,183,174,6.02
2020,CB2020,081,4,Queens,40347002006,365,200,165,4.58
2020,CB2020,081,4,Queens,40347002007,367,167,200,4.57
2020,CB2020,081,4,Queens,40347002008,305,127,178,4.82
2020,CB2020,081,4,Queens,40351001000,275,137,138,2.8
2020,CB2020,081,4,Queens,40351001001,309,152,157,3.49
2020,CB2020,081,4,Queens,40351001002,696,326,370,4.58
2020,CB2020,081,4,Queens,40351002000,328,166,162,3.41
2020,CB2020,081,4,Queens,40351002001,668,292,376,4.66
2020,CB2020,081,4,Queens,40351002002,818,363,455,4.67
2020,CB2020,081,4,Queens,40351003000,303,163,140,3.4
2020,CB2020,081,4,Queens,40351003001,253,114,139,4
2020,CB2020,081,4,Queens,40351003002,528,273,255,3.4
2020,CB2020,081,4,Queens,40352001000,241,126,115,11.2
2020,CB2020,081,4,Queens,40352001001,114,60,54,4.2
2020,CB2020,081,4,Queens,40352001002,65,36,29,1.85
2020,CB2020,081,4,Queens,40352001003,202,115,87,6.92
2020,CB2020,081,4,Queens,40352001004,26,9,17,2.13
2020,CB2020,081,4,Queens,40352001005,30,2,28,1.01
2020,CB2020,081,4,Queens,40352001006,68,37,31,2.24
2020,CB2020,081,4,Queens,40352001007,77,21,56,2.68
2020,CB2020,081,4,Queens,40352001008,120,39,81,3.03
2020,CB2020,081,4,Queens,40352001009,62,36,26,2.8
2020,CB2020,081,4,Queens,40352001010,56,31,25,6.62
2020,CB2020,081,4,Queens,40352001011,20,11,9,1.62
2020,CB2020,081,4,Queens,40352001012,79,31,48,6.8
2020,CB2020,081,4,Queens,40352001013,34,11,23,2.1
2020,CB2020,081,4,Queens,40352001014,5,2,3,23.38
2020,CB2020,081,4,Queens,40352001015,82,47,35,1.86
2020,CB2020,081,4,Queens,40352002000,0,0,0,15.36
2020,CB2020,081,4,Queens,40352002001,196,103,93,8.69
2020,CB2020,081,4,Queens,40352002002,125,55,70,2.95
2020,CB2020,081,4,Queens,40352002003,28,15,13,12.1
2020,CB2020,081,4,Queens,40352002004,102,38,64,2.41
2020,CB2020,081,4,Queens,40352002005,112,46,66,5.14
2020,CB2020,081,4,Queens,40352002006,143,70,73,4.4
2020,CB2020,081,4,Queens,40352002007,65,49,16,3.79
2020,CB2020,081,4,Queens,40352002008,99,32,67,2.28
2020,CB2020,081,4,Queens,40352002009,14,3,11,0.85
2020,CB2020,081,4,Queens,40352002010,147,75,72,4.98
2020,CB2020,081,4,Queens,40352002011,134,50,84,3.31
2020,CB2020,081,4,Queens,40352002012,104,52,52,3.1
2020,CB2020,081,4,Queens,40353001000,260,124,136,3.71
2020,CB2020,081,4,Queens,40353001001,347,137,210,4.39
2020,CB2020,081,4,Queens,40353001002,79,40,39,1.75
2020,CB2020,081,4,Queens,40353001003,189,90,99,2.27
2020,CB2020,081,4,Queens,40353001004,217,108,109,3.23
2020,CB2020,081,4,Queens,40353001005,187,98,89,2.24
2020,CB2020,081,4,Queens,40353001006,33,19,14,0.88
2020,CB2020,081,4,Queens,40353001007,104,50,54,1.34
2020,CB2020,081,4,Queens,40353001008,106,58,48,1.62
2020,CB2020,081,4,Queens,40353002000,253,125,128,3.47
2020,CB2020,081,4,Queens,40353002001,0,0,0,0.46
2020,CB2020,081,4,Queens,40353002002,294,143,151,5.43
2020,CB2020,081,4,Queens,40353002003,313,168,145,3.65
2020,CB2020,081,4,Queens,40353002004,338,164,174,2.94
2020,CB2020,081,4,Queens,40353002005,108,63,45,0.96
2020,CB2020,081,4,Queens,40357001000,0,0,0,3.01
2020,CB2020,081,4,Queens,40357001001,0,0,0,7.91
2020,CB2020,081,4,Queens,40357001002,165,64,101,9.26
2020,CB2020,081,4,Queens,40357001003,252,102,150,4.18
2020,CB2020,081,4,Queens,40357001004,272,143,129,4.43
2020,CB2020,081,4,Queens,40357001005,233,126,107,4.39
2020,CB2020,081,4,Queens,40357001006,255,155,100,4.4
2020,CB2020,081,4,Queens,40357001007,315,160,155,3.84
2020,CB2020,081,4,Queens,40357001008,297,127,170,3.83
2020,CB2020,081,4,Queens,40357001009,124,76,48,1.32
2020,CB2020,081,4,Queens,40357001010,169,74,95,3.27
2020,CB2020,081,4,Queens,40357001011,0,0,0,0.72
2020,CB2020,081,4,Queens,40357002000,0,0,0,0.96
2020,CB2020,081,4,Queens,40357002001,15,10,5,8.65
2020,CB2020,081,4,Queens,40357002002,382,180,202,10.93
2020,CB2020,081,4,Queens,40357002003,190,80,110,4.06
2020,CB2020,081,4,Queens,40357002004,272,136,136,4.47
2020,CB2020,081,4,Queens,40357002005,275,139,136,4.48
2020,CB2020,081,4,Queens,40357002006,242,112,130,5.01
2020,CB2020,081,4,Queens,40357002007,90,56,34,8.26
2020,CB2020,081,4,Queens,40357002008,232,96,136,3.91
2020,CB2020,081,4,Queens,40357003000,0,0,0,3.1
2020,CB2020,081,4,Queens,40357003001,233,174,59,13.99
2020,CB2020,081,4,Queens,40357003002,166,91,75,1.29
2020,CB2020,081,4,Queens,40357003003,0,0,0,1.16
2020,CB2020,081,4,Queens,40357003004,0,0,0,0.87
2020,CB2020,081,4,Queens,40357003005,398,183,215,2.68
2020,CB2020,081,4,Queens,40357003006,224,115,109,4.66
2020,CB2020,081,4,Queens,40357003007,212,85,127,4.53
2020,CB2020,081,4,Queens,40357003008,139,57,82,10.96
2020,CB2020,081,4,Queens,40357003009,171,86,85,3.32
2020,CB2020,081,4,Queens,40357003010,233,129,104,3.77
2020,CB2020,081,4,Queens,40357003011,37,18,19,1.21
2020,CB2020,081,4,Queens,40358001000,28,2,26,1.71
2020,CB2020,081,4,Queens,40358001001,0,0,0,1.9
2020,CB2020,081,4,Queens,40358001002,90,41,49,2.93
2020,CB2020,081,4,Queens,40358001003,67,29,38,2.86
2020,CB2020,081,4,Queens,40358001004,31,13,18,2.63
2020,CB2020,081,4,Queens,40358001005,84,39,45,2.75
2020,CB2020,081,4,Queens,40358001006,49,29,20,2.96
2020,CB2020,081,4,Queens,40358001007,140,65,75,5.78
2020,CB2020,081,4,Queens,40358001008,254,91,163,5.93
2020,CB2020,081,4,Queens,40358001009,95,37,58,2.44
2020,CB2020,081,4,Queens,40358002000,234,114,120,3.97
2020,CB2020,081,4,Queens,40358002001,125,54,71,2.03
2020,CB2020,081,4,Queens,40358002002,62,45,17,2.08
2020,CB2020,081,4,Queens,40358002003,84,34,50,2.11
2020,CB2020,081,4,Queens,40358002004,110,50,60,2.11
2020,CB2020,081,4,Queens,40358002005,137,70,67,2.56
2020,CB2020,081,4,Queens,40358002006,78,41,37,2.15
2020,CB2020,081,4,Queens,40358002007,123,62,61,2.89
2020,CB2020,081,4,Queens,40358002008,163,80,83,3.58
2020,CB2020,081,4,Queens,40358002009,119,29,90,2.82
2020,CB2020,081,4,Queens,40358002010,104,63,41,2.85
2020,CB2020,081,4,Queens,40358002011,131,57,74,2.88
2020,CB2020,081,4,Queens,40358002012,144,72,72,2.86
2020,CB2020,081,4,Queens,40358002013,24,14,10,3.42
2020,CB2020,081,4,Queens,40358002014,153,39,114,3.56
2020,CB2020,081,4,Queens,40358003000,119,30,89,4.28
2020,CB2020,081,4,Queens,40358003001,127,58,69,4.49
2020,CB2020,081,4,Queens,40358003002,106,60,46,2.55
2020,CB2020,081,4,Queens,40358003003,81,30,51,1.72
2020,CB2020,081,4,Queens,40358003004,98,40,58,1.73
2020,CB2020,081,4,Queens,40358003005,85,35,50,1.71
2020,CB2020,081,4,Queens,40358003006,114,62,52,3.66
2020,CB2020,081,4,Queens,40358003007,74,25,49,1.89
2020,CB2020,081,4,Queens,40358003008,90,39,51,2.08
2020,CB2020,081,4,Queens,40358003009,94,44,50,2.01
2020,CB2020,081,4,Queens,40358003010,76,36,40,1.92
2020,CB2020,081,4,Queens,40358003011,109,52,57,2.89
2020,CB2020,081,4,Queens,40358004000,178,86,92,5.24
2020,CB2020,081,4,Queens,40358004001,49,27,22,1.67
2020,CB2020,081,4,Queens,40358004002,118,59,59,4.35
2020,CB2020,081,4,Queens,40358004003,99,34,65,3.32
2020,CB2020,081,4,Queens,40358004004,75,47,28,3.31
2020,CB2020,081,4,Queens,40358004005,68,17,51,3.17
2020,CB2020,081,4,Queens,40358004006,78,37,41,2.27
2020,CB2020,081,4,Queens,40358004007,41,11,30,1.55
2020,CB2020,081,4,Queens,40361001000,283,137,146,4.69
2020,CB2020,081,4,Queens,40361001001,228,105,123,3.98
2020,CB2020,081,4,Queens,40361001002,170,80,90,3.5
2020,CB2020,081,4,Queens,40361001003,219,105,114,3.45
2020,CB2020,081,4,Queens,40361001004,62,36,26,3.78
2020,CB2020,081,4,Queens,40361001005,0,0,0,0.49
2020,CB2020,081,4,Queens,40361001006,372,151,221,2.93
2020,CB2020,081,4,Queens,40361001007,0,0,0,0.28
2020,CB2020,081,4,Queens,40361002000,370,201,169,4.17
2020,CB2020,081,4,Queens,40361002001,137,67,70,1.74
2020,CB2020,081,4,Queens,40361002002,186,105,81,2.01
2020,CB2020,081,4,Queens,40361002003,321,167,154,3.91
2020,CB2020,081,4,Queens,40361002004,358,169,189,3.98
2020,CB2020,081,4,Queens,40363001000,0,0,0,2.01
2020,CB2020,081,4,Queens,40363001001,101,54,47,2.73
2020,CB2020,081,4,Queens,40363001002,226,125,101,3.03
2020,CB2020,081,4,Queens,40363001003,291,124,167,3.91
2020,CB2020,081,4,Queens,40363001004,375,181,194,4.39
2020,CB2020,081,4,Queens,40363001005,325,185,140,4.38
2020,CB2020,081,4,Queens,40363002000,388,207,181,4.45
2020,CB2020,081,4,Queens,40363002001,311,149,162,3.48
2020,CB2020,081,4,Queens,40363002002,258,143,115,3.1
2020,CB2020,081,4,Queens,40363002003,82,62,20,0.88
2020,CB2020,081,4,Queens,40363002004,105,53,52,0.97
2020,CB2020,081,4,Queens,40365001000,242,143,99,2.81
2020,CB2020,081,4,Queens,40365001001,301,150,151,3.33
2020,CB2020,081,4,Queens,40365001002,386,203,183,4.48
2020,CB2020,081,4,Queens,40365001003,0,0,0,0.85
2020,CB2020,081,4,Queens,40365001004,51,37,14,1.2
2020,CB2020,081,4,Queens,40365001005,359,173,186,3.88
2020,CB2020,081,4,Queens,40365001006,369,176,193,3.8
2020,CB2020,081,4,Queens,40365002000,517,247,270,4.2
2020,CB2020,081,4,Queens,40365002001,541,299,242,4.07
2020,CB2020,081,4,Queens,40365002002,441,189,252,4.63
2020,CB2020,081,4,Queens,40365002003,445,238,207,3.9
2020,CB2020,081,4,Queens,40365002004,490,243,247,3.91
2020,CB2020,081,4,Queens,40366001000,67,27,40,1.71
2020,CB2020,081,4,Queens,40366001001,70,24,46,7.26
2020,CB2020,081,4,Queens,40366001002,147,56,91,3.75
2020,CB2020,081,4,Queens,40366001003,107,39,68,1.87
2020,CB2020,081,4,Queens,40366001004,10,5,5,3.12
2020,CB2020,081,4,Queens,40366001005,109,46,63,2.78
2020,CB2020,081,4,Queens,40366001006,111,32,79,2.63
2020,CB2020,081,4,Queens,40366001007,88,45,43,2.88
2020,CB2020,081,4,Queens,40366001008,0,0,0,2.69
2020,CB2020,081,4,Queens,40366001009,119,53,66,4.24
2020,CB2020,081,4,Queens,40366001010,199,91,108,6.22
2020,CB2020,081,4,Queens,40366001011,169,71,98,8.51
2020,CB2020,081,4,Queens,40366001012,64,20,44,1.73
2020,CB2020,081,4,Queens,40366001013,128,74,54,2.76
2020,CB2020,081,4,Queens,40366001014,110,53,57,2.46
2020,CB2020,081,4,Queens,40366002000,191,89,102,3.59
2020,CB2020,081,4,Queens,40366002001,200,108,92,5.03
2020,CB2020,081,4,Queens,40366002002,288,146,142,5.03
2020,CB2020,081,4,Queens,40366002003,200,76,124,4.21
2020,CB2020,081,4,Queens,40366002004,123,55,68,3.34
2020,CB2020,081,4,Queens,40366002005,63,25,38,2.73
2020,CB2020,081,4,Queens,40366002006,103,55,48,2.82
2020,CB2020,081,4,Queens,40366002007,126,44,82,2.75
2020,CB2020,081,4,Queens,40366002008,160,86,74,2
2020,CB2020,081,4,Queens,40366002009,51,28,23,5.23
2020,CB2020,081,4,Queens,40367001000,134,73,61,3.13
2020,CB2020,081,4,Queens,40367001001,231,81,150,3.19
2020,CB2020,081,4,Queens,40367001002,249,121,128,3.67
2020,CB2020,081,4,Queens,40367001003,223,114,109,2.1
2020,CB2020,081,4,Queens,40367002000,214,107,107,4.02
2020,CB2020,081,4,Queens,40367002001,163,88,75,4.02
2020,CB2020,081,4,Queens,40367002002,287,134,153,4.09
2020,CB2020,081,4,Queens,40367002003,222,95,127,3.5
2020,CB2020,081,4,Queens,40367002004,30,7,23,1.31
2020,CB2020,081,4,Queens,40367002005,543,282,261,5.69
2020,CB2020,081,4,Queens,40367002006,382,197,185,5.18
2020,CB2020,081,4,Queens,40367002007,164,66,98,3.65
2020,CB2020,081,4,Queens,40367002008,158,81,77,2.74
2020,CB2020,081,4,Queens,40367002009,60,35,25,1.15
2020,CB2020,081,4,Queens,40367002010,39,23,16,0.89
2020,CB2020,081,4,Queens,40368001000,123,50,73,3.25
2020,CB2020,081,4,Queens,40368001001,105,31,74,2.65
2020,CB2020,081,4,Queens,40368001002,145,66,79,3.38
2020,CB2020,081,4,Queens,40368001003,122,57,65,3.56
2020,CB2020,081,4,Queens,40368001004,143,44,99,3.52
2020,CB2020,081,4,Queens,40368001005,136,58,78,3.51
2020,CB2020,081,4,Queens,40368001006,171,102,69,3.53
2020,CB2020,081,4,Queens,40368001007,118,62,56,3.43
2020,CB2020,081,4,Queens,40368001008,157,62,95,4.35
2020,CB2020,081,4,Queens,40368002000,47,29,18,1.18
2020,CB2020,081,4,Queens,40368002001,112,82,30,2.46
2020,CB2020,081,4,Queens,40368002002,173,73,100,3.57
2020,CB2020,081,4,Queens,40368002003,215,94,121,3.82
2020,CB2020,081,4,Queens,40368002004,76,46,30,2.53
2020,CB2020,081,4,Queens,40368002005,24,13,11,0.61
2020,CB2020,081,4,Queens,40368002006,64,26,38,2.49
2020,CB2020,081,4,Queens,40368002007,225,88,137,2.67
2020,CB2020,081,4,Queens,40368002008,185,70,115,3.15
2020,CB2020,081,4,Queens,40368002009,141,74,67,2.38
2020,CB2020,081,4,Queens,40368002010,31,22,9,1.49
2020,CB2020,081,4,Queens,40371001000,0,0,0,3.31
2020,CB2020,081,4,Queens,40371001001,329,194,135,10.53
2020,CB2020,081,4,Queens,40371001002,114,52,62,3.26
2020,CB2020,081,4,Queens,40371001003,218,112,106,4.42
2020,CB2020,081,4,Queens,40371001004,147,71,76,3.36
2020,CB2020,081,4,Queens,40371001005,113,45,68,3.13
2020,CB2020,081,4,Queens,40371001006,159,70,89,3.14
2020,CB2020,081,4,Queens,40371001007,229,106,123,4.03
2020,CB2020,081,4,Queens,40371001008,217,81,136,4.04
2020,CB2020,081,4,Queens,40371001009,194,132,62,3.56
2020,CB2020,081,4,Queens,40371001010,197,91,106,3.56
2020,CB2020,081,4,Queens,40373001000,153,67,86,3.68
2020,CB2020,081,4,Queens,40373001001,153,65,88,3.51
2020,CB2020,081,4,Queens,40373001002,45,18,27,1.9
2020,CB2020,081,4,Queens,40373001003,131,71,60,2.21
2020,CB2020,081,4,Queens,40373001004,85,34,51,1.43
2020,CB2020,081,4,Queens,40373001005,466,235,231,4.45
2020,CB2020,081,4,Queens,40373001006,465,273,192,4.31
2020,CB2020,081,4,Queens,40373002000,22,9,13,12.11
2020,CB2020,081,4,Queens,40373002001,91,45,46,3.21
2020,CB2020,081,4,Queens,40373002002,128,77,51,2.9
2020,CB2020,081,4,Queens,40373002003,245,136,109,3.06
2020,CB2020,081,4,Queens,40373002004,0,0,0,2.67
2020,CB2020,081,4,Queens,40373002005,383,202,181,6.42
2020,CB2020,081,4,Queens,40373002006,355,156,199,5.54
2020,CB2020,081,4,Queens,40373002007,165,73,92,1.22
2020,CB2020,081,4,Queens,40375011000,176,78,98,1.68
2020,CB2020,081,4,Queens,40375011001,602,355,247,3.16
2020,CB2020,081,4,Queens,40375011002,352,203,149,2.54
2020,CB2020,081,4,Queens,40375011003,290,162,128,2.82
2020,CB2020,081,4,Queens,40375011004,59,29,30,2.92
2020,CB2020,081,4,Queens,40375021000,321,182,139,3.85
2020,CB2020,081,4,Queens,40375021001,424,250,174,3.72
2020,CB2020,081,4,Queens,40375021002,149,75,74,1.12
2020,CB2020,081,4,Queens,40375021003,0,0,0,1.7
2020,CB2020,081,4,Queens,40375021004,491,242,249,4.01
2020,CB2020,081,4,Queens,40375021005,384,218,166,4.44
2020,CB2020,081,4,Queens,40375022000,857,442,415,4.6
2020,CB2020,081,4,Queens,40375022001,152,102,50,1.3
2020,CB2020,081,4,Queens,40376001000,123,44,79,2.23
2020,CB2020,081,4,Queens,40376001001,83,43,40,2.23
2020,CB2020,081,4,Queens,40376001002,96,29,67,2.23
2020,CB2020,081,4,Queens,40376001003,95,52,43,2.25
2020,CB2020,081,4,Queens,40376001004,151,74,77,3.76
2020,CB2020,081,4,Queens,40376001005,171,75,96,3.73
2020,CB2020,081,4,Queens,40376001006,181,98,83,3.73
2020,CB2020,081,4,Queens,40376001007,177,84,93,3.73
2020,CB2020,081,4,Queens,40376002000,97,52,45,2.98
2020,CB2020,081,4,Queens,40376002001,153,70,83,3.1
2020,CB2020,081,4,Queens,40376002002,151,69,82,3.31
2020,CB2020,081,4,Queens,40376002003,167,78,89,3.47
2020,CB2020,081,4,Queens,40376002004,131,35,96,3.49
2020,CB2020,081,4,Queens,40376002005,142,72,70,3.7
2020,CB2020,081,4,Queens,40376002006,152,64,88,3.76
2020,CB2020,081,4,Queens,40376002007,150,67,83,3.8
2020,CB2020,081,4,Queens,40376002008,222,87,135,7.15
2020,CB2020,081,4,Queens,40376002009,147,89,58,3.86
2020,CB2020,081,4,Queens,40376003000,115,45,70,3.07
2020,CB2020,081,4,Queens,40376003001,127,45,82,2.97
2020,CB2020,081,4,Queens,40376003002,80,40,40,3.18
2020,CB2020,081,4,Queens,40376003003,122,55,67,3.16
2020,CB2020,081,4,Queens,40376003004,115,39,76,3.35
2020,CB2020,081,4,Queens,40376003005,81,39,42,2.43
2020,CB2020,081,4,Queens,40376003006,84,55,29,2.69
2020,CB2020,081,4,Queens,40376003007,89,35,54,2.62
2020,CB2020,081,4,Queens,40376003008,81,39,42,2.68
2020,CB2020,081,4,Queens,40376003009,105,41,64,2.64
2020,CB2020,081,4,Queens,40376004000,18,5,13,5.48
2020,CB2020,081,4,Queens,40376004001,128,56,72,3.75
2020,CB2020,081,4,Queens,40376004002,167,83,84,3.87
2020,CB2020,081,4,Queens,40376004003,121,66,55,3
2020,CB2020,081,4,Queens,40376004004,172,85,87,3.03
2020,CB2020,081,4,Queens,40376004005,58,17,41,2.36
2020,CB2020,081,4,Queens,40376004006,78,31,47,2.35
2020,CB2020,081,4,Queens,40376004007,49,15,34,0.93
2020,CB2020,081,4,Queens,40376004008,0,0,0,1.8
2020,CB2020,081,4,Queens,40376004009,168,72,96,4.52
2020,CB2020,081,4,Queens,40376004010,50,14,36,2.23
2020,CB2020,081,4,Queens,40376004011,96,56,40,3.58
2020,CB2020,081,4,Queens,40376004012,112,62,50,4.41
2020,CB2020,081,4,Queens,40376004013,90,30,60,3.8
2020,CB2020,081,4,Queens,40376004014,0,0,0,0.45
2020,CB2020,081,4,Queens,40376004015,74,30,44,2.13
2020,CB2020,081,4,Queens,40376004016,102,35,67,2.52
2020,CB2020,081,4,Queens,40376005000,70,33,37,6
2020,CB2020,081,4,Queens,40376005001,21,12,9,0.73
2020,CB2020,081,4,Queens,40376005002,101,33,68,2.82
2020,CB2020,081,4,Queens,40376005003,123,77,46,3.43
2020,CB2020,081,4,Queens,40376005004,173,72,101,7.64
2020,CB2020,081,4,Queens,40376005005,92,38,54,2.77
2020,CB2020,081,4,Queens,40376005006,107,55,52,3.61
2020,CB2020,081,4,Queens,40376005007,102,59,43,3.75
2020,CB2020,081,4,Queens,40376005008,87,48,39,5.21
2020,CB2020,081,4,Queens,40376005009,330,159,171,9.73
2020,CB2020,081,4,Queens,40376005010,96,52,44,3.06
2020,CB2020,081,4,Queens,40377001000,619,368,251,3.86
2020,CB2020,081,4,Queens,40377001001,571,289,282,4.41
2020,CB2020,081,4,Queens,40377001002,325,169,156,4.4
2020,CB2020,081,4,Queens,40377001003,551,270,281,3.94
2020,CB2020,081,4,Queens,40377001004,443,246,197,3.93
2020,CB2020,081,4,Queens,40377002000,339,167,172,2.54
2020,CB2020,081,4,Queens,40377002001,428,242,186,3.14
2020,CB2020,081,4,Queens,40377002002,390,218,172,3.38
2020,CB2020,081,4,Queens,40377002003,418,226,192,3.24
2020,CB2020,081,4,Queens,40377002004,409,230,179,3.44
2020,CB2020,081,4,Queens,40379001000,394,207,187,3.44
2020,CB2020,081,4,Queens,40379001001,410,223,187,3.58
2020,CB2020,081,4,Queens,40379001002,810,458,352,4.81
2020,CB2020,081,4,Queens,40379001003,964,491,473,4.67
2020,CB2020,081,4,Queens,40379002000,266,157,109,2.95
2020,CB2020,081,4,Queens,40379002001,538,279,259,3.25
2020,CB2020,081,4,Queens,40379002002,521,296,225,3.7
2020,CB2020,081,4,Queens,40379002003,271,150,121,2.37
2020,CB2020,081,4,Queens,40379002004,517,291,226,3.45
2020,CB2020,081,4,Queens,40379003000,485,255,230,3.7
2020,CB2020,081,4,Queens,40379003001,400,221,179,4.46
2020,CB2020,081,4,Queens,40379003002,408,223,185,3.87
2020,CB2020,081,4,Queens,40379003003,520,302,218,4.46
2020,CB2020,081,4,Queens,40381001000,590,264,326,5.69
2020,CB2020,081,4,Queens,40381001001,264,153,111,2.69
2020,CB2020,081,4,Queens,40381001002,201,95,106,2.92
2020,CB2020,081,4,Queens,40381001003,387,218,169,3.18
2020,CB2020,081,4,Queens,40381001004,303,134,169,2.74
2020,CB2020,081,4,Queens,40381001005,214,116,98,3.32
2020,CB2020,081,4,Queens,40381002000,1013,549,464,5.51
2020,CB2020,081,4,Queens,40381002001,306,177,129,2.26
2020,CB2020,081,4,Queens,40381002002,629,319,310,4.9
2020,CB2020,081,4,Queens,40381002003,414,234,180,2.6
2020,CB2020,081,4,Queens,40381002004,487,250,237,3.16
2020,CB2020,081,4,Queens,40381003000,0,0,0,8.46
2020,CB2020,081,4,Queens,40381003001,21,7,14,5.75
2020,CB2020,081,4,Queens,40381003002,331,144,187,6.4
2020,CB2020,081,4,Queens,40381003003,928,527,401,5.46
2020,CB2020,081,4,Queens,40381003004,878,472,406,5.48
2020,CB2020,081,4,Queens,40383010001,2,1,1,0
2020,CB2020,081,4,Queens,40383010002,0,0,0,0
2020,CB2020,081,4,Queens,40383011000,0,0,0,2.45
2020,CB2020,081,4,Queens,40383011001,0,0,0,0.34
2020,CB2020,081,4,Queens,40383011002,0,0,0,3.46
2020,CB2020,081,4,Queens,40383011003,0,0,0,4.64
2020,CB2020,081,4,Queens,40383011004,0,0,0,0.34
2020,CB2020,081,4,Queens,40383011005,0,0,0,19.35
2020,CB2020,081,4,Queens,40383011006,0,0,0,2.5
2020,CB2020,081,4,Queens,40383011007,0,0,0,7.41
2020,CB2020,081,4,Queens,40383011008,0,0,0,3.22
2020,CB2020,081,4,Queens,40383011009,0,0,0,1.13
2020,CB2020,081,4,Queens,40383011010,0,0,0,1
2020,CB2020,081,4,Queens,40383011011,0,0,0,0.63
2020,CB2020,081,4,Queens,40383011012,0,0,0,8.3
2020,CB2020,081,4,Queens,40383011013,0,0,0,1.15
2020,CB2020,081,4,Queens,40383011014,0,0,0,2.95
2020,CB2020,081,4,Queens,40383011015,0,0,0,3.71
2020,CB2020,081,4,Queens,40383011016,0,0,0,4.28
2020,CB2020,081,4,Queens,40383011017,0,0,0,3.86
2020,CB2020,081,4,Queens,40383011018,0,0,0,35.22
2020,CB2020,081,4,Queens,40383011019,0,0,0,2.56
2020,CB2020,081,4,Queens,40383011020,0,0,0,1.16
2020,CB2020,081,4,Queens,40383011021,0,0,0,4.32
2020,CB2020,081,4,Queens,40383011022,0,0,0,4.22
2020,CB2020,081,4,Queens,40383011023,0,0,0,4.67
2020,CB2020,081,4,Queens,40383011024,0,0,0,2.67
2020,CB2020,081,4,Queens,40383011025,0,0,0,0.9
2020,CB2020,081,4,Queens,40383011026,0,0,0,11.16
2020,CB2020,081,4,Queens,40383011027,0,0,0,0
2020,CB2020,081,4,Queens,40383011028,0,0,0,0.82
2020,CB2020,081,4,Queens,40383020001,0,0,0,0
2020,CB2020,081,4,Queens,40383021000,0,0,0,33.66
2020,CB2020,081,4,Queens,40383021001,0,0,0,7.79
2020,CB2020,081,4,Queens,40383021002,0,0,0,1.23
2020,CB2020,081,4,Queens,40383021003,0,0,0,1.25
2020,CB2020,081,4,Queens,40383021004,0,0,0,1.2
2020,CB2020,081,4,Queens,40383021005,0,0,0,5.54
2020,CB2020,081,4,Queens,40383021006,0,0,0,18.12
2020,CB2020,081,4,Queens,40383021007,0,0,0,2.1
2020,CB2020,081,4,Queens,40383021008,0,0,0,0.99
2020,CB2020,081,4,Queens,40383021009,0,0,0,2.47
2020,CB2020,081,4,Queens,40383021010,3,3,0,9.31
2020,CB2020,081,4,Queens,40383021011,0,0,0,3.37
2020,CB2020,081,4,Queens,40383021012,0,0,0,6.93
2020,CB2020,081,4,Queens,40383021013,0,0,0,4.88
2020,CB2020,081,4,Queens,40383021014,0,0,0,65.52
2020,CB2020,081,4,Queens,40383021015,0,0,0,4.51
2020,CB2020,081,4,Queens,40383021016,0,0,0,0
2020,CB2020,081,4,Queens,40383021017,0,0,0,0
2020,CB2020,081,4,Queens,40383021018,4,3,1,3.73
2020,CB2020,081,4,Queens,40383021019,0,0,0,3.06
2020,CB2020,081,4,Queens,40383021020,0,0,0,16.35
2020,CB2020,081,4,Queens,40383021021,0,0,0,1.42
2020,CB2020,081,4,Queens,40383021022,0,0,0,0
2020,CB2020,081,4,Queens,40383021023,0,0,0,0
2020,CB2020,081,4,Queens,40383021024,4,0,4,200.1
2020,CB2020,081,4,Queens,40383021025,0,0,0,43.72
2020,CB2020,081,4,Queens,40383021026,0,0,0,5.28
2020,CB2020,081,4,Queens,40383021027,6,2,4,100.4
2020,CB2020,081,4,Queens,40383021028,0,0,0,2.17
2020,CB2020,081,4,Queens,40383021029,0,0,0,1.83
2020,CB2020,081,4,Queens,40383021030,0,0,0,20.17
2020,CB2020,081,4,Queens,40383021031,0,0,0,1.4
2020,CB2020,081,4,Queens,40383021032,0,0,0,1.33
2020,CB2020,081,4,Queens,40383021033,0,0,0,1.17
2020,CB2020,081,4,Queens,40383021034,0,0,0,0.56
2020,CB2020,081,4,Queens,40383021035,0,0,0,1.83
2020,CB2020,081,4,Queens,40383021036,0,0,0,1.17
2020,CB2020,081,4,Queens,40383021037,0,0,0,0.31
2020,CB2020,081,4,Queens,40383021038,0,0,0,1.75
2020,CB2020,081,4,Queens,40383021039,0,0,0,0.75
2020,CB2020,081,4,Queens,40383021040,0,0,0,1.05
2020,CB2020,081,4,Queens,40383021041,0,0,0,1.79
2020,CB2020,081,4,Queens,40383021042,0,0,0,0.94
2020,CB2020,081,4,Queens,40383021043,0,0,0,1.99
2020,CB2020,081,4,Queens,40383021044,3,3,0,23.2
2020,CB2020,081,4,Queens,40383021045,0,0,0,3.02
2020,CB2020,081,4,Queens,40383021046,0,0,0,5.6
2020,CB2020,081,4,Queens,40383021047,0,0,0,8.31
2020,CB2020,081,4,Queens,40383021048,0,0,0,1.25
2020,CB2020,081,4,Queens,40383021049,0,0,0,6.63
2020,CB2020,081,4,Queens,40383021050,0,0,0,0.37
2020,CB2020,081,4,Queens,40383021051,0,0,0,24.55
2020,CB2020,081,4,Queens,40383021052,0,0,0,6.51
2020,CB2020,081,4,Queens,40383021053,1,1,0,116.4
2020,CB2020,081,4,Queens,40383021054,0,0,0,1.74
2020,CB2020,081,4,Queens,40383021055,0,0,0,160.15
2020,CB2020,081,4,Queens,40383021056,0,0,0,0
2020,CB2020,081,4,Queens,40383021057,0,0,0,1.25
2020,CB2020,081,4,Queens,40383021058,0,0,0,0
2020,CB2020,081,4,Queens,40383021059,0,0,0,1.66
2020,CB2020,081,4,Queens,40383021060,0,0,0,0.47
2020,CB2020,081,4,Queens,40383021061,0,0,0,0.46
2020,CB2020,081,4,Queens,40383021062,0,0,0,3.52
2020,CB2020,081,4,Queens,40383021063,0,0,0,11.9
2020,CB2020,081,4,Queens,40383021064,6,4,2,12.22
2020,CB2020,081,4,Queens,40383021065,0,0,0,0.85
2020,CB2020,081,4,Queens,40383021066,0,0,0,0.16
2020,CB2020,081,4,Queens,40383021067,0,0,0,1.13
2020,CB2020,081,4,Queens,40383021068,0,0,0,0.72
2020,CB2020,081,4,Queens,40383021069,0,0,0,1.38
2020,CB2020,081,4,Queens,40383021070,0,0,0,0.67
2020,CB2020,081,4,Queens,40383021071,0,0,0,5.8
2020,CB2020,081,4,Queens,40383021072,0,0,0,0.55
2020,CB2020,081,4,Queens,40383021073,0,0,0,1.12
2020,CB2020,081,4,Queens,40383021074,0,0,0,1.43
2020,CB2020,081,4,Queens,40383021075,0,0,0,3.7
2020,CB2020,081,4,Queens,40383021076,0,0,0,0.46
2020,CB2020,081,4,Queens,40383021077,0,0,0,0.74
2020,CB2020,081,4,Queens,40383021078,0,0,0,0.53
2020,CB2020,081,4,Queens,40383021079,0,0,0,4.32
2020,CB2020,081,4,Queens,40383021080,0,0,0,2.12
2020,CB2020,081,4,Queens,40383021081,0,0,0,1.75
2020,CB2020,081,4,Queens,40383021082,0,0,0,4.2
2020,CB2020,081,4,Queens,40383021083,0,0,0,0.86
2020,CB2020,081,4,Queens,40383021084,0,0,0,5.56
2020,CB2020,081,4,Queens,40383021085,5,2,3,20.24
2020,CB2020,081,4,Queens,40383021086,0,0,0,0.56
2020,CB2020,081,4,Queens,40383021087,0,0,0,0.81
2020,CB2020,081,4,Queens,40383021088,0,0,0,2.9
2020,CB2020,081,4,Queens,40383021089,12,7,5,71.84
2020,CB2020,081,4,Queens,40383021090,0,0,0,0.29
2020,CB2020,081,4,Queens,40383021091,0,0,0,0.26
2020,CB2020,081,4,Queens,40384001000,126,58,68,3.88
2020,CB2020,081,4,Queens,40384001001,97,38,59,3.53
2020,CB2020,081,4,Queens,40384001002,40,27,13,2.46
2020,CB2020,081,4,Queens,40384001003,120,54,66,2.24
2020,CB2020,081,4,Queens,40384001004,75,25,50,2.23
2020,CB2020,081,4,Queens,40384001005,154,81,73,3.73
2020,CB2020,081,4,Queens,40384001006,177,84,93,3.76
2020,CB2020,081,4,Queens,40384001007,78,47,31,1.86
2020,CB2020,081,4,Queens,40384001008,82,28,54,2.49
2020,CB2020,081,4,Queens,40384001009,12,5,7,0.97
2020,CB2020,081,4,Queens,40384001010,0,0,0,0.44
2020,CB2020,081,4,Queens,40384001011,84,43,41,2.39
2020,CB2020,081,4,Queens,40384001012,69,45,24,1.81
2020,CB2020,081,4,Queens,40384001013,30,6,24,1.03
2020,CB2020,081,4,Queens,40384001014,71,41,30,2.16
2020,CB2020,081,4,Queens,40384001015,63,38,25,1.62
2020,CB2020,081,4,Queens,40384001016,92,34,58,2.24
2020,CB2020,081,4,Queens,40384002000,90,53,37,2.24
2020,CB2020,081,4,Queens,40384002001,92,37,55,2.23
2020,CB2020,081,4,Queens,40384002002,66,24,42,2.25
2020,CB2020,081,4,Queens,40384002003,164,81,83,3.72
2020,CB2020,081,4,Queens,40384002004,175,90,85,3.73
2020,CB2020,081,4,Queens,40384002005,130,49,81,3.73
2020,CB2020,081,4,Queens,40384002006,108,69,39,2.58
2020,CB2020,081,4,Queens,40384002007,96,39,57,2.72
2020,CB2020,081,4,Queens,40384002008,125,54,71,2.85
2020,CB2020,081,4,Queens,40384002009,107,44,63,2.83
2020,CB2020,081,4,Queens,40384002010,69,22,47,1.88
2020,CB2020,081,4,Queens,40384002011,74,33,41,1.7
2020,CB2020,081,4,Queens,40384002012,54,29,25,2.2
2020,CB2020,081,4,Queens,40394001000,275,122,153,6.57
2020,CB2020,081,4,Queens,40394001001,103,53,50,2.86
2020,CB2020,081,4,Queens,40394001002,125,53,72,3.43
2020,CB2020,081,4,Queens,40394001003,103,35,68,2.87
2020,CB2020,081,4,Queens,40394001004,56,29,27,2.88
2020,CB2020,081,4,Queens,40394001005,63,34,29,2.42
2020,CB2020,081,4,Queens,40394001006,109,50,59,2.71
2020,CB2020,081,4,Queens,40394001007,102,42,60,2.88
2020,CB2020,081,4,Queens,40394001008,124,52,72,3.35
2020,CB2020,081,4,Queens,40394001009,128,66,62,3.41
2020,CB2020,081,4,Queens,40394001010,48,20,28,1.16
2020,CB2020,081,4,Queens,40394001011,28,16,12,1.15
2020,CB2020,081,4,Queens,40394002000,121,60,61,2.87
2020,CB2020,081,4,Queens,40394002001,109,47,62,2.28
2020,CB2020,081,4,Queens,40394002002,62,39,23,2.29
2020,CB2020,081,4,Queens,40394002003,182,78,104,3.8
2020,CB2020,081,4,Queens,40394002004,301,122,179,5.05
2020,CB2020,081,4,Queens,40394002005,131,55,76,3.13
2020,CB2020,081,4,Queens,40394002006,244,92,152,7.37
2020,CB2020,081,4,Queens,40394003000,157,45,112,3.92
2020,CB2020,081,4,Queens,40394003001,127,66,61,3.95
2020,CB2020,081,4,Queens,40394003002,92,31,61,2.53
2020,CB2020,081,4,Queens,40394003003,221,126,95,5.09
2020,CB2020,081,4,Queens,40394003004,194,79,115,5.47
2020,CB2020,081,4,Queens,40394003005,127,72,55,2.6
2020,CB2020,081,4,Queens,40398001000,56,11,45,2.47
2020,CB2020,081,4,Queens,40398001001,48,25,23,2.12
2020,CB2020,081,4,Queens,40398001002,63,8,55,2.13
2020,CB2020,081,4,Queens,40398001003,66,22,44,2.42
2020,CB2020,081,4,Queens,40398001004,57,27,30,2.28
2020,CB2020,081,4,Queens,40398001005,56,32,24,2.16
2020,CB2020,081,4,Queens,40398001006,71,30,41,2.16
2020,CB2020,081,4,Queens,40398001007,94,59,35,2.21
2020,CB2020,081,4,Queens,40398001008,78,20,58,2.35
2020,CB2020,081,4,Queens,40398001009,73,54,19,2.09
2020,CB2020,081,4,Queens,40398001010,126,50,76,2.17
2020,CB2020,081,4,Queens,40398001011,66,27,39,2.73
2020,CB2020,081,4,Queens,40398002000,138,57,81,3.86
2020,CB2020,081,4,Queens,40398002001,146,62,84,3.82
2020,CB2020,081,4,Queens,40398002002,109,44,65,3.01
2020,CB2020,081,4,Queens,40398002003,95,52,43,3.52
2020,CB2020,081,4,Queens,40398002004,166,75,91,4.52
2020,CB2020,081,4,Queens,40398002005,180,97,83,3.55
2020,CB2020,081,4,Queens,40399011000,30,12,18,3.69
2020,CB2020,081,4,Queens,40399011001,690,411,279,5.73
2020,CB2020,081,4,Queens,40399011002,785,404,381,5.11
2020,CB2020,081,4,Queens,40399012000,711,550,161,5.94
2020,CB2020,081,4,Queens,40399012001,659,346,313,5.73
2020,CB2020,081,4,Queens,40399021000,0,0,0,2.95
2020,CB2020,081,4,Queens,40399021001,883,427,456,4.13
2020,CB2020,081,4,Queens,40399021002,861,396,465,4.32
2020,CB2020,081,4,Queens,40399021003,541,280,261,4.31
2020,CB2020,081,4,Queens,40400001000,111,58,53,2.71
2020,CB2020,081,4,Queens,40400001001,123,58,65,3.28
2020,CB2020,081,4,Queens,40400001002,97,55,42,3.17
2020,CB2020,081,4,Queens,40400001003,64,24,40,2.11
2020,CB2020,081,4,Queens,40400001004,18,12,6,1.48
2020,CB2020,081,4,Queens,40400001005,33,7,26,0.61
2020,CB2020,081,4,Queens,40400001006,50,19,31,3.1
2020,CB2020,081,4,Queens,40400001007,64,32,32,3.17
2020,CB2020,081,4,Queens,40400001008,69,38,31,1.3
2020,CB2020,081,4,Queens,40400001009,48,8,40,0.75
2020,CB2020,081,4,Queens,40400001010,31,9,22,1.06
2020,CB2020,081,4,Queens,40400002000,65,32,33,1.57
2020,CB2020,081,4,Queens,40400002001,55,27,28,2.06
2020,CB2020,081,4,Queens,40400002002,33,9,24,2.56
2020,CB2020,081,4,Queens,40400002003,84,48,36,2.98
2020,CB2020,081,4,Queens,40400002004,173,72,101,3.31
2020,CB2020,081,4,Queens,40400002005,38,11,27,1.33
2020,CB2020,081,4,Queens,40400002006,50,18,32,2.13
2020,CB2020,081,4,Queens,40400002007,112,59,53,3.81
2020,CB2020,081,4,Queens,40400002008,47,10,37,2.07
2020,CB2020,081,4,Queens,40400002009,84,41,43,2.18
2020,CB2020,081,4,Queens,40400002010,25,16,9,1.78
2020,CB2020,081,4,Queens,40401011000,728,404,324,5.19
2020,CB2020,081,4,Queens,40401011001,871,504,367,4.82
2020,CB2020,081,4,Queens,40401011002,0,0,0,1.12
2020,CB2020,081,4,Queens,40401012000,471,286,185,5.41
2020,CB2020,081,4,Queens,40401012001,777,448,329,5.2
2020,CB2020,081,4,Queens,40401021000,732,408,324,6.51
2020,CB2020,081,4,Queens,40401021001,380,184,196,3
2020,CB2020,081,4,Queens,40401021002,1376,758,618,6.2
2020,CB2020,081,4,Queens,40401022000,621,335,286,3.07
2020,CB2020,081,4,Queens,40401022001,447,252,195,2.7
2020,CB2020,081,4,Queens,40401022002,492,249,243,2.8
2020,CB2020,081,4,Queens,40401022003,760,416,344,6.37
2020,CB2020,081,4,Queens,40402001000,72,22,50,4.07
2020,CB2020,081,4,Queens,40402001001,129,49,80,3.52
2020,CB2020,081,4,Queens,40402001002,108,39,69,3.18
2020,CB2020,081,4,Queens,40402001003,111,54,57,3.22
2020,CB2020,081,4,Queens,40402001004,78,39,39,3.11
2020,CB2020,081,4,Queens,40402001005,81,51,30,3.1
2020,CB2020,081,4,Queens,40402001006,66,36,30,3.05
2020,CB2020,081,4,Queens,40402001007,88,39,49,3.1
2020,CB2020,081,4,Queens,40402001008,0,0,0,0.95
2020,CB2020,081,4,Queens,40402002000,30,18,12,2.25
2020,CB2020,081,4,Queens,40402002001,81,42,39,3.31
2020,CB2020,081,4,Queens,40402002002,99,44,55,3.06
2020,CB2020,081,4,Queens,40402002003,105,58,47,3.1
2020,CB2020,081,4,Queens,40402002004,84,33,51,3.1
2020,CB2020,081,4,Queens,40402002005,101,53,48,3.22
2020,CB2020,081,4,Queens,40402002006,98,22,76,3.04
2020,CB2020,081,4,Queens,40402002007,58,25,33,2.53
2020,CB2020,081,4,Queens,40402002008,71,46,25,1.92
2020,CB2020,081,4,Queens,40402002009,14,10,4,1.13
2020,CB2020,081,4,Queens,40403011000,686,387,299,5.58
2020,CB2020,081,4,Queens,40403011001,552,304,248,5.2
2020,CB2020,081,4,Queens,40403012000,821,406,415,5.2
2020,CB2020,081,4,Queens,40403012001,709,381,328,4.87
2020,CB2020,081,4,Queens,40403012002,0,0,0,1.06
2020,CB2020,081,4,Queens,40403021000,537,280,257,2.78
2020,CB2020,081,4,Queens,40403021001,568,293,275,3.52
2020,CB2020,081,4,Queens,40403021002,498,237,261,2.6
2020,CB2020,081,4,Queens,40403021003,1057,582,475,6.19
2020,CB2020,081,4,Queens,40403021004,1167,662,505,6.21
2020,CB2020,081,4,Queens,40403021005,933,536,397,6.21
2020,CB2020,081,4,Queens,40404001000,85,37,48,2.08
2020,CB2020,081,4,Queens,40404001001,144,53,91,4.67
2020,CB2020,081,4,Queens,40404001002,187,88,99,4.6
2020,CB2020,081,4,Queens,40404001003,256,131,125,4.42
2020,CB2020,081,4,Queens,40404001004,56,28,28,2.23
2020,CB2020,081,4,Queens,40404001005,95,46,49,2.32
2020,CB2020,081,4,Queens,40404001006,73,41,32,2.31
2020,CB2020,081,4,Queens,40404002000,0,0,0,6.57
2020,CB2020,081,4,Queens,40404002001,372,182,190,10.5
2020,CB2020,081,4,Queens,40404002002,281,134,147,4.43
2020,CB2020,081,4,Queens,40404002003,282,120,162,3.63
2020,CB2020,081,4,Queens,40404002004,263,81,182,5.68
2020,CB2020,081,4,Queens,40404002005,280,140,140,4.23
2020,CB2020,081,4,Queens,40404003000,87,57,30,2.63
2020,CB2020,081,4,Queens,40404003001,155,50,105,3.13
2020,CB2020,081,4,Queens,40404003002,81,39,42,2.14
2020,CB2020,081,4,Queens,40404003003,67,37,30,0.9
2020,CB2020,081,4,Queens,40404003004,124,59,65,3.51
2020,CB2020,081,4,Queens,40404003005,90,31,59,4.57
2020,CB2020,081,4,Queens,40404003006,26,9,17,1.82
2020,CB2020,081,4,Queens,40404003007,0,0,0,0.39
2020,CB2020,081,4,Queens,40404003008,70,33,37,2.2
2020,CB2020,081,4,Queens,40404003009,37,25,12,1.24
2020,CB2020,081,4,Queens,40404003010,40,23,17,1.44
2020,CB2020,081,4,Queens,40404004000,185,87,98,4.48
2020,CB2020,081,4,Queens,40404004001,81,29,52,2.36
2020,CB2020,081,4,Queens,40404004002,60,31,29,1.54
2020,CB2020,081,4,Queens,40404004003,19,13,6,1.01
2020,CB2020,081,4,Queens,40404004004,195,73,122,6.65
2020,CB2020,081,4,Queens,40404004005,133,60,73,5.05
2020,CB2020,081,4,Queens,40404004006,108,47,61,3.76
2020,CB2020,081,4,Queens,40404004007,29,10,19,2.64
2020,CB2020,081,4,Queens,40404004008,150,86,64,4.42
2020,CB2020,081,4,Queens,40404004009,159,72,87,4.93
2020,CB2020,081,4,Queens,40405011000,13,10,3,0.7
2020,CB2020,081,4,Queens,40405011001,58,34,24,1.95
2020,CB2020,081,4,Queens,40405011002,248,118,130,2.71
2020,CB2020,081,4,Queens,40405011003,47,21,26,1.63
2020,CB2020,081,4,Queens,40405011004,6,3,3,4.17
2020,CB2020,081,4,Queens,40405011005,420,212,208,2.81
2020,CB2020,081,4,Queens,40405011006,391,212,179,3.7
2020,CB2020,081,4,Queens,40405021000,1041,580,461,5.93
2020,CB2020,081,4,Queens,40405021001,985,554,431,6.37
2020,CB2020,081,4,Queens,40405021002,149,85,64,2.04
2020,CB2020,081,4,Queens,40407011000,696,370,326,4.4
2020,CB2020,081,4,Queens,40407011001,347,187,160,2.09
2020,CB2020,081,4,Queens,40407011002,444,249,195,1.6
2020,CB2020,081,4,Queens,40407012000,1020,546,474,4.03
2020,CB2020,081,4,Queens,40407012001,381,211,170,2.51
2020,CB2020,081,4,Queens,40407012002,58,39,19,0.79
2020,CB2020,081,4,Queens,40407012003,216,105,111,1.99
2020,CB2020,081,4,Queens,40407021000,688,368,320,4.08
2020,CB2020,081,4,Queens,40407021001,614,346,268,4.1
2020,CB2020,081,4,Queens,40407021002,578,338,240,4.37
2020,CB2020,081,4,Queens,40407022000,1487,833,654,8.89
2020,CB2020,081,4,Queens,40407023000,1258,691,567,5.99
2020,CB2020,081,4,Queens,40407023001,506,282,224,4.47
2020,CB2020,081,4,Queens,40409011000,30,11,19,3.94
2020,CB2020,081,4,Queens,40409011001,103,65,38,1.25
2020,CB2020,081,4,Queens,40409011002,654,334,320,3.02
2020,CB2020,081,4,Queens,40409012000,422,206,216,2.65
2020,CB2020,081,4,Queens,40409012001,364,221,143,2.68
2020,CB2020,081,4,Queens,40409012002,378,201,177,3.96
2020,CB2020,081,4,Queens,40409021000,832,461,371,3.81
2020,CB2020,081,4,Queens,40409021001,638,342,296,3.93
2020,CB2020,081,4,Queens,40409022000,771,393,378,4.25
2020,CB2020,081,4,Queens,40409022001,815,450,365,4.37
2020,CB2020,081,4,Queens,40409022002,208,127,81,1.68
2020,CB2020,081,4,Queens,40409022003,270,167,103,2.11
2020,CB2020,081,4,Queens,40411001000,0,0,0,2.24
2020,CB2020,081,4,Queens,40411001001,263,111,152,1.29
2020,CB2020,081,4,Queens,40411001002,696,380,316,4.83
2020,CB2020,081,4,Queens,40411001003,224,145,79,1.88
2020,CB2020,081,4,Queens,40411001004,315,145,170,2.67
2020,CB2020,081,4,Queens,40411001005,304,167,137,2.24
2020,CB2020,081,4,Queens,40411001006,313,158,155,1.82
2020,CB2020,081,4,Queens,40411002000,575,314,261,3.28
2020,CB2020,081,4,Queens,40411002001,581,338,243,3.42
2020,CB2020,081,4,Queens,40411002002,611,319,292,3.62
2020,CB2020,081,4,Queens,40411002003,143,79,64,3.55
2020,CB2020,081,4,Queens,40411002004,507,272,235,3.18
2020,CB2020,081,4,Queens,40413001000,246,159,87,1.95
2020,CB2020,081,4,Queens,40413001001,329,148,181,3.16
2020,CB2020,081,4,Queens,40413001002,117,61,56,2.28
2020,CB2020,081,4,Queens,40413001003,548,279,269,3.85
2020,CB2020,081,4,Queens,40413001004,361,180,181,2.82
2020,CB2020,081,4,Queens,40413002000,0,0,0,0.85
2020,CB2020,081,4,Queens,40413002001,557,307,250,4.72
2020,CB2020,081,4,Queens,40413002002,196,77,119,1.09
2020,CB2020,081,4,Queens,40413002003,213,124,89,2.04
2020,CB2020,081,4,Queens,40413002004,780,386,394,4.78
2020,CB2020,081,4,Queens,40413003000,0,0,0,1.06
2020,CB2020,081,4,Queens,40413003001,470,243,227,3.71
2020,CB2020,081,4,Queens,40413003002,539,306,233,3.95
2020,CB2020,081,4,Queens,40413003003,396,186,210,2.98
2020,CB2020,081,4,Queens,40414001000,1096,543,553,42.8
2020,CB2020,081,4,Queens,40414001001,178,62,116,3.88
2020,CB2020,081,4,Queens,40414001002,0,0,0,2.47
2020,CB2020,081,4,Queens,40414001003,74,43,31,2.32
2020,CB2020,081,4,Queens,40414001004,151,80,71,3.88
2020,CB2020,081,4,Queens,40414001005,118,59,59,3.77
2020,CB2020,081,4,Queens,40414001006,160,77,83,2.92
2020,CB2020,081,4,Queens,40414001007,162,81,81,3.21
2020,CB2020,081,4,Queens,40414001008,223,118,105,3.94
2020,CB2020,081,4,Queens,40414001009,200,77,123,3.94
2020,CB2020,081,4,Queens,40414001010,219,97,122,3.91
2020,CB2020,081,4,Queens,40414002000,183,61,122,3.94
2020,CB2020,081,4,Queens,40414002001,476,200,276,7.3
2020,CB2020,081,4,Queens,40414003000,113,59,54,2.23
2020,CB2020,081,4,Queens,40414003001,154,75,79,2.44
2020,CB2020,081,4,Queens,40414003002,177,54,123,2.72
2020,CB2020,081,4,Queens,40414003003,171,84,87,2.96
2020,CB2020,081,4,Queens,40414003004,87,35,52,4.37
2020,CB2020,081,4,Queens,40414003005,53,37,16,3.61
2020,CB2020,081,4,Queens,40414003006,131,68,63,3.53
2020,CB2020,081,4,Queens,40414003007,229,100,129,3.46
2020,CB2020,081,4,Queens,40414003008,171,74,97,3.35
2020,CB2020,081,4,Queens,40415001000,0,0,0,0.44
2020,CB2020,081,4,Queens,40415001001,711,356,355,4.76
2020,CB2020,081,4,Queens,40415001002,23,8,15,2.76
2020,CB2020,081,4,Queens,40415001003,224,90,134,2.66
2020,CB2020,081,4,Queens,40415001004,548,293,255,4.85
2020,CB2020,081,4,Queens,40415001005,32,27,5,0.39
2020,CB2020,081,4,Queens,40415001006,415,206,209,5.38
2020,CB2020,081,4,Queens,40415001007,642,339,303,5.22
2020,CB2020,081,4,Queens,40415002000,614,331,283,5.37
2020,CB2020,081,4,Queens,40415002001,447,223,224,5.21
2020,CB2020,081,4,Queens,40415002002,709,367,342,5.2
2020,CB2020,081,4,Queens,40424001000,65,43,22,8.64
2020,CB2020,081,4,Queens,40424001001,44,14,30,11.09
2020,CB2020,081,4,Queens,40424001002,143,65,78,5.93
2020,CB2020,081,4,Queens,40424001003,82,44,38,5.25
2020,CB2020,081,4,Queens,40424001004,162,74,88,7.15
2020,CB2020,081,4,Queens,40424001005,68,49,19,2.65
2020,CB2020,081,4,Queens,40424001006,195,72,123,4.98
2020,CB2020,081,4,Queens,40424001007,58,24,34,3.95
2020,CB2020,081,4,Queens,40424001008,91,57,34,4.22
2020,CB2020,081,4,Queens,40424002000,114,51,63,4.55
2020,CB2020,081,4,Queens,40424002001,70,38,32,3.95
2020,CB2020,081,4,Queens,40424002002,57,23,34,3.94
2020,CB2020,081,4,Queens,40424002003,129,78,51,3.84
2020,CB2020,081,4,Queens,40424002004,97,44,53,3.26
2020,CB2020,081,4,Queens,40424002005,72,29,43,3.95
2020,CB2020,081,4,Queens,40424002006,66,26,40,4.2
2020,CB2020,081,4,Queens,40424002007,53,29,24,4.22
2020,CB2020,081,4,Queens,40424002008,58,18,40,4.22
2020,CB2020,081,4,Queens,40424002009,34,16,18,3.55
2020,CB2020,081,4,Queens,40424002010,40,18,22,1.9
2020,CB2020,081,4,Queens,40424002011,0,0,0,0.33
2020,CB2020,081,4,Queens,40424003000,130,42,88,6.21
2020,CB2020,081,4,Queens,40424003001,114,64,50,5.75
2020,CB2020,081,4,Queens,40424003002,97,46,51,4.88
2020,CB2020,081,4,Queens,40424003003,29,9,20,1.76
2020,CB2020,081,4,Queens,40424003004,40,16,24,2.18
2020,CB2020,081,4,Queens,40424003005,51,26,25,2.8
2020,CB2020,081,4,Queens,40424003006,15,6,9,1.37
2020,CB2020,081,4,Queens,40424003007,37,17,20,1.41
2020,CB2020,081,4,Queens,40424003008,32,9,23,2.64
2020,CB2020,081,4,Queens,40424003009,52,23,29,2.85
2020,CB2020,081,4,Queens,40426001000,364,320,44,128.92
2020,CB2020,081,4,Queens,40427001000,598,304,294,5.38
2020,CB2020,081,4,Queens,40427001001,568,281,287,5.38
2020,CB2020,081,4,Queens,40427001002,157,94,63,2.46
2020,CB2020,081,4,Queens,40427001003,254,128,126,2.78
2020,CB2020,081,4,Queens,40427001004,237,133,104,2.18
2020,CB2020,081,4,Queens,40427002000,712,371,341,5.37
2020,CB2020,081,4,Queens,40427002001,13,8,5,0.65
2020,CB2020,081,4,Queens,40427002002,634,339,295,5.11
2020,CB2020,081,4,Queens,40427002003,571,267,304,4.69
2020,CB2020,081,4,Queens,40427002004,564,299,265,4.05
2020,CB2020,081,4,Queens,40427002005,583,286,297,2.85
2020,CB2020,081,4,Queens,40427002006,107,56,51,1.24
2020,CB2020,081,4,Queens,40432001000,34,18,16,1.21
2020,CB2020,081,4,Queens,40432001001,18,2,16,1.28
2020,CB2020,081,4,Queens,40432001002,56,30,26,2.42
2020,CB2020,081,4,Queens,40432001003,80,45,35,3.16
2020,CB2020,081,4,Queens,40432001004,78,40,38,3.35
2020,CB2020,081,4,Queens,40432001005,99,43,56,3.54
2020,CB2020,081,4,Queens,40432001006,118,44,74,3.67
2020,CB2020,081,4,Queens,40432001007,103,46,57,3.89
2020,CB2020,081,4,Queens,40432001008,113,58,55,4.05
2020,CB2020,081,4,Queens,40432001009,0,0,0,11.25
2020,CB2020,081,4,Queens,40432001010,50,10,40,4.02
2020,CB2020,081,4,Queens,40432001011,58,27,31,2.98
2020,CB2020,081,4,Queens,40432001012,129,58,71,3.43
2020,CB2020,081,4,Queens,40432001013,129,51,78,3.95
2020,CB2020,081,4,Queens,40432001014,130,78,52,3.82
2020,CB2020,081,4,Queens,40432001015,50,24,26,2.09
2020,CB2020,081,4,Queens,40432001016,35,22,13,0.78
2020,CB2020,081,4,Queens,40434001000,0,0,0,0.94
2020,CB2020,081,4,Queens,40434001001,74,47,27,1.92
2020,CB2020,081,4,Queens,40434001002,77,36,41,2.78
2020,CB2020,081,4,Queens,40434001003,131,52,79,3.69
2020,CB2020,081,4,Queens,40434001004,129,69,60,4.08
2020,CB2020,081,4,Queens,40434001005,135,74,61,3.97
2020,CB2020,081,4,Queens,40434001006,149,59,90,3.95
2020,CB2020,081,4,Queens,40434001007,134,56,78,3.94
2020,CB2020,081,4,Queens,40434001008,198,86,112,3.95
2020,CB2020,081,4,Queens,40434001009,123,62,61,4.46
2020,CB2020,081,4,Queens,40434001010,10,9,1,1.12
2020,CB2020,081,4,Queens,40434001011,19,14,5,1.6
2020,CB2020,081,4,Queens,40434001012,192,99,93,3.76
2020,CB2020,081,4,Queens,40434001013,122,67,55,3.12
2020,CB2020,081,4,Queens,40434001014,135,39,96,2.81
2020,CB2020,081,4,Queens,40434001015,76,32,44,2.41
2020,CB2020,081,4,Queens,40434001016,13,9,4,2.27
2020,CB2020,081,4,Queens,40437011000,800,402,398,6.82
2020,CB2020,081,4,Queens,40437011001,752,379,373,4.32
2020,CB2020,081,4,Queens,40437011002,577,283,294,4.11
2020,CB2020,081,4,Queens,40437012000,0,0,0,0.52
2020,CB2020,081,4,Queens,40437012001,0,0,0,2.85
2020,CB2020,081,4,Queens,40437012002,0,0,0,0.71
2020,CB2020,081,4,Queens,40437012003,235,138,97,2.26
2020,CB2020,081,4,Queens,40437012004,0,0,0,1.39
2020,CB2020,081,4,Queens,40437012005,520,258,262,3.52
2020,CB2020,081,4,Queens,40437012006,589,298,291,4.09
2020,CB2020,081,4,Queens,40437012007,170,71,99,3.03
2020,CB2020,081,4,Queens,40437012008,40,23,17,0.96
2020,CB2020,081,4,Queens,40437012009,0,0,0,1.42
2020,CB2020,081,4,Queens,40437021000,0,0,0,2.44
2020,CB2020,081,4,Queens,40437021001,84,32,52,0.65
2020,CB2020,081,4,Queens,40437021002,144,72,72,3.19
2020,CB2020,081,4,Queens,40437021003,791,316,475,4.72
2020,CB2020,081,4,Queens,40437021004,468,217,251,3.16
2020,CB2020,081,4,Queens,40437021005,474,222,252,2.17
2020,CB2020,081,4,Queens,40437022000,463,246,217,2.54
2020,CB2020,081,4,Queens,40437022001,450,229,221,3.48
2020,CB2020,081,4,Queens,40437022002,758,396,362,3.99
2020,CB2020,081,4,Queens,40437022003,508,252,256,2.55
2020,CB2020,081,4,Queens,40437023000,496,272,224,2.62
2020,CB2020,081,4,Queens,40437023001,871,451,420,4.54
2020,CB2020,081,4,Queens,40437023002,1067,488,579,5.07
2020,CB2020,081,4,Queens,40437023003,424,198,226,2.18
2020,CB2020,081,4,Queens,40439001000,752,390,362,5.7
2020,CB2020,081,4,Queens,40439001001,446,237,209,3.72
2020,CB2020,081,4,Queens,40439001002,433,220,213,3.11
2020,CB2020,081,4,Queens,40439001003,0,0,0,0.44
2020,CB2020,081,4,Queens,40439001004,884,432,452,5.96
2020,CB2020,081,4,Queens,40439002000,40,25,15,0.48
2020,CB2020,081,4,Queens,40439002001,104,48,56,0.86
2020,CB2020,081,4,Queens,40439002002,195,106,89,1.29
2020,CB2020,081,4,Queens,40439002003,162,87,75,3.64
2020,CB2020,081,4,Queens,40439002004,385,188,197,3.61
2020,CB2020,081,4,Queens,40439002005,405,196,209,2.38
2020,CB2020,081,4,Queens,40439002006,480,245,235,2.94
2020,CB2020,081,4,Queens,40439002007,224,126,98,2.3
2020,CB2020,081,4,Queens,40439002008,70,31,39,0.74
2020,CB2020,081,4,Queens,40439002009,88,62,26,1.4
2020,CB2020,081,4,Queens,40439002010,263,137,126,2.14
2020,CB2020,081,4,Queens,40440001000,132,67,65,2.8
2020,CB2020,081,4,Queens,40440001001,197,87,110,2.44
2020,CB2020,081,4,Queens,40440001002,152,76,76,2.47
2020,CB2020,081,4,Queens,40440001003,176,89,87,2.45
2020,CB2020,081,4,Queens,40440001004,74,28,46,2.19
2020,CB2020,081,4,Queens,40440001005,0,0,0,0.52
2020,CB2020,081,4,Queens,40440001006,182,93,89,2.79
2020,CB2020,081,4,Queens,40440001007,144,90,54,3.46
2020,CB2020,081,4,Queens,40440001008,240,108,132,3.81
2020,CB2020,081,4,Queens,40440001009,166,90,76,2.85
2020,CB2020,081,4,Queens,40440002000,158,72,86,11.44
2020,CB2020,081,4,Queens,40440002001,257,145,112,3.8
2020,CB2020,081,4,Queens,40440002002,218,110,108,3.61
2020,CB2020,081,4,Queens,40440002003,171,86,85,3.4
2020,CB2020,081,4,Queens,40440002004,215,81,134,3.24
2020,CB2020,081,4,Queens,40440002005,120,69,51,2.16
2020,CB2020,081,4,Queens,40440002006,78,38,40,1.67
2020,CB2020,081,4,Queens,40440003000,0,0,0,2.04
2020,CB2020,081,4,Queens,40440003001,51,37,14,2.71
2020,CB2020,081,4,Queens,40440003002,121,52,69,4.25
2020,CB2020,081,4,Queens,40440003003,215,104,111,4.19
2020,CB2020,081,4,Queens,40440003004,276,133,143,4.07
2020,CB2020,081,4,Queens,40440003005,208,112,96,3.76
2020,CB2020,081,4,Queens,40440003006,310,164,146,4.22
2020,CB2020,081,4,Queens,40440003007,364,159,205,4.76
2020,CB2020,081,4,Queens,40440003008,0,0,0,0.73
2020,CB2020,081,4,Queens,40440003009,383,167,216,4.1
2020,CB2020,081,4,Queens,40440003010,175,80,95,3.59
2020,CB2020,081,4,Queens,40443011000,274,133,141,2.08
2020,CB2020,081,4,Queens,40443011001,353,168,185,2.05
2020,CB2020,081,4,Queens,40443011002,342,184,158,2.03
2020,CB2020,081,4,Queens,40443011003,194,99,95,2.88
2020,CB2020,081,4,Queens,40443011004,141,60,81,1.48
2020,CB2020,081,4,Queens,40443011005,560,216,344,5.91
2020,CB2020,081,4,Queens,40443011006,254,118,136,1.73
2020,CB2020,081,4,Queens,40443012000,619,350,269,2.47
2020,CB2020,081,4,Queens,40443012001,627,296,331,3.56
2020,CB2020,081,4,Queens,40443012002,377,177,200,1.93
2020,CB2020,081,4,Queens,40443012003,672,323,349,3.94
2020,CB2020,081,4,Queens,40443012004,312,134,178,2.96
2020,CB2020,081,4,Queens,40443021000,0,0,0,7.21
2020,CB2020,081,4,Queens,40443021001,0,0,0,4.02
2020,CB2020,081,4,Queens,40443021002,340,132,208,4.05
2020,CB2020,081,4,Queens,40443021003,220,122,98,2.03
2020,CB2020,081,4,Queens,40443021004,209,131,78,1.84
2020,CB2020,081,4,Queens,40443021005,236,101,135,2.05
2020,CB2020,081,4,Queens,40443021006,285,175,110,2.01
2020,CB2020,081,4,Queens,40443022000,39,18,21,9.57
2020,CB2020,081,4,Queens,40443022001,0,0,0,3.68
2020,CB2020,081,4,Queens,40443022002,338,191,147,3.71
2020,CB2020,081,4,Queens,40443022003,508,240,268,3.69
2020,CB2020,081,4,Queens,40443022004,217,91,126,1.92
2020,CB2020,081,4,Queens,40443022005,190,90,100,1.94
2020,CB2020,081,4,Queens,40443023000,1402,662,740,7.38
2020,CB2020,081,4,Queens,40443023001,503,264,239,3.18
2020,CB2020,081,4,Queens,40443023002,300,158,142,3.3
2020,CB2020,081,4,Queens,40443023003,241,106,135,3.44
2020,CB2020,081,4,Queens,40443023004,128,70,58,1.58
2020,CB2020,081,4,Queens,40443023005,217,111,106,2.07
2020,CB2020,081,4,Queens,40444001000,680,307,373,6.73
2020,CB2020,081,4,Queens,40444001001,120,74,46,2.34
2020,CB2020,081,4,Queens,40444001002,66,37,29,1.01
2020,CB2020,081,4,Queens,40444001003,364,189,175,3.35
2020,CB2020,081,4,Queens,40444001004,124,65,59,2.27
2020,CB2020,081,4,Queens,40444001005,123,62,61,3.14
2020,CB2020,081,4,Queens,40444001006,11,2,9,5.54
2020,CB2020,081,4,Queens,40444001007,67,27,40,4.06
2020,CB2020,081,4,Queens,40444002000,20,14,6,1.9
2020,CB2020,081,4,Queens,40444002001,19,12,7,1.74
2020,CB2020,081,4,Queens,40444002002,0,0,0,2.74
2020,CB2020,081,4,Queens,40444002003,101,42,59,1.62
2020,CB2020,081,4,Queens,40444002004,44,20,24,0.45
2020,CB2020,081,4,Queens,40444002005,95,45,50,1.23
2020,CB2020,081,4,Queens,40444002006,43,17,26,1.28
2020,CB2020,081,4,Queens,40444002007,178,76,102,2.78
2020,CB2020,081,4,Queens,40444002008,231,100,131,3.2
2020,CB2020,081,4,Queens,40444002009,412,226,186,3.7
2020,CB2020,081,4,Queens,40444002010,331,184,147,5.63
2020,CB2020,081,4,Queens,40444003000,15,6,9,28.48
2020,CB2020,081,4,Queens,40444003001,81,44,37,5.07
2020,CB2020,081,4,Queens,40444003002,15,9,6,6.18
2020,CB2020,081,4,Queens,40444003003,0,0,0,5.9
2020,CB2020,081,4,Queens,40444003004,0,0,0,22.77
2020,CB2020,081,4,Queens,40444003005,0,0,0,2.26
2020,CB2020,081,4,Queens,40444003006,31,12,19,11.71
2020,CB2020,081,4,Queens,40444003007,948,458,490,7.62
2020,CB2020,081,4,Queens,40444003008,149,61,88,4.26
2020,CB2020,081,4,Queens,40444003009,0,0,0,26.75
2020,CB2020,081,4,Queens,40444003010,0,0,0,9.85
2020,CB2020,081,4,Queens,40444003011,0,0,0,8.96
2020,CB2020,081,4,Queens,40444003012,20,8,12,4.04
2020,CB2020,081,4,Queens,40444003013,189,101,88,5.48
2020,CB2020,081,4,Queens,40444003014,25,11,14,2.52
2020,CB2020,081,4,Queens,40444003015,18,5,13,4.8
2020,CB2020,081,4,Queens,40444003016,30,14,16,5.3
2020,CB2020,081,4,Queens,40444003017,0,0,0,0.31
2020,CB2020,081,4,Queens,40444003018,12,5,7,4.15
2020,CB2020,081,4,Queens,40444003019,0,0,0,0.57
2020,CB2020,081,4,Queens,40446011000,881,507,374,5.66
2020,CB2020,081,4,Queens,40446011001,1305,606,699,4.49
2020,CB2020,081,4,Queens,40446011002,207,85,122,2.57
2020,CB2020,081,4,Queens,40446011003,10,1,9,4.38
2020,CB2020,081,4,Queens,40446011004,40,19,21,3.2
2020,CB2020,081,4,Queens,40446011005,42,26,16,3.86
2020,CB2020,081,4,Queens,40446012000,0,0,0,5.3
2020,CB2020,081,4,Queens,40446012001,1119,578,541,7.34
2020,CB2020,081,4,Queens,40446012002,357,140,217,6.04
2020,CB2020,081,4,Queens,40446012003,20,11,9,3.55
2020,CB2020,081,4,Queens,40446012004,15,10,5,3.36
2020,CB2020,081,4,Queens,40446012005,17,11,6,5.8
2020,CB2020,081,4,Queens,40446021000,1312,625,687,3.74
2020,CB2020,081,4,Queens,40446021001,313,129,184,5.14
2020,CB2020,081,4,Queens,40446021002,873,436,437,4.32
2020,CB2020,081,4,Queens,40446022000,349,197,152,4.19
2020,CB2020,081,4,Queens,40446022001,1169,555,614,6.56
2020,CB2020,081,4,Queens,40446022002,177,94,83,2.31
2020,CB2020,081,4,Queens,40446023000,789,376,413,4.86
2020,CB2020,081,4,Queens,40446023001,51,34,17,2.28
2020,CB2020,081,4,Queens,40446023002,127,67,60,2.55
2020,CB2020,081,4,Queens,40446023003,312,171,141,6.08
2020,CB2020,081,4,Queens,40448001000,205,102,103,3.47
2020,CB2020,081,4,Queens,40448001001,544,287,257,19.52
2020,CB2020,081,4,Queens,40448001002,140,65,75,1.66
2020,CB2020,081,4,Queens,40448001003,348,189,159,4.32
2020,CB2020,081,4,Queens,40448001004,176,94,82,2.02
2020,CB2020,081,4,Queens,40448001005,437,231,206,3.02
2020,CB2020,081,4,Queens,40448001006,246,100,146,2.36
2020,CB2020,081,4,Queens,40448002000,141,86,55,2.66
2020,CB2020,081,4,Queens,40448002001,231,116,115,3.39
2020,CB2020,081,4,Queens,40448002002,305,148,157,5.78
2020,CB2020,081,4,Queens,40448002003,290,142,148,3.2
2020,CB2020,081,4,Queens,40450001000,0,0,0,0.84
2020,CB2020,081,4,Queens,40450001001,0,0,0,1.3
2020,CB2020,081,4,Queens,40450001002,0,0,0,0.96
2020,CB2020,081,4,Queens,40450001003,159,93,66,2.53
2020,CB2020,081,4,Queens,40450001004,134,69,65,2.32
2020,CB2020,081,4,Queens,40450001005,171,59,112,3.79
2020,CB2020,081,4,Queens,40450001006,155,72,83,2.97
2020,CB2020,081,4,Queens,40450001007,93,58,35,1.57
2020,CB2020,081,4,Queens,40450001008,75,49,26,1.47
2020,CB2020,081,4,Queens,40450001009,222,94,128,4.88
2020,CB2020,081,4,Queens,40450002000,361,175,186,7.86
2020,CB2020,081,4,Queens,40450002001,182,99,83,3.32
2020,CB2020,081,4,Queens,40450002002,185,103,82,2.97
2020,CB2020,081,4,Queens,40450002003,110,37,73,2.29
2020,CB2020,081,4,Queens,40450002004,123,58,65,2.16
2020,CB2020,081,4,Queens,40450002005,100,44,56,2.15
2020,CB2020,081,4,Queens,40452001000,0,0,0,0.91
2020,CB2020,081,4,Queens,40452001001,0,0,0,1.78
2020,CB2020,081,4,Queens,40452001002,0,0,0,1.25
2020,CB2020,081,4,Queens,40452001003,0,0,0,10.9
2020,CB2020,081,4,Queens,40452001004,868,377,491,22.18
2020,CB2020,081,4,Queens,40452001005,64,30,34,1.97
2020,CB2020,081,4,Queens,40452001006,140,83,57,2.53
2020,CB2020,081,4,Queens,40452001007,133,63,70,3.11
2020,CB2020,081,4,Queens,40452001008,4,2,2,9.21
2020,CB2020,081,4,Queens,40454001000,194,98,96,1.92
2020,CB2020,081,4,Queens,40454001001,266,141,125,4.01
2020,CB2020,081,4,Queens,40454001002,306,138,168,4.08
2020,CB2020,081,4,Queens,40454001003,320,148,172,4.01
2020,CB2020,081,4,Queens,40454001004,539,249,290,3.9
2020,CB2020,081,4,Queens,40454001005,592,311,281,5.77
2020,CB2020,081,4,Queens,40454002000,126,56,70,3.07
2020,CB2020,081,4,Queens,40454002001,138,63,75,2.44
2020,CB2020,081,4,Queens,40454002002,332,145,187,5.08
2020,CB2020,081,4,Queens,40454002003,651,330,321,5.12
2020,CB2020,081,4,Queens,40454002004,288,148,140,3.97
2020,CB2020,081,4,Queens,40454002005,300,146,154,4.17
2020,CB2020,081,4,Queens,40454002006,410,208,202,4.03
2020,CB2020,081,4,Queens,40454002007,745,376,369,5.53
2020,CB2020,081,4,Queens,40455001000,2554,1213,1341,6.17
2020,CB2020,081,4,Queens,40455002000,2770,1303,1467,6.19
2020,CB2020,081,4,Queens,40455003000,2655,1313,1342,7.87
2020,CB2020,081,4,Queens,40455004000,2462,1140,1322,6.37
2020,CB2020,081,4,Queens,40455005000,2672,1237,1435,5.06
2020,CB2020,081,4,Queens,40455006000,87,38,49,4.97
2020,CB2020,081,4,Queens,40456001000,0,0,0,1.41
2020,CB2020,081,4,Queens,40456001001,0,0,0,1.88
2020,CB2020,081,4,Queens,40456001002,0,0,0,0.78
2020,CB2020,081,4,Queens,40456001003,0,0,0,1.65
2020,CB2020,081,4,Queens,40456001004,112,54,58,3.08
2020,CB2020,081,4,Queens,40456001005,112,65,47,3.26
2020,CB2020,081,4,Queens,40456001006,0,0,0,0.78
2020,CB2020,081,4,Queens,40456001007,175,67,108,3.09
2020,CB2020,081,4,Queens,40456001008,47,41,6,3.1
2020,CB2020,081,4,Queens,40456001009,52,29,23,2.14
2020,CB2020,081,4,Queens,40456001010,57,43,14,1.47
2020,CB2020,081,4,Queens,40456001011,148,77,71,3.09
2020,CB2020,081,4,Queens,40456001012,248,121,127,4.42
2020,CB2020,081,4,Queens,40456001013,78,38,40,1.97
2020,CB2020,081,4,Queens,40456001014,116,63,53,2.21
2020,CB2020,081,4,Queens,40456001015,86,36,50,2.1
2020,CB2020,081,4,Queens,40456001016,134,54,80,3.64
2020,CB2020,081,4,Queens,40457001000,304,156,148,2.91
2020,CB2020,081,4,Queens,40457001001,404,209,195,3.82
2020,CB2020,081,4,Queens,40457001002,332,132,200,3.82
2020,CB2020,081,4,Queens,40457001003,244,132,112,2.93
2020,CB2020,081,4,Queens,40457001004,240,123,117,4.93
2020,CB2020,081,4,Queens,40457001005,272,115,157,3.94
2020,CB2020,081,4,Queens,40457002000,670,331,339,4.53
2020,CB2020,081,4,Queens,40457002001,478,237,241,4.53
2020,CB2020,081,4,Queens,40457002002,592,266,326,5.77
2020,CB2020,081,4,Queens,40458001000,99,60,39,6.09
2020,CB2020,081,4,Queens,40458001001,83,41,42,8.48
2020,CB2020,081,4,Queens,40458001002,127,72,55,6.72
2020,CB2020,081,4,Queens,40458001003,98,61,37,5.64
2020,CB2020,081,4,Queens,40458001004,96,25,71,6.46
2020,CB2020,081,4,Queens,40458001005,63,23,40,4.39
2020,CB2020,081,4,Queens,40458001006,107,54,53,3.64
2020,CB2020,081,4,Queens,40458001007,98,57,41,4.02
2020,CB2020,081,4,Queens,40458001008,377,190,187,3.53
2020,CB2020,081,4,Queens,40458001009,366,185,181,4.12
2020,CB2020,081,4,Queens,40458001010,757,360,397,7.53
2020,CB2020,081,4,Queens,40459001000,314,164,150,3.08
2020,CB2020,081,4,Queens,40459001001,285,150,135,2.32
2020,CB2020,081,4,Queens,40459001002,213,92,121,1.43
2020,CB2020,081,4,Queens,40459001003,521,284,237,4.46
2020,CB2020,081,4,Queens,40459001004,606,280,326,4.55
2020,CB2020,081,4,Queens,40459001005,495,247,248,3.83
2020,CB2020,081,4,Queens,40459001006,320,175,145,2.88
2020,CB2020,081,4,Queens,40459002000,304,149,155,2.9
2020,CB2020,081,4,Queens,40459002001,446,239,207,3.82
2020,CB2020,081,4,Queens,40459002002,646,335,311,4.54
2020,CB2020,081,4,Queens,40460001000,226,110,116,2.04
2020,CB2020,081,4,Queens,40460001001,51,20,31,1.7
2020,CB2020,081,4,Queens,40460001002,128,62,66,1.53
2020,CB2020,081,4,Queens,40460001003,745,380,365,1.89
2020,CB2020,081,4,Queens,40460001004,599,299,300,1.93
2020,CB2020,081,4,Queens,40460001005,367,179,188,2.21
2020,CB2020,081,4,Queens,40460002000,269,134,135,3.26
2020,CB2020,081,4,Queens,40460002001,30,10,20,1.61
2020,CB2020,081,4,Queens,40460002002,273,130,143,2.26
2020,CB2020,081,4,Queens,40460002003,989,472,517,3.03
2020,CB2020,081,4,Queens,40460002004,375,201,174,3.62
2020,CB2020,081,4,Queens,40460002005,31,20,11,5.94
2020,CB2020,081,4,Queens,40460002006,0,0,0,5.87
2020,CB2020,081,4,Queens,40460003000,925,457,468,2.38
2020,CB2020,081,4,Queens,40460003001,176,85,91,2.08
2020,CB2020,081,4,Queens,40460003002,317,168,149,2.04
2020,CB2020,081,4,Queens,40460003003,123,75,48,3.1
2020,CB2020,081,4,Queens,40460003004,536,223,313,4.34
2020,CB2020,081,4,Queens,40460003005,33,28,5,3.86
2020,CB2020,081,4,Queens,40461001000,65,41,24,1
2020,CB2020,081,4,Queens,40461001001,155,88,67,1.66
2020,CB2020,081,4,Queens,40461001002,285,166,119,2.48
2020,CB2020,081,4,Queens,40461001003,0,0,0,2.51
2020,CB2020,081,4,Queens,40461001004,204,103,101,2.48
2020,CB2020,081,4,Queens,40461001005,341,168,173,2.53
2020,CB2020,081,4,Queens,40461001006,277,135,142,2.46
2020,CB2020,081,4,Queens,40461002000,379,201,178,3.82
2020,CB2020,081,4,Queens,40461002001,162,87,75,0.63
2020,CB2020,081,4,Queens,40461002002,444,241,203,3.94
2020,CB2020,081,4,Queens,40461002003,260,164,96,2.32
2020,CB2020,081,4,Queens,40461002004,331,176,155,2.06
2020,CB2020,081,4,Queens,40462001000,499,222,277,4.51
2020,CB2020,081,4,Queens,40462001001,660,312,348,3.88
2020,CB2020,081,4,Queens,40462001002,322,137,185,3.78
2020,CB2020,081,4,Queens,40462001003,713,367,346,6.32
2020,CB2020,081,4,Queens,40462002000,25,15,10,1.93
2020,CB2020,081,4,Queens,40462002001,469,234,235,4.28
2020,CB2020,081,4,Queens,40462002002,767,364,403,3.45
2020,CB2020,081,4,Queens,40462002003,578,284,294,3.49
2020,CB2020,081,4,Queens,40462002004,381,204,177,3.57
2020,CB2020,081,4,Queens,40462002005,223,120,103,3.17
2020,CB2020,081,4,Queens,40462002006,324,174,150,2.51
2020,CB2020,081,4,Queens,40462003000,713,338,375,3.51
2020,CB2020,081,4,Queens,40462003001,132,73,59,2.09
2020,CB2020,081,4,Queens,40462003002,482,242,240,2.22
2020,CB2020,081,4,Queens,40462003003,312,133,179,2.38
2020,CB2020,081,4,Queens,40462003004,686,349,337,1.96
2020,CB2020,081,4,Queens,40462003005,388,193,195,4.11
2020,CB2020,081,4,Queens,40462003006,532,285,247,4.5
2020,CB2020,081,4,Queens,40463001000,72,35,37,0.52
2020,CB2020,081,4,Queens,40463001001,295,163,132,1.75
2020,CB2020,081,4,Queens,40463001002,532,267,265,3.07
2020,CB2020,081,4,Queens,40463001003,486,281,205,3.1
2020,CB2020,081,4,Queens,40463001004,469,257,212,1.93
2020,CB2020,081,4,Queens,40463001005,114,55,59,0.82
2020,CB2020,081,4,Queens,40463002000,519,293,226,4.45
2020,CB2020,081,4,Queens,40463002001,558,269,289,6.03
2020,CB2020,081,4,Queens,40463002002,112,63,49,7.96
2020,CB2020,081,4,Queens,40463002003,655,330,325,4.56
2020,CB2020,081,4,Queens,40463002004,729,385,344,5.19
2020,CB2020,081,4,Queens,40464001000,0,0,0,1.7
2020,CB2020,081,4,Queens,40464001001,0,0,0,3.08
2020,CB2020,081,4,Queens,40464001002,69,37,32,6.42
2020,CB2020,081,4,Queens,40464001003,60,25,35,3.8
2020,CB2020,081,4,Queens,40464001004,76,39,37,3.93
2020,CB2020,081,4,Queens,40464001005,82,35,47,4.94
2020,CB2020,081,4,Queens,40464001006,58,25,33,4.46
2020,CB2020,081,4,Queens,40464001007,53,37,16,3.46
2020,CB2020,081,4,Queens,40464001008,40,16,24,4.44
2020,CB2020,081,4,Queens,40464001009,61,34,27,6.49
2020,CB2020,081,4,Queens,40464001010,51,13,38,3.16
2020,CB2020,081,4,Queens,40464001011,712,340,372,6.67
2020,CB2020,081,4,Queens,40464001012,579,294,285,3.98
2020,CB2020,081,4,Queens,40465001000,0,0,0,1.15
2020,CB2020,081,4,Queens,40465001001,18,6,12,0.44
2020,CB2020,081,4,Queens,40465001002,202,106,96,1.29
2020,CB2020,081,4,Queens,40465001003,581,306,275,3.13
2020,CB2020,081,4,Queens,40465001004,234,120,114,1.39
2020,CB2020,081,4,Queens,40465001005,216,141,75,1.33
2020,CB2020,081,4,Queens,40465001006,133,69,64,1.27
2020,CB2020,081,4,Queens,40465001007,108,69,39,0.61
2020,CB2020,081,4,Queens,40465001008,564,309,255,3.32
2020,CB2020,081,4,Queens,40465001009,279,157,122,2.29
2020,CB2020,081,4,Queens,40465002000,0,0,0,0.56
2020,CB2020,081,4,Queens,40465002001,165,105,60,1.23
2020,CB2020,081,4,Queens,40465002002,259,137,122,2.05
2020,CB2020,081,4,Queens,40465002003,351,187,164,2.4
2020,CB2020,081,4,Queens,40465002004,410,219,191,2.67
2020,CB2020,081,4,Queens,40465002005,353,195,158,2.7
2020,CB2020,081,4,Queens,40465002006,403,235,168,4.24
2020,CB2020,081,4,Queens,40466001000,413,199,214,9.29
2020,CB2020,081,4,Queens,40466001001,268,148,120,17.68
2020,CB2020,081,4,Queens,40466001002,60,29,31,6.13
2020,CB2020,081,4,Queens,40466001003,1122,523,599,7.91
2020,CB2020,081,4,Queens,40466002000,210,84,126,4.74
2020,CB2020,081,4,Queens,40466002001,899,441,458,7.35
2020,CB2020,081,4,Queens,40466002002,704,311,393,6.04
2020,CB2020,081,4,Queens,40466002003,0,0,0,0.3
2020,CB2020,081,4,Queens,40467001000,123,71,52,1.68
2020,CB2020,081,4,Queens,40467001001,464,265,199,3.15
2020,CB2020,081,4,Queens,40467001002,1071,571,500,3.9
2020,CB2020,081,4,Queens,40467002000,917,476,441,3.78
2020,CB2020,081,4,Queens,40467002001,1260,603,657,3.87
2020,CB2020,081,4,Queens,40467003000,880,448,432,3.86
2020,CB2020,081,4,Queens,40467003001,857,449,408,3.79
2020,CB2020,081,4,Queens,40467004000,899,465,434,3.86
2020,CB2020,081,4,Queens,40467004001,788,346,442,3.51
2020,CB2020,081,4,Queens,40467004002,22,7,15,2.32
2020,CB2020,081,4,Queens,40467004003,0,0,0,1.33
2020,CB2020,081,4,Queens,40468001000,293,156,137,3.67
2020,CB2020,081,4,Queens,40468001001,108,51,57,2.54
2020,CB2020,081,4,Queens,40468001002,226,93,133,4.59
2020,CB2020,081,4,Queens,40468001003,210,80,130,4.43
2020,CB2020,081,4,Queens,40468001004,497,254,243,4.44
2020,CB2020,081,4,Queens,40468001005,226,104,122,1.64
2020,CB2020,081,4,Queens,40468001006,89,52,37,1.95
2020,CB2020,081,4,Queens,40468002000,210,110,100,2.88
2020,CB2020,081,4,Queens,40468002001,167,80,87,2.06
2020,CB2020,081,4,Queens,40468002002,217,115,102,3.64
2020,CB2020,081,4,Queens,40468002003,453,252,201,5.96
2020,CB2020,081,4,Queens,40468002004,639,345,294,5.85
2020,CB2020,081,4,Queens,40468002005,404,177,227,5.73
2020,CB2020,081,4,Queens,40468002006,321,157,164,5.15
2020,CB2020,081,4,Queens,40468002007,113,63,50,2.16
2020,CB2020,081,4,Queens,40469011000,462,228,234,2.95
2020,CB2020,081,4,Queens,40469011001,438,220,218,3.3
2020,CB2020,081,4,Queens,40469012000,1060,523,537,3.64
2020,CB2020,081,4,Queens,40469012001,536,244,292,2.61
2020,CB2020,081,4,Queens,40469013000,1163,592,571,3
2020,CB2020,081,4,Queens,40469013001,687,341,346,2.96
2020,CB2020,081,4,Queens,40469021000,76,58,18,2.03
2020,CB2020,081,4,Queens,40469021001,473,238,235,3.53
2020,CB2020,081,4,Queens,40469021002,750,407,343,3.56
2020,CB2020,081,4,Queens,40469021003,980,487,493,3.47
2020,CB2020,081,4,Queens,40469022000,1110,560,550,3.3
2020,CB2020,081,4,Queens,40469022001,713,340,373,3.07
2020,CB2020,081,4,Queens,40470001000,35,12,23,0.99
2020,CB2020,081,4,Queens,40470001001,33,12,21,0.94
2020,CB2020,081,4,Queens,40470001002,147,76,71,2.25
2020,CB2020,081,4,Queens,40470001003,94,27,67,3.14
2020,CB2020,081,4,Queens,40470001004,55,19,36,0.74
2020,CB2020,081,4,Queens,40470001005,116,73,43,5.24
2020,CB2020,081,4,Queens,40470001006,120,60,60,2.18
2020,CB2020,081,4,Queens,40470001007,187,80,107,2.83
2020,CB2020,081,4,Queens,40470001008,217,117,100,2.88
2020,CB2020,081,4,Queens,40470001009,165,70,95,2.65
2020,CB2020,081,4,Queens,40470001010,173,99,74,2.19
2020,CB2020,081,4,Queens,40470002000,287,109,178,4.93
2020,CB2020,081,4,Queens,40470002001,384,196,188,4.75
2020,CB2020,081,4,Queens,40470002002,345,182,163,5.25
2020,CB2020,081,4,Queens,40470002003,122,55,67,1.99
2020,CB2020,081,4,Queens,40470002004,120,55,65,1.91
2020,CB2020,081,4,Queens,40470002005,147,55,92,2.42
2020,CB2020,081,4,Queens,40470002006,147,70,77,2.69
2020,CB2020,081,4,Queens,40470002007,208,86,122,2.45
2020,CB2020,081,4,Queens,40470002008,115,71,44,1.82
2020,CB2020,081,4,Queens,40470002009,126,79,47,2.44
2020,CB2020,081,4,Queens,40471001000,382,183,199,4.93
2020,CB2020,081,4,Queens,40471001001,741,346,395,7.2
2020,CB2020,081,4,Queens,40471001002,475,238,237,3.6
2020,CB2020,081,4,Queens,40471001003,0,0,0,1.02
2020,CB2020,081,4,Queens,40471001004,1220,621,599,3.41
2020,CB2020,081,4,Queens,40471002000,295,164,131,2.87
2020,CB2020,081,4,Queens,40471002001,324,158,166,4.47
2020,CB2020,081,4,Queens,40471002002,722,362,360,5.69
2020,CB2020,081,4,Queens,40471002003,402,223,179,3.39
2020,CB2020,081,4,Queens,40471002004,224,90,134,2.48
2020,CB2020,081,4,Queens,40472001000,75,27,48,6.72
2020,CB2020,081,4,Queens,40472001001,72,37,35,8.21
2020,CB2020,081,4,Queens,40472001002,81,45,36,4.04
2020,CB2020,081,4,Queens,40472001003,91,47,44,5.59
2020,CB2020,081,4,Queens,40472001004,59,35,24,3.85
2020,CB2020,081,4,Queens,40472001005,160,67,93,5.41
2020,CB2020,081,4,Queens,40472001006,61,21,40,4.26
2020,CB2020,081,4,Queens,40472001007,325,179,146,8.13
2020,CB2020,081,4,Queens,40472001008,69,24,45,3.62
2020,CB2020,081,4,Queens,40472002000,0,0,0,2.87
2020,CB2020,081,4,Queens,40472002001,0,0,0,6.03
2020,CB2020,081,4,Queens,40472002002,37,35,2,3.34
2020,CB2020,081,4,Queens,40472002003,128,55,73,5.43
2020,CB2020,081,4,Queens,40472002004,56,24,32,4.09
2020,CB2020,081,4,Queens,40472002005,89,66,23,7.86
2020,CB2020,081,4,Queens,40472002006,63,23,40,2.79
2020,CB2020,081,4,Queens,40472002007,21,17,4,2.09
2020,CB2020,081,4,Queens,40472002008,63,31,32,4.45
2020,CB2020,081,4,Queens,40472002009,55,20,35,3.81
2020,CB2020,081,4,Queens,40472002010,66,45,21,3.91
2020,CB2020,081,4,Queens,40472002011,94,40,54,7.53
2020,CB2020,081,4,Queens,40472002012,113,42,71,3.23
2020,CB2020,081,4,Queens,40472002013,136,59,77,3.74
2020,CB2020,081,4,Queens,40472002014,319,126,193,3.9
2020,CB2020,081,4,Queens,40472003000,461,182,279,5.96
2020,CB2020,081,4,Queens,40472003001,1167,511,656,7.84
2020,CB2020,081,4,Queens,40473001000,705,301,404,4.71
2020,CB2020,081,4,Queens,40473001001,459,211,248,3.24
2020,CB2020,081,4,Queens,40473001002,413,195,218,2.72
2020,CB2020,081,4,Queens,40473001003,274,134,140,1.32
2020,CB2020,081,4,Queens,40473002000,99,37,62,3.51
2020,CB2020,081,4,Queens,40473002001,299,113,186,2.58
2020,CB2020,081,4,Queens,40473002002,238,129,109,2.59
2020,CB2020,081,4,Queens,40473002003,0,0,0,2.66
2020,CB2020,081,4,Queens,40473002004,0,0,0,1.65
2020,CB2020,081,4,Queens,40473002005,0,0,0,1.92
2020,CB2020,081,4,Queens,40473002006,1096,526,570,7.19
2020,CB2020,081,4,Queens,40473002007,0,0,0,6.43
2020,CB2020,081,4,Queens,40473002008,0,0,0,1.58
2020,CB2020,081,4,Queens,40473003000,1280,565,715,6.95
2020,CB2020,081,4,Queens,40475001000,0,0,0,2.4
2020,CB2020,081,4,Queens,40475001001,195,89,106,3.48
2020,CB2020,081,4,Queens,40475001002,213,106,107,2.52
2020,CB2020,081,4,Queens,40475001003,154,74,80,2.03
2020,CB2020,081,4,Queens,40475001004,82,46,36,1.8
2020,CB2020,081,4,Queens,40475001005,45,20,25,1.96
2020,CB2020,081,4,Queens,40475001006,210,102,108,2.13
2020,CB2020,081,4,Queens,40475001007,198,87,111,2.03
2020,CB2020,081,4,Queens,40475001008,292,155,137,2.58
2020,CB2020,081,4,Queens,40475001009,565,247,318,3.86
2020,CB2020,081,4,Queens,40475001010,198,83,115,2.33
2020,CB2020,081,4,Queens,40475001011,222,81,141,1.72
2020,CB2020,081,4,Queens,40475002000,503,237,266,14.35
2020,CB2020,081,4,Queens,40475002001,323,135,188,2.75
2020,CB2020,081,4,Queens,40475002002,337,144,193,3.06
2020,CB2020,081,4,Queens,40475002003,318,135,183,3.13
2020,CB2020,081,4,Queens,40475002004,393,205,188,2.56
2020,CB2020,081,4,Queens,40475002005,347,149,198,3.13
2020,CB2020,081,4,Queens,40475002006,306,160,146,3.08
2020,CB2020,081,4,Queens,40475002007,197,104,93,3
2020,CB2020,081,4,Queens,40475002008,139,72,67,2.91
2020,CB2020,081,4,Queens,40475002009,252,151,101,2.88
2020,CB2020,081,4,Queens,40476001000,0,0,0,8.08
2020,CB2020,081,4,Queens,40476001001,121,43,78,25.64
2020,CB2020,081,4,Queens,40476001002,57,31,26,4.21
2020,CB2020,081,4,Queens,40476001003,52,28,24,4.14
2020,CB2020,081,4,Queens,40476001004,44,13,31,2.77
2020,CB2020,081,4,Queens,40476001005,53,35,18,2.38
2020,CB2020,081,4,Queens,40476001006,123,51,72,12.59
2020,CB2020,081,4,Queens,40476001007,85,52,33,5.76
2020,CB2020,081,4,Queens,40476001008,94,47,47,10.61
2020,CB2020,081,4,Queens,40476001009,30,16,14,2.64
2020,CB2020,081,4,Queens,40476001010,37,10,27,5.57
2020,CB2020,081,4,Queens,40476002000,90,55,35,7.14
2020,CB2020,081,4,Queens,40476002001,50,10,40,3.08
2020,CB2020,081,4,Queens,40476002002,99,56,43,3.89
2020,CB2020,081,4,Queens,40476002003,105,57,48,6.25
2020,CB2020,081,4,Queens,40476002004,100,45,55,11.77
2020,CB2020,081,4,Queens,40476002005,87,23,64,5.71
2020,CB2020,081,4,Queens,40476002006,33,18,15,1.56
2020,CB2020,081,4,Queens,40476002007,114,67,47,11.48
2020,CB2020,081,4,Queens,40478011000,1209,518,691,31.39
2020,CB2020,081,4,Queens,40478011001,171,65,106,3.85
2020,CB2020,081,4,Queens,40478011002,171,77,94,3.6
2020,CB2020,081,4,Queens,40478011003,477,221,256,3.19
2020,CB2020,081,4,Queens,40478011004,32,20,12,1.86
2020,CB2020,081,4,Queens,40478012000,93,43,50,7.02
2020,CB2020,081,4,Queens,40478012001,228,88,140,6.74
2020,CB2020,081,4,Queens,40478012002,272,114,158,6.53
2020,CB2020,081,4,Queens,40478012003,108,66,42,7.14
2020,CB2020,081,4,Queens,40478012004,77,31,46,7.66
2020,CB2020,081,4,Queens,40478012005,291,134,157,24.45
2020,CB2020,081,4,Queens,40478012006,59,25,34,1.74
2020,CB2020,081,4,Queens,40478012007,49,29,20,2.41
2020,CB2020,081,4,Queens,40478012008,644,303,341,8.46
2020,CB2020,081,4,Queens,40478012009,93,37,56,6.77
2020,CB2020,081,4,Queens,40478012010,24,21,3,1.24
2020,CB2020,081,4,Queens,40478012011,67,27,40,4.55
2020,CB2020,081,4,Queens,40478021000,76,37,39,2.48
2020,CB2020,081,4,Queens,40478021001,62,15,47,1.5
2020,CB2020,081,4,Queens,40478021002,118,58,60,3.69
2020,CB2020,081,4,Queens,40478021003,170,100,70,3.73
2020,CB2020,081,4,Queens,40478021004,209,97,112,3.74
2020,CB2020,081,4,Queens,40478021005,247,104,143,3.8
2020,CB2020,081,4,Queens,40478021006,179,88,91,3.99
2020,CB2020,081,4,Queens,40478021007,144,71,73,4.45
2020,CB2020,081,4,Queens,40478021008,306,150,156,5.41
2020,CB2020,081,4,Queens,40479001000,210,90,120,3.35
2020,CB2020,081,4,Queens,40479001001,952,438,514,4.53
2020,CB2020,081,4,Queens,40479001002,509,244,265,7.49
2020,CB2020,081,4,Queens,40479001003,769,392,377,4.31
2020,CB2020,081,4,Queens,40479001004,0,0,0,0.47
2020,CB2020,081,4,Queens,40479001005,339,200,139,8.02
2020,CB2020,081,4,Queens,40479001006,104,54,50,5.41
2020,CB2020,081,4,Queens,40479001007,412,176,236,7.79
2020,CB2020,081,4,Queens,40479002000,0,0,0,3.08
2020,CB2020,081,4,Queens,40479002001,0,0,0,0.77
2020,CB2020,081,4,Queens,40479002002,0,0,0,0.84
2020,CB2020,081,4,Queens,40479002003,0,0,0,3.3
2020,CB2020,081,4,Queens,40479002004,0,0,0,2.55
2020,CB2020,081,4,Queens,40479002005,564,229,335,3.07
2020,CB2020,081,4,Queens,40479002006,112,59,53,2.02
2020,CB2020,081,4,Queens,40479002007,197,104,93,3.25
2020,CB2020,081,4,Queens,40479002008,299,156,143,4.51
2020,CB2020,081,4,Queens,40479002009,465,220,245,5.56
2020,CB2020,081,4,Queens,40479003000,303,132,171,2.84
2020,CB2020,081,4,Queens,40479003001,303,148,155,2.79
2020,CB2020,081,4,Queens,40479003002,222,111,111,2.78
2020,CB2020,081,4,Queens,40479003003,188,90,98,2.79
2020,CB2020,081,4,Queens,40479003004,196,107,89,6.96
2020,CB2020,081,4,Queens,40479003005,693,379,314,8.26
2020,CB2020,081,4,Queens,40479003006,0,0,0,0.27
2020,CB2020,081,4,Queens,40480001000,74,27,47,2.84
2020,CB2020,081,4,Queens,40480001001,117,52,65,2.85
2020,CB2020,081,4,Queens,40480001002,99,55,44,3.04
2020,CB2020,081,4,Queens,40480001003,65,25,40,0.88
2020,CB2020,081,4,Queens,40480001004,116,47,69,2.29
2020,CB2020,081,4,Queens,40480001005,182,100,82,3.35
2020,CB2020,081,4,Queens,40480001006,75,43,32,0.9
2020,CB2020,081,4,Queens,40480001007,155,76,79,2.59
2020,CB2020,081,4,Queens,40480001008,165,87,78,2.8
2020,CB2020,081,4,Queens,40480001009,145,94,51,2.67
2020,CB2020,081,4,Queens,40480001010,164,72,92,2.56
2020,CB2020,081,4,Queens,40480001011,112,65,47,2.58
2020,CB2020,081,4,Queens,40480001012,82,56,26,2.58
2020,CB2020,081,4,Queens,40480001013,108,49,59,2.59
2020,CB2020,081,4,Queens,40480002000,110,25,85,3.68
2020,CB2020,081,4,Queens,40480002001,105,71,34,2.3
2020,CB2020,081,4,Queens,40480002002,83,31,52,2.31
2020,CB2020,081,4,Queens,40480002003,169,92,77,2.3
2020,CB2020,081,4,Queens,40480002004,386,208,178,4.83
2020,CB2020,081,4,Queens,40480002005,82,48,34,2.06
2020,CB2020,081,4,Queens,40480002006,50,23,27,2.87
2020,CB2020,081,4,Queens,40480002007,22,12,10,2.02
2020,CB2020,081,4,Queens,40481001000,578,289,289,5.26
2020,CB2020,081,4,Queens,40481001001,532,280,252,5.24
2020,CB2020,081,4,Queens,40481002000,1700,901,799,6.1
2020,CB2020,081,4,Queens,40481002001,335,152,183,2.29
2020,CB2020,081,4,Queens,40481003000,1288,639,649,4.77
2020,CB2020,081,4,Queens,40481003001,571,327,244,3.48
2020,CB2020,081,4,Queens,40481004000,1317,592,725,3.94
2020,CB2020,081,4,Queens,40481004001,0,0,0,3.29
2020,CB2020,081,4,Queens,40482001000,341,170,171,13.81
2020,CB2020,081,4,Queens,40482001001,102,42,60,6.35
2020,CB2020,081,4,Queens,40482001002,245,102,143,7.22
2020,CB2020,081,4,Queens,40482001003,149,70,79,7.13
2020,CB2020,081,4,Queens,40482001004,136,70,66,6.16
2020,CB2020,081,4,Queens,40482001005,103,45,58,2.75
2020,CB2020,081,4,Queens,40482001006,76,29,47,2.59
2020,CB2020,081,4,Queens,40482001007,143,74,69,3.15
2020,CB2020,081,4,Queens,40482001008,108,60,48,2.95
2020,CB2020,081,4,Queens,40482001009,71,39,32,2.05
2020,CB2020,081,4,Queens,40482001010,44,24,20,2.28
2020,CB2020,081,4,Queens,40483011000,465,224,241,5.16
2020,CB2020,081,4,Queens,40483011001,603,299,304,4.16
2020,CB2020,081,4,Queens,40483011002,106,57,49,2.29
2020,CB2020,081,4,Queens,40483011003,77,47,30,1.63
2020,CB2020,081,4,Queens,40483011004,410,227,183,3.55
2020,CB2020,081,4,Queens,40483011005,405,192,213,3.63
2020,CB2020,081,4,Queens,40483011006,79,48,31,1.17
2020,CB2020,081,4,Queens,40483021000,0,0,0,1.39
2020,CB2020,081,4,Queens,40483021001,314,148,166,5.33
2020,CB2020,081,4,Queens,40483021002,146,86,60,1.76
2020,CB2020,081,4,Queens,40483021003,22,9,13,0.89
2020,CB2020,081,4,Queens,40483021004,0,0,0,0.31
2020,CB2020,081,4,Queens,40483021005,550,317,233,5.67
2020,CB2020,081,4,Queens,40483021006,126,55,71,1.85
2020,CB2020,081,4,Queens,40483021007,178,92,86,2.4
2020,CB2020,081,4,Queens,40483021008,488,239,249,5.75
2020,CB2020,081,4,Queens,40483021009,151,64,87,2.79
2020,CB2020,081,4,Queens,40483021010,99,61,38,1.84
2020,CB2020,081,4,Queens,40483021011,18,8,10,1.79
2020,CB2020,081,4,Queens,40483021012,0,0,0,1.38
2020,CB2020,081,4,Queens,40484001000,94,46,48,2.08
2020,CB2020,081,4,Queens,40484001001,58,20,38,1.83
2020,CB2020,081,4,Queens,40484001002,168,72,96,3.61
2020,CB2020,081,4,Queens,40484001003,201,95,106,3.61
2020,CB2020,081,4,Queens,40484001004,204,110,94,3.61
2020,CB2020,081,4,Queens,40484001005,170,84,86,3.62
2020,CB2020,081,4,Queens,40484001006,220,101,119,3.88
2020,CB2020,081,4,Queens,40484001007,94,45,49,2.24
2020,CB2020,081,4,Queens,40484001008,103,31,72,2.94
2020,CB2020,081,4,Queens,40484001009,86,43,43,2.92
2020,CB2020,081,4,Queens,40484001010,123,66,57,2.25
2020,CB2020,081,4,Queens,40484002000,377,164,213,6.3
2020,CB2020,081,4,Queens,40484002001,435,215,220,8.04
2020,CB2020,081,4,Queens,40484002002,132,64,68,2.85
2020,CB2020,081,4,Queens,40484002003,238,116,122,4.04
2020,CB2020,081,4,Queens,40484002004,0,0,0,1.91
2020,CB2020,081,4,Queens,40484003000,107,61,46,2.39
2020,CB2020,081,4,Queens,40484003001,94,43,51,2.58
2020,CB2020,081,4,Queens,40484003002,239,106,133,4.59
2020,CB2020,081,4,Queens,40484003003,203,107,96,4.6
2020,CB2020,081,4,Queens,40484003004,243,114,129,4.59
2020,CB2020,081,4,Queens,40484003005,312,138,174,4.68
2020,CB2020,081,4,Queens,40484004000,93,42,51,2.31
2020,CB2020,081,4,Queens,40484004001,89,44,45,1.98
2020,CB2020,081,4,Queens,40484004002,160,78,82,3.96
2020,CB2020,081,4,Queens,40484004003,526,237,289,4.74
2020,CB2020,081,4,Queens,40484004004,600,291,309,3.83
2020,CB2020,081,4,Queens,40484004005,49,23,26,2.87
2020,CB2020,081,4,Queens,40484004006,43,37,6,1.48
2020,CB2020,081,4,Queens,40484004007,32,13,19,0.66
2020,CB2020,081,4,Queens,40484004008,76,22,54,1.48
2020,CB2020,081,4,Queens,40485001000,135,59,76,2.21
2020,CB2020,081,4,Queens,40485001001,495,261,234,3.46
2020,CB2020,081,4,Queens,40485001002,316,168,148,4.85
2020,CB2020,081,4,Queens,40485001003,15,7,8,5.68
2020,CB2020,081,4,Queens,40485001004,0,0,0,5.84
2020,CB2020,081,4,Queens,40485001005,0,0,0,2.71
2020,CB2020,081,4,Queens,40485002000,467,230,237,3.59
2020,CB2020,081,4,Queens,40485002001,494,235,259,3.91
2020,CB2020,081,4,Queens,40485002002,109,35,74,2.14
2020,CB2020,081,4,Queens,40485002003,203,102,101,3.89
2020,CB2020,081,4,Queens,40485002004,454,202,252,2.2
2020,CB2020,081,4,Queens,40485003000,40,23,17,1.83
2020,CB2020,081,4,Queens,40485003001,824,425,399,12.8
2020,CB2020,081,4,Queens,40485003002,649,342,307,3.88
2020,CB2020,081,4,Queens,40485003003,93,43,50,3.63
2020,CB2020,081,4,Queens,40485003004,366,186,180,3.08
2020,CB2020,081,4,Queens,40485003005,233,138,95,2.46
2020,CB2020,081,4,Queens,40485003006,181,99,82,2.05
2020,CB2020,081,4,Queens,40485003007,110,42,68,2.07
2020,CB2020,081,4,Queens,40485003008,147,75,72,6.13
2020,CB2020,081,4,Queens,40489001000,7,7,0,2.66
2020,CB2020,081,4,Queens,40489001001,0,0,0,0.53
2020,CB2020,081,4,Queens,40489001002,0,0,0,1.25
2020,CB2020,081,4,Queens,40489001003,0,0,0,1.67
2020,CB2020,081,4,Queens,40489001004,0,0,0,1.41
2020,CB2020,081,4,Queens,40489001005,22,9,13,3.46
2020,CB2020,081,4,Queens,40489001006,57,23,34,2.54
2020,CB2020,081,4,Queens,40489001007,0,0,0,0.96
2020,CB2020,081,4,Queens,40489001008,4,2,2,9.3
2020,CB2020,081,4,Queens,40489001009,190,80,110,2.84
2020,CB2020,081,4,Queens,40489001010,322,182,140,2.41
2020,CB2020,081,4,Queens,40489001011,13,12,1,2.96
2020,CB2020,081,4,Queens,40489001012,19,12,7,3.04
2020,CB2020,081,4,Queens,40489001013,0,0,0,7.77
2020,CB2020,081,4,Queens,40489001014,0,0,0,4.83
2020,CB2020,081,4,Queens,40489001015,34,18,16,2.98
2020,CB2020,081,4,Queens,40489001016,25,3,22,2.92
2020,CB2020,081,4,Queens,40489001017,21,7,14,0.96
2020,CB2020,081,4,Queens,40489001018,0,0,0,2.83
2020,CB2020,081,4,Queens,40489001019,16,8,8,2.92
2020,CB2020,081,4,Queens,40489001020,0,0,0,0.71
2020,CB2020,081,4,Queens,40489001021,89,37,52,2.69
2020,CB2020,081,4,Queens,40489001022,17,6,11,0.63
2020,CB2020,081,4,Queens,40489001023,0,0,0,1.03
2020,CB2020,081,4,Queens,40489001024,176,89,87,2.19
2020,CB2020,081,4,Queens,40489001025,12,9,3,3.21
2020,CB2020,081,4,Queens,40489001026,27,10,17,3.12
2020,CB2020,081,4,Queens,40489001027,0,0,0,2.03
2020,CB2020,081,4,Queens,40489001028,156,81,75,2.75
2020,CB2020,081,4,Queens,40489002000,250,139,111,3.46
2020,CB2020,081,4,Queens,40489002001,196,88,108,3.25
2020,CB2020,081,4,Queens,40489002002,284,153,131,4.14
2020,CB2020,081,4,Queens,40492011000,0,0,0,1.83
2020,CB2020,081,4,Queens,40492011001,0,0,0,1.48
2020,CB2020,081,4,Queens,40492011002,0,0,0,4.03
2020,CB2020,081,4,Queens,40492011003,34,20,14,9.05
2020,CB2020,081,4,Queens,40492011004,0,0,0,0.9
2020,CB2020,081,4,Queens,40492011005,42,21,21,2.06
2020,CB2020,081,4,Queens,40492011006,370,165,205,8.07
2020,CB2020,081,4,Queens,40492011007,722,299,423,12.05
2020,CB2020,081,4,Queens,40492012000,0,0,0,0.61
2020,CB2020,081,4,Queens,40492012001,414,195,219,6.39
2020,CB2020,081,4,Queens,40492012002,473,210,263,8.98
2020,CB2020,081,4,Queens,40492012003,623,299,324,12.25
2020,CB2020,081,4,Queens,40492012004,210,96,114,5.21
2020,CB2020,081,4,Queens,40492021000,144,81,63,2.82
2020,CB2020,081,4,Queens,40492021001,104,49,55,2.25
2020,CB2020,081,4,Queens,40492021002,277,129,148,4.98
2020,CB2020,081,4,Queens,40492021003,233,105,128,4.4
2020,CB2020,081,4,Queens,40492021004,269,142,127,4.76
2020,CB2020,081,4,Queens,40492021005,148,69,79,3.95
2020,CB2020,081,4,Queens,40492021006,240,120,120,3.81
2020,CB2020,081,4,Queens,40492021007,0,0,0,3.88
2020,CB2020,081,4,Queens,40492021008,177,77,100,4.09
2020,CB2020,081,4,Queens,40492021009,35,11,24,3.96
2020,CB2020,081,4,Queens,40492021010,150,83,67,3.99
2020,CB2020,081,4,Queens,40492021011,241,130,111,4.36
2020,CB2020,081,4,Queens,40493011000,76,19,57,1.44
2020,CB2020,081,4,Queens,40493011001,133,84,49,2.22
2020,CB2020,081,4,Queens,40493011002,148,80,68,2.94
2020,CB2020,081,4,Queens,40493011003,216,61,155,3.3
2020,CB2020,081,4,Queens,40493011004,347,173,174,5.81
2020,CB2020,081,4,Queens,40493011005,311,159,152,5.15
2020,CB2020,081,4,Queens,40493012000,195,86,109,2.87
2020,CB2020,081,4,Queens,40493012001,171,76,95,3.08
2020,CB2020,081,4,Queens,40493012002,262,124,138,4.71
2020,CB2020,081,4,Queens,40493012003,179,76,103,3.16
2020,CB2020,081,4,Queens,40493012004,215,113,102,3
2020,CB2020,081,4,Queens,40493012005,138,63,75,2.89
2020,CB2020,081,4,Queens,40493021000,632,300,332,9.39
2020,CB2020,081,4,Queens,40493021001,278,151,127,5.39
2020,CB2020,081,4,Queens,40493021002,283,138,145,3.9
2020,CB2020,081,4,Queens,40493021003,197,100,97,2.76
2020,CB2020,081,4,Queens,40493021004,217,96,121,3.66
2020,CB2020,081,4,Queens,40493022000,105,56,49,10.49
2020,CB2020,081,4,Queens,40493022001,308,131,177,5.65
2020,CB2020,081,4,Queens,40493022002,618,306,312,9.89
2020,CB2020,081,4,Queens,40493022003,266,128,138,3.33
2020,CB2020,081,4,Queens,40493022004,170,74,96,1.93
2020,CB2020,081,4,Queens,40493022005,183,102,81,3.98
2020,CB2020,081,4,Queens,40493022006,241,122,119,6.18
2020,CB2020,081,4,Queens,40495001000,0,0,0,1.57
2020,CB2020,081,4,Queens,40495001001,0,0,0,4.76
2020,CB2020,081,4,Queens,40495001002,16,13,3,0.8
2020,CB2020,081,4,Queens,40495001003,55,23,32,0.47
2020,CB2020,081,4,Queens,40495001004,0,0,0,1.42
2020,CB2020,081,4,Queens,40495001005,131,55,76,1.74
2020,CB2020,081,4,Queens,40495001006,290,169,121,4.6
2020,CB2020,081,4,Queens,40495001007,317,169,148,5.29
2020,CB2020,081,4,Queens,40495001008,193,82,111,3.14
2020,CB2020,081,4,Queens,40495001009,0,0,0,0.35
2020,CB2020,081,4,Queens,40495001010,129,70,59,2.52
2020,CB2020,081,4,Queens,40495001011,142,55,87,1.99
2020,CB2020,081,4,Queens,40495001012,14,8,6,0.4
2020,CB2020,081,4,Queens,40495001013,0,0,0,0.35
2020,CB2020,081,4,Queens,40495001014,143,56,87,2.47
2020,CB2020,081,4,Queens,40496001000,159,66,93,3.3
2020,CB2020,081,4,Queens,40496001001,193,85,108,3.65
2020,CB2020,081,4,Queens,40496001002,222,110,112,4.12
2020,CB2020,081,4,Queens,40496001003,211,87,124,4.67
2020,CB2020,081,4,Queens,40496001004,250,118,132,4.61
2020,CB2020,081,4,Queens,40496001005,238,126,112,4.94
2020,CB2020,081,4,Queens,40496002000,83,34,49,1.9
2020,CB2020,081,4,Queens,40496002001,75,23,52,1.35
2020,CB2020,081,4,Queens,40496002002,0,0,0,0.81
2020,CB2020,081,4,Queens,40496002003,160,64,96,3.67
2020,CB2020,081,4,Queens,40496002004,173,80,93,3.53
2020,CB2020,081,4,Queens,40496002005,164,92,72,3.3
2020,CB2020,081,4,Queens,40496002006,146,79,67,3.87
2020,CB2020,081,4,Queens,40496002007,203,112,91,3.98
2020,CB2020,081,4,Queens,40496002008,260,114,146,4.28
2020,CB2020,081,4,Queens,40496003000,146,59,87,2.49
2020,CB2020,081,4,Queens,40496003001,178,82,96,3
2020,CB2020,081,4,Queens,40496003002,135,49,86,2.79
2020,CB2020,081,4,Queens,40496003003,80,66,14,2.6
2020,CB2020,081,4,Queens,40496003004,109,43,66,2.4
2020,CB2020,081,4,Queens,40496003005,66,45,21,2.24
2020,CB2020,081,4,Queens,40497001000,963,487,476,11.22
2020,CB2020,081,4,Queens,40497001001,213,136,77,2.98
2020,CB2020,081,4,Queens,40497001002,248,111,137,3.65
2020,CB2020,081,4,Queens,40497001003,69,24,45,0.75
2020,CB2020,081,4,Queens,40497001004,247,124,123,3.27
2020,CB2020,081,4,Queens,40497001005,208,94,114,3.26
2020,CB2020,081,4,Queens,40497001006,202,91,111,2.49
2020,CB2020,081,4,Queens,40497002000,121,69,52,1.6
2020,CB2020,081,4,Queens,40497002001,444,211,233,5.9
2020,CB2020,081,4,Queens,40497002002,315,151,164,5.46
2020,CB2020,081,4,Queens,40497002003,169,61,108,4.33
2020,CB2020,081,4,Queens,40497002004,182,87,95,3.92
2020,CB2020,081,4,Queens,40499001000,31,18,13,5.59
2020,CB2020,081,4,Queens,40499001001,0,0,0,1.94
2020,CB2020,081,4,Queens,40499002000,319,176,143,3.83
2020,CB2020,081,4,Queens,40499002001,154,67,87,2.65
2020,CB2020,081,4,Queens,40499002002,288,159,129,15.78
2020,CB2020,081,4,Queens,40499002003,975,471,504,12.24
2020,CB2020,081,4,Queens,40499002004,49,16,33,5.7
2020,CB2020,081,4,Queens,40499002005,0,0,0,2.62
2020,CB2020,081,4,Queens,40499003000,160,88,72,4.77
2020,CB2020,081,4,Queens,40499003001,0,0,0,0.72
2020,CB2020,081,4,Queens,40499003002,0,0,0,1.35
2020,CB2020,081,4,Queens,40499003003,215,118,97,5.6
2020,CB2020,081,4,Queens,40499003004,141,74,67,4.18
2020,CB2020,081,4,Queens,40499003005,550,259,291,5.44
2020,CB2020,081,4,Queens,40499003006,23,15,8,0.79
2020,CB2020,081,4,Queens,40499003007,60,38,22,0.81
2020,CB2020,081,4,Queens,40499003008,62,27,35,0.88
2020,CB2020,081,4,Queens,40499003009,170,66,104,2.54
2020,CB2020,081,4,Queens,40499003010,180,83,97,1.9
2020,CB2020,081,4,Queens,40499003011,162,86,76,1.39
2020,CB2020,081,4,Queens,40499003012,204,109,95,2.91
2020,CB2020,081,4,Queens,40499004000,359,158,201,2.87
2020,CB2020,081,4,Queens,40499004001,415,199,216,3.47
2020,CB2020,081,4,Queens,40499004002,230,131,99,2.17
2020,CB2020,081,4,Queens,40499004003,256,117,139,6.28
2020,CB2020,081,4,Queens,40499004004,114,63,51,12.72
2020,CB2020,081,4,Queens,40499004005,360,188,172,3.1
2020,CB2020,081,4,Queens,40500001000,6,2,4,9.9
2020,CB2020,081,4,Queens,40500001001,215,96,119,3.1
2020,CB2020,081,4,Queens,40500001002,239,115,124,7.63
2020,CB2020,081,4,Queens,40500001003,116,67,49,2.47
2020,CB2020,081,4,Queens,40500001004,114,50,64,4.14
2020,CB2020,081,4,Queens,40500001005,0,0,0,0.86
2020,CB2020,081,4,Queens,40500001006,98,42,56,1.41
2020,CB2020,081,4,Queens,40500001007,385,185,200,4.34
2020,CB2020,081,4,Queens,40500001008,170,69,101,1.61
2020,CB2020,081,4,Queens,40500001009,404,224,180,2.99
2020,CB2020,081,4,Queens,40500001010,65,24,41,2.05
2020,CB2020,081,4,Queens,40500001011,19,8,11,5.27
2020,CB2020,081,4,Queens,40500001012,0,0,0,2.86
2020,CB2020,081,4,Queens,40500001013,34,26,8,0.9
2020,CB2020,081,4,Queens,40500002000,881,399,482,6.52
2020,CB2020,081,4,Queens,40500002001,535,212,323,6.55
2020,CB2020,081,4,Queens,40500002002,1059,505,554,5.44
2020,CB2020,081,4,Queens,40500002003,147,94,53,2.61
2020,CB2020,081,4,Queens,40500002004,106,36,70,3.02
2020,CB2020,081,4,Queens,40500002005,47,12,35,6.18
2020,CB2020,081,4,Queens,40500002006,138,67,71,3.2
2020,CB2020,081,4,Queens,40502011000,118,24,94,2.31
2020,CB2020,081,4,Queens,40502011001,101,60,41,2.34
2020,CB2020,081,4,Queens,40502011002,77,21,56,2.3
2020,CB2020,081,4,Queens,40502011003,112,40,72,2.39
2020,CB2020,081,4,Queens,40502011004,231,107,124,2.78
2020,CB2020,081,4,Queens,40502011005,100,60,40,3.26
2020,CB2020,081,4,Queens,40502011006,55,31,24,1.75
2020,CB2020,081,4,Queens,40502011007,117,72,45,4.62
2020,CB2020,081,4,Queens,40502011008,187,84,103,3.99
2020,CB2020,081,4,Queens,40502011009,158,60,98,3.96
2020,CB2020,081,4,Queens,40502011010,196,84,112,3.97
2020,CB2020,081,4,Queens,40502011011,87,24,63,3.57
2020,CB2020,081,4,Queens,40502011012,104,46,58,2.89
2020,CB2020,081,4,Queens,40502011013,35,24,11,1.43
2020,CB2020,081,4,Queens,40502021000,149,90,59,2.36
2020,CB2020,081,4,Queens,40502021001,126,36,90,2.3
2020,CB2020,081,4,Queens,40502021002,53,34,19,2.32
2020,CB2020,081,4,Queens,40502021003,88,39,49,2.33
2020,CB2020,081,4,Queens,40502021004,99,45,54,2.31
2020,CB2020,081,4,Queens,40502021005,48,26,22,0.86
2020,CB2020,081,4,Queens,40502021006,41,14,27,1.45
2020,CB2020,081,4,Queens,40502021007,140,74,66,3.98
2020,CB2020,081,4,Queens,40502021008,140,59,81,3.97
2020,CB2020,081,4,Queens,40502021009,131,57,74,3.98
2020,CB2020,081,4,Queens,40502021010,162,77,85,3.97
2020,CB2020,081,4,Queens,40502021011,155,77,78,3.97
2020,CB2020,081,4,Queens,40502021012,189,80,109,3.97
2020,CB2020,081,4,Queens,40504001000,320,123,197,2.67
2020,CB2020,081,4,Queens,40504001001,50,9,41,1.67
2020,CB2020,081,4,Queens,40504001002,0,0,0,0.48
2020,CB2020,081,4,Queens,40504001003,113,54,59,3.72
2020,CB2020,081,4,Queens,40504001004,79,50,29,2.47
2020,CB2020,081,4,Queens,40504001005,58,44,14,2.47
2020,CB2020,081,4,Queens,40504001006,68,37,31,2.23
2020,CB2020,081,4,Queens,40504001007,98,44,54,3.42
2020,CB2020,081,4,Queens,40504001008,100,43,57,2.51
2020,CB2020,081,4,Queens,40504001009,99,52,47,2
2020,CB2020,081,4,Queens,40504001010,169,82,87,2.76
2020,CB2020,081,4,Queens,40504002000,95,30,65,4.16
2020,CB2020,081,4,Queens,40504002001,80,22,58,3.7
2020,CB2020,081,4,Queens,40504002002,128,71,57,3.31
2020,CB2020,081,4,Queens,40504002003,103,62,41,3.19
2020,CB2020,081,4,Queens,40504002004,76,14,62,3.08
2020,CB2020,081,4,Queens,40504002005,0,0,0,2.5
2020,CB2020,081,4,Queens,40504002006,95,72,23,2.09
2020,CB2020,081,4,Queens,40504002007,48,18,30,2.19
2020,CB2020,081,4,Queens,40504002008,93,47,46,2.82
2020,CB2020,081,4,Queens,40505001000,56,36,20,4.67
2020,CB2020,081,4,Queens,40505001001,72,49,23,1.26
2020,CB2020,081,4,Queens,40505001002,0,0,0,1.38
2020,CB2020,081,4,Queens,40505001003,161,85,76,2.26
2020,CB2020,081,4,Queens,40505001004,182,86,96,2.86
2020,CB2020,081,4,Queens,40505001005,138,50,88,1.52
2020,CB2020,081,4,Queens,40505001006,177,91,86,2.04
2020,CB2020,081,4,Queens,40505001007,137,71,66,2.81
2020,CB2020,081,4,Queens,40505001008,245,114,131,2.92
2020,CB2020,081,4,Queens,40505001009,227,105,122,2.95
2020,CB2020,081,4,Queens,40505001010,208,100,108,1.85
2020,CB2020,081,4,Queens,40505001011,165,85,80,2.17
2020,CB2020,081,4,Queens,40506001000,130,84,46,3.41
2020,CB2020,081,4,Queens,40506001001,147,61,86,3.4
2020,CB2020,081,4,Queens,40506001002,161,64,97,4.09
2020,CB2020,081,4,Queens,40506001003,99,67,32,3.39
2020,CB2020,081,4,Queens,40506001004,83,32,51,2.34
2020,CB2020,081,4,Queens,40506001005,86,41,45,1.47
2020,CB2020,081,4,Queens,40506002000,178,72,106,5.13
2020,CB2020,081,4,Queens,40506002001,143,64,79,5.99
2020,CB2020,081,4,Queens,40506002002,91,33,58,3.47
2020,CB2020,081,4,Queens,40506002003,113,41,72,4.23
2020,CB2020,081,4,Queens,40506002004,111,58,53,3.9
2020,CB2020,081,4,Queens,40506002005,90,38,52,3.37
2020,CB2020,081,4,Queens,40506002006,64,25,39,3.37
2020,CB2020,081,4,Queens,40506002007,139,80,59,3.37
2020,CB2020,081,4,Queens,40507001000,0,0,0,1.6
2020,CB2020,081,4,Queens,40507001001,32,14,18,3.94
2020,CB2020,081,4,Queens,40507001002,155,77,78,2.85
2020,CB2020,081,4,Queens,40507001003,165,89,76,2.87
2020,CB2020,081,4,Queens,40507001004,183,101,82,2.7
2020,CB2020,081,4,Queens,40507001005,118,49,69,2.25
2020,CB2020,081,4,Queens,40507001006,113,36,77,3.14
2020,CB2020,081,4,Queens,40507001007,173,74,99,3.43
2020,CB2020,081,4,Queens,40507001008,0,0,0,1.01
2020,CB2020,081,4,Queens,40507001009,0,0,0,0.61
2020,CB2020,081,4,Queens,40507001010,0,0,0,1.15
2020,CB2020,081,4,Queens,40507001011,182,99,83,9.88
2020,CB2020,081,4,Queens,40507001012,74,43,31,1.51
2020,CB2020,081,4,Queens,40507001013,169,69,100,3.63
2020,CB2020,081,4,Queens,40507001014,380,195,185,11.52
2020,CB2020,081,4,Queens,40507001015,205,108,97,3.49
2020,CB2020,081,4,Queens,40507002000,268,107,161,3.89
2020,CB2020,081,4,Queens,40507002001,223,110,113,3.57
2020,CB2020,081,4,Queens,40507002002,58,49,9,1.87
2020,CB2020,081,4,Queens,40507002003,235,130,105,4.62
2020,CB2020,081,4,Queens,40507002004,190,87,103,4.08
2020,CB2020,081,4,Queens,40507002005,172,80,92,3.85
2020,CB2020,081,4,Queens,40507002006,171,77,94,3.76
2020,CB2020,081,4,Queens,40507002007,191,90,101,3.81
2020,CB2020,081,4,Queens,40507002008,76,30,46,2.06
2020,CB2020,081,4,Queens,40507002009,63,28,35,2.25
2020,CB2020,081,4,Queens,40507002010,103,53,50,2.61
2020,CB2020,081,4,Queens,40508001000,105,35,70,3.4
2020,CB2020,081,4,Queens,40508001001,151,84,67,3.4
2020,CB2020,081,4,Queens,40508001002,166,73,93,3.41
2020,CB2020,081,4,Queens,40508001003,115,39,76,3.4
2020,CB2020,081,4,Queens,40508001004,120,71,49,3.4
2020,CB2020,081,4,Queens,40508001005,158,69,89,2.83
2020,CB2020,081,4,Queens,40508001006,157,65,92,3.13
2020,CB2020,081,4,Queens,40508001007,139,89,50,3.26
2020,CB2020,081,4,Queens,40508001008,33,11,22,3.29
2020,CB2020,081,4,Queens,40508001009,132,59,73,3.33
2020,CB2020,081,4,Queens,40508002000,0,0,0,4.03
2020,CB2020,081,4,Queens,40508002001,222,110,112,4.1
2020,CB2020,081,4,Queens,40508002002,249,141,108,4.19
2020,CB2020,081,4,Queens,40508002003,151,54,97,4.39
2020,CB2020,081,4,Queens,40508002004,186,103,83,4.7
2020,CB2020,081,4,Queens,40510001000,43,17,26,2.31
2020,CB2020,081,4,Queens,40510001001,56,29,27,2.29
2020,CB2020,081,4,Queens,40510001002,74,36,38,2.31
2020,CB2020,081,4,Queens,40510001003,94,49,45,2.31
2020,CB2020,081,4,Queens,40510001004,136,62,74,3.97
2020,CB2020,081,4,Queens,40510001005,136,53,83,3.97
2020,CB2020,081,4,Queens,40510001006,148,69,79,3.97
2020,CB2020,081,4,Queens,40510001007,89,30,59,1.92
2020,CB2020,081,4,Queens,40510001008,100,60,40,2.06
2020,CB2020,081,4,Queens,40510002000,74,40,34,2.12
2020,CB2020,081,4,Queens,40510002001,99,44,55,3.4
2020,CB2020,081,4,Queens,40510002002,175,94,81,3.38
2020,CB2020,081,4,Queens,40510002003,88,45,43,2.15
2020,CB2020,081,4,Queens,40510002004,83,27,56,1.29
2020,CB2020,081,4,Queens,40510002005,49,23,26,1.28
2020,CB2020,081,4,Queens,40510002006,76,48,28,4.15
2020,CB2020,081,4,Queens,40510002007,69,16,53,1.91
2020,CB2020,081,4,Queens,40510002008,27,6,21,0.9
2020,CB2020,081,4,Queens,40511001000,150,62,88,3.05
2020,CB2020,081,4,Queens,40511001001,214,115,99,4.07
2020,CB2020,081,4,Queens,40511001002,143,70,73,3.82
2020,CB2020,081,4,Queens,40511001003,184,93,91,4.07
2020,CB2020,081,4,Queens,40511001004,119,53,66,2.36
2020,CB2020,081,4,Queens,40511001005,0,0,0,5.33
2020,CB2020,081,4,Queens,40511001006,21,5,16,0.55
2020,CB2020,081,4,Queens,40511001007,86,24,62,1.87
2020,CB2020,081,4,Queens,40511001008,0,0,0,9.17
2020,CB2020,081,4,Queens,40511001009,0,0,0,0.86
2020,CB2020,081,4,Queens,40511001010,137,74,63,2.98
2020,CB2020,081,4,Queens,40511001011,192,114,78,3.53
2020,CB2020,081,4,Queens,40511001012,39,22,17,0.94
2020,CB2020,081,4,Queens,40511002000,267,125,142,5.08
2020,CB2020,081,4,Queens,40511002001,283,130,153,4.79
2020,CB2020,081,4,Queens,40511002002,255,111,144,3.81
2020,CB2020,081,4,Queens,40511002003,278,148,130,3.94
2020,CB2020,081,4,Queens,40511002004,96,59,37,2.33
2020,CB2020,081,4,Queens,40511002005,30,13,17,2.21
2020,CB2020,081,4,Queens,40511002006,0,0,0,2.3
2020,CB2020,081,4,Queens,40511002007,0,0,0,0.61
2020,CB2020,081,4,Queens,40512001000,0,0,0,7.64
2020,CB2020,081,4,Queens,40512001001,0,0,0,3.66
2020,CB2020,081,4,Queens,40512001002,103,65,38,3.5
2020,CB2020,081,4,Queens,40512001003,155,70,85,6.35
2020,CB2020,081,4,Queens,40512001004,105,57,48,2.9
2020,CB2020,081,4,Queens,40512001005,160,82,78,4.63
2020,CB2020,081,4,Queens,40512001006,68,23,45,2.3
2020,CB2020,081,4,Queens,40512001007,80,21,59,2.35
2020,CB2020,081,4,Queens,40512001008,85,38,47,2.32
2020,CB2020,081,4,Queens,40512001009,98,39,59,3.97
2020,CB2020,081,4,Queens,40512001010,141,76,65,4.04
2020,CB2020,081,4,Queens,40512002000,127,67,60,4.04
2020,CB2020,081,4,Queens,40512002001,130,66,64,3.42
2020,CB2020,081,4,Queens,40512002002,102,38,64,3.47
2020,CB2020,081,4,Queens,40512002003,109,51,58,3.47
2020,CB2020,081,4,Queens,40512002004,72,9,63,3.41
2020,CB2020,081,4,Queens,40512002005,98,35,63,3.5
2020,CB2020,081,4,Queens,40512002006,127,79,48,3.25
2020,CB2020,081,4,Queens,40512002007,129,62,67,3
2020,CB2020,081,4,Queens,40512002008,125,57,68,2.75
2020,CB2020,081,4,Queens,40512002009,84,44,40,2.44
2020,CB2020,081,4,Queens,40512003000,36,20,16,1.51
2020,CB2020,081,4,Queens,40512003001,150,74,76,3.96
2020,CB2020,081,4,Queens,40512003002,211,97,114,4.06
2020,CB2020,081,4,Queens,40512003003,116,45,71,3.11
2020,CB2020,081,4,Queens,40512003004,19,7,12,0.67
2020,CB2020,081,4,Queens,40512003005,118,55,63,3.13
2020,CB2020,081,4,Queens,40513001000,34,14,20,3.49
2020,CB2020,081,4,Queens,40513001001,141,80,61,2.35
2020,CB2020,081,4,Queens,40513001002,52,31,21,0.95
2020,CB2020,081,4,Queens,40513001003,91,51,40,1.51
2020,CB2020,081,4,Queens,40513001004,80,52,28,1.58
2020,CB2020,081,4,Queens,40513001005,57,34,23,0.94
2020,CB2020,081,4,Queens,40513001006,84,37,47,1.88
2020,CB2020,081,4,Queens,40513001007,226,109,117,3.05
2020,CB2020,081,4,Queens,40513001008,243,121,122,3.63
2020,CB2020,081,4,Queens,40513001009,139,71,68,2.39
2020,CB2020,081,4,Queens,40513001010,223,90,133,3.09
2020,CB2020,081,4,Queens,40513001011,142,68,74,2.18
2020,CB2020,081,4,Queens,40513002000,133,78,55,2.22
2020,CB2020,081,4,Queens,40513002001,185,74,111,3.25
2020,CB2020,081,4,Queens,40513002002,312,151,161,5.75
2020,CB2020,081,4,Queens,40513002003,189,88,101,3.3
2020,CB2020,081,4,Queens,40513002004,104,77,27,2.1
2020,CB2020,081,4,Queens,40513002005,86,30,56,1.42
2020,CB2020,081,4,Queens,40513002006,117,59,58,2.74
2020,CB2020,081,4,Queens,40515001000,66,31,35,1.52
2020,CB2020,081,4,Queens,40515001001,36,23,13,0.79
2020,CB2020,081,4,Queens,40515001002,69,28,41,0.77
2020,CB2020,081,4,Queens,40515001003,340,146,194,5.18
2020,CB2020,081,4,Queens,40515001004,302,177,125,5.3
2020,CB2020,081,4,Queens,40515002000,37,9,28,0.5
2020,CB2020,081,4,Queens,40515002001,90,71,19,1.01
2020,CB2020,081,4,Queens,40515002002,134,76,58,5.22
2020,CB2020,081,4,Queens,40515002003,633,302,331,4.74
2020,CB2020,081,4,Queens,40515002004,558,260,298,5.98
2020,CB2020,081,4,Queens,40515003000,116,62,54,5.29
2020,CB2020,081,4,Queens,40515003001,232,114,118,5.06
2020,CB2020,081,4,Queens,40515003002,187,91,96,4.37
2020,CB2020,081,4,Queens,40515003003,222,101,121,4.66
2020,CB2020,081,4,Queens,40515003004,29,8,21,0.67
2020,CB2020,081,4,Queens,40515003005,75,53,22,4.41
2020,CB2020,081,4,Queens,40516001000,119,58,61,3.05
2020,CB2020,081,4,Queens,40516001001,113,52,61,3.1
2020,CB2020,081,4,Queens,40516001002,127,66,61,3.09
2020,CB2020,081,4,Queens,40516001003,241,119,122,3.34
2020,CB2020,081,4,Queens,40516001004,161,77,84,3.38
2020,CB2020,081,4,Queens,40516002000,81,37,44,2.43
2020,CB2020,081,4,Queens,40516002001,175,75,100,3.1
2020,CB2020,081,4,Queens,40516002002,183,69,114,3.1
2020,CB2020,081,4,Queens,40516002003,182,91,91,3.11
2020,CB2020,081,4,Queens,40516002004,123,41,82,3.34
2020,CB2020,081,4,Queens,40516002005,201,109,92,5.03
2020,CB2020,081,4,Queens,40516002006,211,97,114,4.66
2020,CB2020,081,4,Queens,40516002007,152,63,89,4.65
2020,CB2020,081,4,Queens,40517001000,0,0,0,0.51
2020,CB2020,081,4,Queens,40517001001,0,0,0,1.37
2020,CB2020,081,4,Queens,40517001002,0,0,0,2.28
2020,CB2020,081,4,Queens,40517001003,0,0,0,6.4
2020,CB2020,081,4,Queens,40517001004,25,5,20,1.28
2020,CB2020,081,4,Queens,40517001005,0,0,0,0.46
2020,CB2020,081,4,Queens,40517001006,213,109,104,3.96
2020,CB2020,081,4,Queens,40517001007,0,0,0,0.9
2020,CB2020,081,4,Queens,40517001008,11,5,6,1.73
2020,CB2020,081,4,Queens,40517001009,24,13,11,0.73
2020,CB2020,081,4,Queens,40517001010,136,47,89,2.18
2020,CB2020,081,4,Queens,40517001011,113,78,35,2.39
2020,CB2020,081,4,Queens,40517001012,0,0,0,0.3
2020,CB2020,081,4,Queens,40517001013,58,25,33,2.27
2020,CB2020,081,4,Queens,40517001014,142,73,69,5.86
2020,CB2020,081,4,Queens,40517001015,0,0,0,2.25
2020,CB2020,081,4,Queens,40517001016,113,52,61,2.26
2020,CB2020,081,4,Queens,40517001017,143,67,76,3.79
2020,CB2020,081,4,Queens,40517001018,50,14,36,1.18
2020,CB2020,081,4,Queens,40517002000,104,44,60,1.72
2020,CB2020,081,4,Queens,40517002001,190,93,97,4.01
2020,CB2020,081,4,Queens,40517002002,253,136,117,4.11
2020,CB2020,081,4,Queens,40517002003,127,68,59,2.74
2020,CB2020,081,4,Queens,40517002004,181,102,79,3.61
2020,CB2020,081,4,Queens,40517002005,263,105,158,4.49
2020,CB2020,081,4,Queens,40518001000,133,59,74,3.13
2020,CB2020,081,4,Queens,40518001001,131,45,86,3.13
2020,CB2020,081,4,Queens,40518001002,112,52,60,3.13
2020,CB2020,081,4,Queens,40518001003,131,52,79,3.1
2020,CB2020,081,4,Queens,40518001004,141,55,86,3.1
2020,CB2020,081,4,Queens,40518001005,161,101,60,3.1
2020,CB2020,081,4,Queens,40518002000,186,67,119,3.1
2020,CB2020,081,4,Queens,40518002001,136,68,68,3.11
2020,CB2020,081,4,Queens,40518002002,98,41,57,3.1
2020,CB2020,081,4,Queens,40518002003,246,103,143,4.65
2020,CB2020,081,4,Queens,40518002004,250,114,136,4.66
2020,CB2020,081,4,Queens,40518002005,223,103,120,4.64
2020,CB2020,081,4,Queens,40520001000,105,61,44,3.2
2020,CB2020,081,4,Queens,40520001001,83,27,56,3.19
2020,CB2020,081,4,Queens,40520001002,86,32,54,3.13
2020,CB2020,081,4,Queens,40520001003,73,29,44,3.11
2020,CB2020,081,4,Queens,40520001004,96,44,52,3.16
2020,CB2020,081,4,Queens,40520001005,146,83,63,3.16
2020,CB2020,081,4,Queens,40520001006,127,52,75,3.16
2020,CB2020,081,4,Queens,40520001007,127,47,80,3.16
2020,CB2020,081,4,Queens,40520001008,120,40,80,3.1
2020,CB2020,081,4,Queens,40520001009,319,168,151,4.66
2020,CB2020,081,4,Queens,40520001010,215,59,156,4.76
2020,CB2020,081,4,Queens,40520001011,96,36,60,4.76
2020,CB2020,081,4,Queens,40521001000,660,355,305,9.85
2020,CB2020,081,4,Queens,40521001001,0,0,0,0.39
2020,CB2020,081,4,Queens,40521001002,152,50,102,4.9
2020,CB2020,081,4,Queens,40521002000,106,54,52,3.75
2020,CB2020,081,4,Queens,40521002001,167,52,115,4.02
2020,CB2020,081,4,Queens,40521002002,295,160,135,5.97
2020,CB2020,081,4,Queens,40521002003,393,180,213,5.56
2020,CB2020,081,4,Queens,40521002004,293,142,151,4.41
2020,CB2020,081,4,Queens,40521002005,34,12,22,1.09
2020,CB2020,081,4,Queens,40521002006,61,24,37,3.38
2020,CB2020,081,4,Queens,40521002007,36,27,9,3.69
2020,CB2020,081,4,Queens,40522001000,71,24,47,3.14
2020,CB2020,081,4,Queens,40522001001,92,45,47,3.13
2020,CB2020,081,4,Queens,40522001002,114,57,57,3.13
2020,CB2020,081,4,Queens,40522001003,132,53,79,3.11
2020,CB2020,081,4,Queens,40522001004,120,72,48,3.1
2020,CB2020,081,4,Queens,40522001005,97,21,76,3.1
2020,CB2020,081,4,Queens,40522001006,114,37,77,3.1
2020,CB2020,081,4,Queens,40522001007,126,60,66,3.1
2020,CB2020,081,4,Queens,40522001008,0,0,0,3.1
2020,CB2020,081,4,Queens,40522001009,161,64,97,4.67
2020,CB2020,081,4,Queens,40522001010,240,119,121,4.64
2020,CB2020,081,4,Queens,40522001011,338,172,166,4.65
2020,CB2020,081,4,Queens,40524001000,138,54,84,4
2020,CB2020,081,4,Queens,40524001001,62,28,34,2.43
2020,CB2020,081,4,Queens,40524001002,253,115,138,5.9
2020,CB2020,081,4,Queens,40524001003,208,104,104,5.2
2020,CB2020,081,4,Queens,40524001004,166,77,89,4.53
2020,CB2020,081,4,Queens,40524001005,141,59,82,3.94
2020,CB2020,081,4,Queens,40524002000,175,70,105,3.94
2020,CB2020,081,4,Queens,40524002001,160,90,70,3.92
2020,CB2020,081,4,Queens,40524002002,105,54,51,3.51
2020,CB2020,081,4,Queens,40524002003,188,85,103,3.95
2020,CB2020,081,4,Queens,40524002004,185,87,98,3.92
2020,CB2020,081,4,Queens,40524002005,164,72,92,3.23
2020,CB2020,081,4,Queens,40525001000,257,139,118,3.94
2020,CB2020,081,4,Queens,40525001001,217,97,120,2.87
2020,CB2020,081,4,Queens,40525001002,218,89,129,2.78
2020,CB2020,081,4,Queens,40525001003,271,152,119,4.23
2020,CB2020,081,4,Queens,40525001004,103,17,86,2.25
2020,CB2020,081,4,Queens,40525001005,149,87,62,3.03
2020,CB2020,081,4,Queens,40525001006,205,96,109,3.91
2020,CB2020,081,4,Queens,40525002000,286,160,126,4.43
2020,CB2020,081,4,Queens,40525002001,21,12,9,7.16
2020,CB2020,081,4,Queens,40525002002,142,75,67,2.43
2020,CB2020,081,4,Queens,40525002003,0,0,0,0.55
2020,CB2020,081,4,Queens,40525002004,136,55,81,3.4
2020,CB2020,081,4,Queens,40525002005,224,113,111,3.17
2020,CB2020,081,4,Queens,40525002006,0,0,0,1.68
2020,CB2020,081,4,Queens,40525002007,23,9,14,4.11
2020,CB2020,081,4,Queens,40526001000,167,67,100,3.93
2020,CB2020,081,4,Queens,40526001001,160,59,101,3.17
2020,CB2020,081,4,Queens,40526001002,150,62,88,3.19
2020,CB2020,081,4,Queens,40526001003,162,89,73,3.96
2020,CB2020,081,4,Queens,40526001004,179,114,65,3.95
2020,CB2020,081,4,Queens,40526001005,164,87,77,3.23
2020,CB2020,081,4,Queens,40526002000,156,86,70,3.94
2020,CB2020,081,4,Queens,40526002001,143,69,74,3.45
2020,CB2020,081,4,Queens,40526002002,136,56,80,3.8
2020,CB2020,081,4,Queens,40526002003,195,87,108,3.94
2020,CB2020,081,4,Queens,40526002004,160,77,83,3.92
2020,CB2020,081,4,Queens,40526002005,186,75,111,4.62
2020,CB2020,081,4,Queens,40528001000,226,88,138,4.67
2020,CB2020,081,4,Queens,40528001001,102,38,64,4.27
2020,CB2020,081,4,Queens,40528001002,119,66,53,3.85
2020,CB2020,081,4,Queens,40528001003,135,66,69,3.94
2020,CB2020,081,4,Queens,40528001004,112,60,52,4.02
2020,CB2020,081,4,Queens,40528001005,39,14,25,2.21
2020,CB2020,081,4,Queens,40528001006,217,76,141,5.61
2020,CB2020,081,4,Queens,40528001007,159,73,86,4.02
2020,CB2020,081,4,Queens,40528001008,62,20,42,1.97
2020,CB2020,081,4,Queens,40528001009,67,22,45,2
2020,CB2020,081,4,Queens,40528001010,81,58,23,1.98
2020,CB2020,081,4,Queens,40528001011,83,43,40,2.02
2020,CB2020,081,4,Queens,40528001012,69,41,28,2.07
2020,CB2020,081,4,Queens,40528001013,92,41,51,1.93
2020,CB2020,081,4,Queens,40530001000,197,101,96,4.65
2020,CB2020,081,4,Queens,40530001001,185,91,94,4.63
2020,CB2020,081,4,Queens,40530001002,171,53,118,4.77
2020,CB2020,081,4,Queens,40530001003,143,47,96,3.47
2020,CB2020,081,4,Queens,40530001004,136,59,77,3.37
2020,CB2020,081,4,Queens,40530001005,116,70,46,3.36
2020,CB2020,081,4,Queens,40530002000,160,69,91,4.76
2020,CB2020,081,4,Queens,40530002001,181,95,86,4.65
2020,CB2020,081,4,Queens,40530002002,232,84,148,4.66
2020,CB2020,081,4,Queens,40530002003,280,119,161,4.66
2020,CB2020,081,4,Queens,40530002004,124,71,53,3.5
2020,CB2020,081,4,Queens,40530002005,115,60,55,3.45
2020,CB2020,081,4,Queens,40530002006,165,90,75,3.46
2020,CB2020,081,4,Queens,40530002007,188,96,92,3.49
2020,CB2020,081,4,Queens,40531001000,210,117,93,5.4
2020,CB2020,081,4,Queens,40531001001,136,66,70,3.3
2020,CB2020,081,4,Queens,40531001002,110,59,51,7.05
2020,CB2020,081,4,Queens,40531001003,470,234,236,6.16
2020,CB2020,081,4,Queens,40531001004,251,103,148,4.92
2020,CB2020,081,4,Queens,40531001005,53,20,33,1.46
2020,CB2020,081,4,Queens,40531001006,226,130,96,4.82
2020,CB2020,081,4,Queens,40531001007,36,7,29,1.46
2020,CB2020,081,4,Queens,40531001008,60,26,34,4.55
2020,CB2020,081,4,Queens,40531001009,65,27,38,2.21
2020,CB2020,081,4,Queens,40531001010,192,108,84,2.21
2020,CB2020,081,4,Queens,40531001011,41,32,9,1.2
2020,CB2020,081,4,Queens,40531001012,0,0,0,0.41
2020,CB2020,081,4,Queens,40531001013,0,0,0,1.5
2020,CB2020,081,4,Queens,40531002000,222,108,114,3.02
2020,CB2020,081,4,Queens,40531002001,0,0,0,0.63
2020,CB2020,081,4,Queens,40531002002,230,119,111,3.01
2020,CB2020,081,4,Queens,40531002003,223,107,116,3.01
2020,CB2020,081,4,Queens,40531002004,163,82,81,3.05
2020,CB2020,081,4,Queens,40531003000,15,8,7,0.96
2020,CB2020,081,4,Queens,40531003001,0,0,0,3.91
2020,CB2020,081,4,Queens,40531003002,52,28,24,4.33
2020,CB2020,081,4,Queens,40531003003,15,6,9,6.37
2020,CB2020,081,4,Queens,40531003004,114,43,71,4.13
2020,CB2020,081,4,Queens,40531003005,65,45,20,3.29
2020,CB2020,081,4,Queens,40531003006,31,11,20,3.24
2020,CB2020,081,4,Queens,40531003007,50,14,36,1.88
2020,CB2020,081,4,Queens,40531003008,122,76,46,2.15
2020,CB2020,081,4,Queens,40531003009,27,11,16,1.5
2020,CB2020,081,4,Queens,40531003010,45,21,24,2.35
2020,CB2020,081,4,Queens,40531003011,80,45,35,1.62
2020,CB2020,081,4,Queens,40531003012,47,19,28,2.31
2020,CB2020,081,4,Queens,40531003013,58,39,19,2.3
2020,CB2020,081,4,Queens,40531003014,0,0,0,0.59
2020,CB2020,081,4,Queens,40531003015,11,3,8,2.14
2020,CB2020,081,4,Queens,40531003016,42,17,25,2.2
2020,CB2020,081,4,Queens,40532001000,31,13,18,0.91
2020,CB2020,081,4,Queens,40532001001,78,28,50,1.92
2020,CB2020,081,4,Queens,40532001002,98,53,45,1.89
2020,CB2020,081,4,Queens,40532001003,33,12,21,0.88
2020,CB2020,081,4,Queens,40532001004,58,33,25,0.88
2020,CB2020,081,4,Queens,40532001005,87,24,63,1.84
2020,CB2020,081,4,Queens,40532001006,127,55,72,2.81
2020,CB2020,081,4,Queens,40532001007,104,73,31,2.7
2020,CB2020,081,4,Queens,40532001008,117,49,68,2.8
2020,CB2020,081,4,Queens,40532001009,106,48,58,1.91
2020,CB2020,081,4,Queens,40532001010,73,38,35,0.93
2020,CB2020,081,4,Queens,40532001011,89,29,60,2.65
2020,CB2020,081,4,Queens,40532001012,54,16,38,1.9
2020,CB2020,081,4,Queens,40532001013,48,23,25,0.91
2020,CB2020,081,4,Queens,40532002000,36,22,14,0.9
2020,CB2020,081,4,Queens,40532002001,76,32,44,1.97
2020,CB2020,081,4,Queens,40532002002,77,37,40,1.82
2020,CB2020,081,4,Queens,40532002003,43,18,25,0.8
2020,CB2020,081,4,Queens,40532002004,41,29,12,0.88
2020,CB2020,081,4,Queens,40532002005,89,34,55,1.87
2020,CB2020,081,4,Queens,40532002006,209,91,118,4.68
2020,CB2020,081,4,Queens,40532002007,80,40,40,3.32
2020,CB2020,081,4,Queens,40532002008,85,30,55,2.92
2020,CB2020,081,4,Queens,40532002009,47,11,36,2.83
2020,CB2020,081,4,Queens,40534011000,69,13,56,3.67
2020,CB2020,081,4,Queens,40534011001,98,53,45,2.14
2020,CB2020,081,4,Queens,40534011002,167,51,116,4.02
2020,CB2020,081,4,Queens,40534011003,154,63,91,4.64
2020,CB2020,081,4,Queens,40534011004,7,2,5,9.68
2020,CB2020,081,4,Queens,40534011005,134,54,80,4.4
2020,CB2020,081,4,Queens,40534011006,142,84,58,3.48
2020,CB2020,081,4,Queens,40534011007,91,40,51,3.35
2020,CB2020,081,4,Queens,40534011008,61,35,26,1.42
2020,CB2020,081,4,Queens,40534011009,94,27,67,1.74
2020,CB2020,081,4,Queens,40534011010,38,22,16,2.26
2020,CB2020,081,4,Queens,40534012000,138,75,63,4.11
2020,CB2020,081,4,Queens,40534012001,73,45,28,1.72
2020,CB2020,081,4,Queens,40534012002,0,0,0,0.48
2020,CB2020,081,4,Queens,40534012003,182,67,115,3.85
2020,CB2020,081,4,Queens,40534012004,39,25,14,0.91
2020,CB2020,081,4,Queens,40534012005,25,3,22,0.63
2020,CB2020,081,4,Queens,40534012006,149,69,80,2.5
2020,CB2020,081,4,Queens,40534012007,282,128,154,4.66
2020,CB2020,081,4,Queens,40534012008,161,78,83,4.65
2020,CB2020,081,4,Queens,40535011000,0,0,0,8.15
2020,CB2020,081,4,Queens,40535011001,53,21,32,6.37
2020,CB2020,081,4,Queens,40535011002,88,36,52,6.9
2020,CB2020,081,4,Queens,40535011003,87,39,48,5.92
2020,CB2020,081,4,Queens,40535011004,46,38,8,2.04
2020,CB2020,081,4,Queens,40535011005,278,112,166,2.38
2020,CB2020,081,4,Queens,40535011006,215,97,118,3.16
2020,CB2020,081,4,Queens,40535011007,45,24,21,1.23
2020,CB2020,081,4,Queens,40535011008,72,57,15,2.73
2020,CB2020,081,4,Queens,40535011009,64,33,31,1.62
2020,CB2020,081,4,Queens,40535011010,30,16,14,2.05
2020,CB2020,081,4,Queens,40535011011,80,31,49,1.41
2020,CB2020,081,4,Queens,40535021000,0,0,0,60.53
2020,CB2020,081,4,Queens,40535021001,0,0,0,0
2020,CB2020,081,4,Queens,40535021002,0,0,0,19.72
2020,CB2020,081,4,Queens,40536011000,137,72,65,4.18
2020,CB2020,081,4,Queens,40536011001,162,71,91,5.45
2020,CB2020,081,4,Queens,40536011002,115,48,67,4.3
2020,CB2020,081,4,Queens,40536011003,65,38,27,2.23
2020,CB2020,081,4,Queens,40536011004,86,52,34,1.95
2020,CB2020,081,4,Queens,40536011005,136,63,73,4.51
2020,CB2020,081,4,Queens,40536011006,130,58,72,4.28
2020,CB2020,081,4,Queens,40536011007,60,28,32,1.49
2020,CB2020,081,4,Queens,40536012000,140,56,84,4.09
2020,CB2020,081,4,Queens,40536012001,31,19,12,0.9
2020,CB2020,081,4,Queens,40536012002,164,57,107,3.72
2020,CB2020,081,4,Queens,40536012003,121,54,67,3.5
2020,CB2020,081,4,Queens,40536012004,127,69,58,2.98
2020,CB2020,081,4,Queens,40536012005,104,61,43,3.73
2020,CB2020,081,4,Queens,40538001000,100,49,51,4.04
2020,CB2020,081,4,Queens,40538001001,117,60,57,4.02
2020,CB2020,081,4,Queens,40538001002,92,39,53,3.99
2020,CB2020,081,4,Queens,40538001003,106,49,57,3.47
2020,CB2020,081,4,Queens,40538001004,83,37,46,2.6
2020,CB2020,081,4,Queens,40538001005,119,47,72,2.53
2020,CB2020,081,4,Queens,40538001006,90,42,48,1.7
2020,CB2020,081,4,Queens,40538001007,115,52,63,2.56
2020,CB2020,081,4,Queens,40538002000,120,79,41,3.55
2020,CB2020,081,4,Queens,40538002001,129,40,89,3.51
2020,CB2020,081,4,Queens,40538002002,110,53,57,3.39
2020,CB2020,081,4,Queens,40538002003,106,40,66,3.58
2020,CB2020,081,4,Queens,40538002004,191,82,109,4.07
2020,CB2020,081,4,Queens,40538002005,170,84,86,3.64
2020,CB2020,081,4,Queens,40539011000,75,42,33,5.3
2020,CB2020,081,4,Queens,40539011001,42,18,24,6.73
2020,CB2020,081,4,Queens,40539011002,0,0,0,5.69
2020,CB2020,081,4,Queens,40539011003,0,0,0,7.82
2020,CB2020,081,4,Queens,40539011004,0,0,0,4.99
2020,CB2020,081,4,Queens,40539011005,61,37,24,9.1
2020,CB2020,081,4,Queens,40539011006,439,217,222,4.84
2020,CB2020,081,4,Queens,40539011007,0,0,0,3.25
2020,CB2020,081,4,Queens,40539011008,63,28,35,3.06
2020,CB2020,081,4,Queens,40539011009,36,22,14,2.49
2020,CB2020,081,4,Queens,40539011010,216,112,104,3.1
2020,CB2020,081,4,Queens,40539012000,179,84,95,3.07
2020,CB2020,081,4,Queens,40539012001,154,38,116,3.07
2020,CB2020,081,4,Queens,40539012002,617,300,317,16.83
2020,CB2020,081,4,Queens,40539012003,68,33,35,2.5
2020,CB2020,081,4,Queens,40539012004,135,70,65,3.1
2020,CB2020,081,4,Queens,40539012005,158,82,76,2.49
2020,CB2020,081,4,Queens,40539012006,51,30,21,2.5
2020,CB2020,081,4,Queens,40539012007,323,167,156,3.11
2020,CB2020,081,4,Queens,40539012008,218,107,111,3.11
2020,CB2020,081,4,Queens,40539013000,188,102,86,3.09
2020,CB2020,081,4,Queens,40539013001,288,155,133,3.09
2020,CB2020,081,4,Queens,40539013002,328,167,161,3.08
2020,CB2020,081,4,Queens,40539013003,329,160,169,3.09
2020,CB2020,081,4,Queens,40539021000,88,42,46,40.9
2020,CB2020,081,4,Queens,40540001000,115,55,60,4.33
2020,CB2020,081,4,Queens,40540001001,202,93,109,4.15
2020,CB2020,081,4,Queens,40540001002,195,75,120,4.33
2020,CB2020,081,4,Queens,40540001003,208,87,121,2.76
2020,CB2020,081,4,Queens,40540001004,0,0,0,3.9
2020,CB2020,081,4,Queens,40540001005,143,68,75,3.26
2020,CB2020,081,4,Queens,40540001006,126,65,61,3.28
2020,CB2020,081,4,Queens,40540001007,201,94,107,5.76
2020,CB2020,081,4,Queens,40540001008,212,89,123,4.74
2020,CB2020,081,4,Queens,40540001009,225,140,85,7.24
2020,CB2020,081,4,Queens,40540001010,241,115,126,6.69
2020,CB2020,081,4,Queens,40540001011,82,40,42,2.25
2020,CB2020,081,4,Queens,40540002000,48,22,26,9.94
2020,CB2020,081,4,Queens,40540002001,28,18,10,3.71
2020,CB2020,081,4,Queens,40540002002,163,67,96,3.64
2020,CB2020,081,4,Queens,40540002003,174,88,86,3.64
2020,CB2020,081,4,Queens,40540002004,180,83,97,4
2020,CB2020,081,4,Queens,40540002005,176,103,73,4.02
2020,CB2020,081,4,Queens,40540002006,101,40,61,2.66
2020,CB2020,081,4,Queens,40540002007,101,37,64,2.71
2020,CB2020,081,4,Queens,40540002008,226,88,138,5.94
2020,CB2020,081,4,Queens,40540003000,142,79,63,2.82
2020,CB2020,081,4,Queens,40540003001,155,82,73,3.44
2020,CB2020,081,4,Queens,40540003002,125,66,59,3.53
2020,CB2020,081,4,Queens,40540003003,433,187,246,10.52
2020,CB2020,081,4,Queens,40540003004,154,64,90,3.51
2020,CB2020,081,4,Queens,40540003005,77,41,36,2.16
2020,CB2020,081,4,Queens,40540003006,115,66,49,2.09
2020,CB2020,081,4,Queens,40540003007,20,8,12,1.94
2020,CB2020,081,4,Queens,40540003008,110,66,44,2.98
2020,CB2020,081,4,Queens,40540003009,154,68,86,3.23
2020,CB2020,081,4,Queens,40542001000,102,48,54,3.11
2020,CB2020,081,4,Queens,40542001001,151,83,68,2.85
2020,CB2020,081,4,Queens,40542001002,102,38,64,2.78
2020,CB2020,081,4,Queens,40542001003,166,89,77,2.75
2020,CB2020,081,4,Queens,40542001004,147,71,76,2.7
2020,CB2020,081,4,Queens,40542001005,65,44,21,1.22
2020,CB2020,081,4,Queens,40542001006,77,16,61,1.61
2020,CB2020,081,4,Queens,40542001007,85,37,48,1.99
2020,CB2020,081,4,Queens,40542001008,72,39,33,2.06
2020,CB2020,081,4,Queens,40542001009,80,33,47,2.77
2020,CB2020,081,4,Queens,40542002000,170,68,102,3.19
2020,CB2020,081,4,Queens,40542002001,85,39,46,1.61
2020,CB2020,081,4,Queens,40542002002,174,60,114,3.67
2020,CB2020,081,4,Queens,40542002003,0,0,0,3.35
2020,CB2020,081,4,Queens,40542002004,149,81,68,3.27
2020,CB2020,081,4,Queens,40542002005,124,46,78,3.35
2020,CB2020,081,4,Queens,40542002006,90,60,30,3.34
2020,CB2020,081,4,Queens,40542002007,124,42,82,3.27
2020,CB2020,081,4,Queens,40542002008,159,75,84,3.33
2020,CB2020,081,4,Queens,40542002009,140,101,39,3.62
2020,CB2020,081,4,Queens,40542002010,40,20,20,0.69
2020,CB2020,081,4,Queens,40542003000,150,72,78,4.06
2020,CB2020,081,4,Queens,40542003001,160,90,70,4.37
2020,CB2020,081,4,Queens,40542003002,208,88,120,4.77
2020,CB2020,081,4,Queens,40542003003,143,58,85,4.29
2020,CB2020,081,4,Queens,40542003004,141,74,67,3.72
2020,CB2020,081,4,Queens,40542003005,161,70,91,3.61
2020,CB2020,081,4,Queens,40542003006,185,123,62,3.48
2020,CB2020,081,4,Queens,40542003007,152,78,74,3.48
2020,CB2020,081,4,Queens,40542003008,138,65,73,3.15
2020,CB2020,081,4,Queens,40542003009,125,68,57,3.42
2020,CB2020,081,4,Queens,40542004000,71,38,33,3.44
2020,CB2020,081,4,Queens,40542004001,64,27,37,1.55
2020,CB2020,081,4,Queens,40542004002,74,36,38,2.45
2020,CB2020,081,4,Queens,40542004003,60,23,37,1.65
2020,CB2020,081,4,Queens,40542004004,320,162,158,12.15
2020,CB2020,081,4,Queens,40542004005,132,76,56,3.88
2020,CB2020,081,4,Queens,40542004006,121,54,67,4.75
2020,CB2020,081,4,Queens,40542004007,311,169,142,6.84
2020,CB2020,081,4,Queens,40542004008,131,63,68,2.28
2020,CB2020,081,4,Queens,40545001000,205,104,101,2.5
2020,CB2020,081,4,Queens,40545001001,404,227,177,3.11
2020,CB2020,081,4,Queens,40545001002,445,184,261,3.11
2020,CB2020,081,4,Queens,40545002000,271,142,129,2.5
2020,CB2020,081,4,Queens,40545002001,353,167,186,2.5
2020,CB2020,081,4,Queens,40545002002,302,128,174,2.5
2020,CB2020,081,4,Queens,40545002003,313,151,162,2.5
2020,CB2020,081,4,Queens,40545003000,495,213,282,3.11
2020,CB2020,081,4,Queens,40545003001,535,266,269,3.12
2020,CB2020,081,4,Queens,40545003002,325,182,143,3.11
2020,CB2020,081,4,Queens,40547001000,269,145,124,3.12
2020,CB2020,081,4,Queens,40547001001,333,168,165,3.11
2020,CB2020,081,4,Queens,40547001002,224,115,109,2.49
2020,CB2020,081,4,Queens,40547001003,292,124,168,2.5
2020,CB2020,081,4,Queens,40547001004,301,165,136,2.5
2020,CB2020,081,4,Queens,40547002000,432,232,200,3.11
2020,CB2020,081,4,Queens,40547002001,499,244,255,3.11
2020,CB2020,081,4,Queens,40547002002,556,268,288,3.1
2020,CB2020,081,4,Queens,40547003000,397,186,211,2.96
2020,CB2020,081,4,Queens,40547003001,422,188,234,2.95
2020,CB2020,081,4,Queens,40547003002,441,239,202,2.96
2020,CB2020,081,4,Queens,40548001000,208,98,110,3.48
2020,CB2020,081,4,Queens,40548001001,104,51,53,4.32
2020,CB2020,081,4,Queens,40548001002,241,110,131,5.47
2020,CB2020,081,4,Queens,40548001003,176,89,87,3.44
2020,CB2020,081,4,Queens,40548001004,245,119,126,8.26
2020,CB2020,081,4,Queens,40548001005,130,58,72,4.35
2020,CB2020,081,4,Queens,40548001006,101,52,49,3.47
2020,CB2020,081,4,Queens,40548002000,285,109,176,5.92
2020,CB2020,081,4,Queens,40548002001,280,142,138,5.87
2020,CB2020,081,4,Queens,40548002002,269,145,124,5.73
2020,CB2020,081,4,Queens,40548002003,297,129,168,5.45
2020,CB2020,081,4,Queens,40549001000,364,176,188,3.13
2020,CB2020,081,4,Queens,40549001001,313,164,149,3.12
2020,CB2020,081,4,Queens,40549001002,431,218,213,3.12
2020,CB2020,081,4,Queens,40549002000,391,192,199,2.51
2020,CB2020,081,4,Queens,40549002001,330,165,165,2.49
2020,CB2020,081,4,Queens,40549002002,403,231,172,2.5
2020,CB2020,081,4,Queens,40549003000,488,245,243,3.12
2020,CB2020,081,4,Queens,40549003001,549,272,277,3.11
2020,CB2020,081,4,Queens,40549003002,530,282,248,3.11
2020,CB2020,081,4,Queens,40549004000,473,240,233,2.96
2020,CB2020,081,4,Queens,40549004001,68,43,25,3.01
2020,CB2020,081,4,Queens,40549004002,0,0,0,2.13
2020,CB2020,081,4,Queens,40549004003,189,87,102,2.96
2020,CB2020,081,4,Queens,40549004004,403,204,199,2.94
2020,CB2020,081,4,Queens,40549004005,0,0,0,0.38
2020,CB2020,081,4,Queens,40551001000,192,91,101,2.8
2020,CB2020,081,4,Queens,40551001001,255,134,121,3.61
2020,CB2020,081,4,Queens,40551001002,290,134,156,2.79
2020,CB2020,081,4,Queens,40551001003,52,17,35,1.26
2020,CB2020,081,4,Queens,40551001004,55,28,27,0.54
2020,CB2020,081,4,Queens,40551002000,454,255,199,3.1
2020,CB2020,081,4,Queens,40551002001,476,253,223,2.95
2020,CB2020,081,4,Queens,40551002002,56,31,25,1.19
2020,CB2020,081,4,Queens,40551002003,280,153,127,1.72
2020,CB2020,081,4,Queens,40551002004,0,0,0,0.26
2020,CB2020,081,4,Queens,40551003000,365,187,178,2.5
2020,CB2020,081,4,Queens,40551003001,344,159,185,2.5
2020,CB2020,081,4,Queens,40551003002,331,172,159,2.34
2020,CB2020,081,4,Queens,40551004000,512,255,257,3.13
2020,CB2020,081,4,Queens,40551004001,428,211,217,3.14
2020,CB2020,081,4,Queens,40551004002,484,235,249,4.51
2020,CB2020,081,4,Queens,40552001000,0,0,0,2.73
2020,CB2020,081,4,Queens,40552001001,129,40,89,11.46
2020,CB2020,081,4,Queens,40552001002,73,50,23,2.65
2020,CB2020,081,4,Queens,40552001003,100,47,53,4.66
2020,CB2020,081,4,Queens,40552001004,69,32,37,1.91
2020,CB2020,081,4,Queens,40552001005,0,0,0,0.84
2020,CB2020,081,4,Queens,40552001006,0,0,0,0.57
2020,CB2020,081,4,Queens,40552001007,117,55,62,16.07
2020,CB2020,081,4,Queens,40552001008,0,0,0,0.37
2020,CB2020,081,4,Queens,40552001009,0,0,0,1.61
2020,CB2020,081,4,Queens,40552001010,0,0,0,2.5
2020,CB2020,081,4,Queens,40552001011,0,0,0,0.92
2020,CB2020,081,4,Queens,40552001012,479,215,264,5.33
2020,CB2020,081,4,Queens,40552001013,274,128,146,5.31
2020,CB2020,081,4,Queens,40552001014,141,56,85,2.85
2020,CB2020,081,4,Queens,40552001015,128,92,36,2.64
2020,CB2020,081,4,Queens,40552001016,113,53,60,2.6
2020,CB2020,081,4,Queens,40552001017,120,43,77,2.02
2020,CB2020,081,4,Queens,40552001018,172,79,93,1.91
2020,CB2020,081,4,Queens,40552001019,0,0,0,0.81
2020,CB2020,081,4,Queens,40552001020,0,0,0,0.44
2020,CB2020,081,4,Queens,40552001021,0,0,0,0.38
2020,CB2020,081,4,Queens,40552002000,0,0,0,2.98
2020,CB2020,081,4,Queens,40552002001,66,38,28,1.89
2020,CB2020,081,4,Queens,40552002002,73,45,28,1.93
2020,CB2020,081,4,Queens,40552002003,69,46,23,2.01
2020,CB2020,081,4,Queens,40552002004,34,18,16,2.25
2020,CB2020,081,4,Queens,40552002005,81,31,50,2.42
2020,CB2020,081,4,Queens,40552002006,140,71,69,2.56
2020,CB2020,081,4,Queens,40552002007,186,86,100,2.87
2020,CB2020,081,4,Queens,40552002008,119,52,67,3.02
2020,CB2020,081,4,Queens,40552002009,183,92,91,3.49
2020,CB2020,081,4,Queens,40552002010,173,73,100,3.68
2020,CB2020,081,4,Queens,40552002011,135,59,76,3.48
2020,CB2020,081,4,Queens,40553001000,39,20,19,0.62
2020,CB2020,081,4,Queens,40553001001,114,61,53,2.96
2020,CB2020,081,4,Queens,40553001002,99,60,39,2.79
2020,CB2020,081,4,Queens,40553001003,453,234,219,5.52
2020,CB2020,081,4,Queens,40553001004,292,139,153,3.23
2020,CB2020,081,4,Queens,40553001005,211,89,122,5.53
2020,CB2020,081,4,Queens,40553002000,729,360,369,5.76
2020,CB2020,081,4,Queens,40553002001,919,480,439,4.07
2020,CB2020,081,4,Queens,40553002002,0,0,0,3.38
2020,CB2020,081,4,Queens,40554001000,121,32,89,1.05
2020,CB2020,081,4,Queens,40554001001,87,35,52,2.02
2020,CB2020,081,4,Queens,40554001002,144,87,57,5.22
2020,CB2020,081,4,Queens,40554001003,271,142,129,6.11
2020,CB2020,081,4,Queens,40554001004,344,156,188,6.24
2020,CB2020,081,4,Queens,40554001005,310,142,168,6.2
2020,CB2020,081,4,Queens,40554002000,137,71,66,2.91
2020,CB2020,081,4,Queens,40554002001,251,140,111,2.9
2020,CB2020,081,4,Queens,40554002002,153,79,74,3.88
2020,CB2020,081,4,Queens,40554002003,99,46,53,3.8
2020,CB2020,081,4,Queens,40554002004,110,45,65,3.84
2020,CB2020,081,4,Queens,40554002005,149,63,86,3.83
2020,CB2020,081,4,Queens,40554002006,142,78,64,3.11
2020,CB2020,081,4,Queens,40554002007,169,82,87,3.28
2020,CB2020,081,4,Queens,40555001000,220,110,110,2.99
2020,CB2020,081,4,Queens,40555001001,0,0,0,2.99
2020,CB2020,081,4,Queens,40555001002,277,141,136,2.99
2020,CB2020,081,4,Queens,40555001003,367,182,185,2.99
2020,CB2020,081,4,Queens,40555002000,61,29,32,5.43
2020,CB2020,081,4,Queens,40555002001,189,90,99,5.44
2020,CB2020,081,4,Queens,40555002002,282,140,142,5.43
2020,CB2020,081,4,Queens,40555002003,478,249,229,5.38
2020,CB2020,081,4,Queens,40555002004,37,24,13,1.89
2020,CB2020,081,4,Queens,40555002005,24,14,10,2.45
2020,CB2020,081,4,Queens,40556001000,218,102,116,6.21
2020,CB2020,081,4,Queens,40556001001,244,95,149,6.21
2020,CB2020,081,4,Queens,40556001002,291,141,150,6.43
2020,CB2020,081,4,Queens,40556001003,283,130,153,6.37
2020,CB2020,081,4,Queens,40556001004,258,152,106,6.02
2020,CB2020,081,4,Queens,40556001005,263,132,131,5.95
2020,CB2020,081,4,Queens,40556002000,113,51,62,3.11
2020,CB2020,081,4,Queens,40556002001,91,59,32,3.1
2020,CB2020,081,4,Queens,40556002002,116,61,55,3.23
2020,CB2020,081,4,Queens,40556002003,132,49,83,3.24
2020,CB2020,081,4,Queens,40556002004,119,59,60,3.1
2020,CB2020,081,4,Queens,40556002005,114,68,46,3.11
2020,CB2020,081,4,Queens,40557001000,133,70,63,3
2020,CB2020,081,4,Queens,40557001001,155,62,93,1.66
2020,CB2020,081,4,Queens,40557001002,471,270,201,3.49
2020,CB2020,081,4,Queens,40557001003,448,215,233,3.57
2020,CB2020,081,4,Queens,40557001004,366,177,189,3.05
2020,CB2020,081,4,Queens,40557002000,34,19,15,0.19
2020,CB2020,081,4,Queens,40557002001,50,6,44,4.34
2020,CB2020,081,4,Queens,40557002002,40,27,13,4.51
2020,CB2020,081,4,Queens,40557002003,308,145,163,4.49
2020,CB2020,081,4,Queens,40557002004,187,106,81,3.87
2020,CB2020,081,4,Queens,40557002005,52,33,19,2.7
2020,CB2020,081,4,Queens,40557002006,108,59,49,7.02
2020,CB2020,081,4,Queens,40557002007,0,0,0,1.55
2020,CB2020,081,4,Queens,40557002008,161,76,85,3.51
2020,CB2020,081,4,Queens,40557002009,311,155,156,3.28
2020,CB2020,081,4,Queens,40557003000,47,26,21,0.53
2020,CB2020,081,4,Queens,40557003001,418,181,237,3.47
2020,CB2020,081,4,Queens,40557003002,485,220,265,3.03
2020,CB2020,081,4,Queens,40557003003,192,124,68,1.75
2020,CB2020,081,4,Queens,40558001000,121,48,73,3.11
2020,CB2020,081,4,Queens,40558001001,105,59,46,3.1
2020,CB2020,081,4,Queens,40558001002,138,72,66,3.23
2020,CB2020,081,4,Queens,40558001003,94,58,36,3.23
2020,CB2020,081,4,Queens,40558001004,91,37,54,3.1
2020,CB2020,081,4,Queens,40558001005,118,61,57,3.09
2020,CB2020,081,4,Queens,40558002000,161,82,79,5.4
2020,CB2020,081,4,Queens,40558002001,170,101,69,4.94
2020,CB2020,081,4,Queens,40558002002,165,85,80,5.01
2020,CB2020,081,4,Queens,40558002003,81,54,27,2.92
2020,CB2020,081,4,Queens,40558002004,130,49,81,2.8
2020,CB2020,081,4,Queens,40558002005,166,71,95,2.84
2020,CB2020,081,4,Queens,40558002006,39,21,18,1.25
2020,CB2020,081,4,Queens,40558002007,53,16,37,1.58
2020,CB2020,081,4,Queens,40558002008,78,35,43,1.93
2020,CB2020,081,4,Queens,40559001000,552,268,284,5.36
2020,CB2020,081,4,Queens,40559001001,152,72,80,5.16
2020,CB2020,081,4,Queens,40559001002,148,85,63,5.1
2020,CB2020,081,4,Queens,40559001003,0,0,0,2.81
2020,CB2020,081,4,Queens,40559001004,0,0,0,2.06
2020,CB2020,081,4,Queens,40559001005,88,53,35,2.14
2020,CB2020,081,4,Queens,40559001006,39,23,16,4.15
2020,CB2020,081,4,Queens,40559001007,35,18,17,4.12
2020,CB2020,081,4,Queens,40559001008,34,10,24,2.51
2020,CB2020,081,4,Queens,40559001009,0,0,0,1.91
2020,CB2020,081,4,Queens,40559001010,0,0,0,2.18
2020,CB2020,081,4,Queens,40559001011,130,53,77,1.69
2020,CB2020,081,4,Queens,40560001000,50,24,26,1.64
2020,CB2020,081,4,Queens,40560001001,139,88,51,2.82
2020,CB2020,081,4,Queens,40560001002,14,5,9,3.14
2020,CB2020,081,4,Queens,40560001003,51,33,18,2.01
2020,CB2020,081,4,Queens,40560001004,36,17,19,0.81
2020,CB2020,081,4,Queens,40560001005,149,79,70,3.3
2020,CB2020,081,4,Queens,40560001006,39,16,23,1.35
2020,CB2020,081,4,Queens,40560001007,138,65,73,3.13
2020,CB2020,081,4,Queens,40560001008,67,29,38,3.39
2020,CB2020,081,4,Queens,40560001009,64,22,42,2.24
2020,CB2020,081,4,Queens,40560001010,116,56,60,2.39
2020,CB2020,081,4,Queens,40560001011,21,11,10,0.51
2020,CB2020,081,4,Queens,40560002000,74,32,42,2.4
2020,CB2020,081,4,Queens,40560002001,85,48,37,2.44
2020,CB2020,081,4,Queens,40560002002,112,72,40,3.11
2020,CB2020,081,4,Queens,40560002003,237,105,132,5.69
2020,CB2020,081,4,Queens,40560002004,96,33,63,2.75
2020,CB2020,081,4,Queens,40560002005,87,49,38,2.67
2020,CB2020,081,4,Queens,40560002006,142,64,78,3.04
2020,CB2020,081,4,Queens,40560002007,26,9,17,3.51
2020,CB2020,081,4,Queens,40560002008,0,0,0,0.4
2020,CB2020,081,4,Queens,40561001000,20,10,10,261.86
2020,CB2020,081,4,Queens,40561001001,0,0,0,1.89
2020,CB2020,081,4,Queens,40561001002,0,0,0,86.77
2020,CB2020,081,4,Queens,40561001003,0,0,0,173.46
2020,CB2020,081,4,Queens,40561001004,0,0,0,5.87
2020,CB2020,081,4,Queens,40561001005,0,0,0,1.68
2020,CB2020,081,4,Queens,40561001006,0,0,0,3.23
2020,CB2020,081,4,Queens,40561001007,0,0,0,52.96
2020,CB2020,081,4,Queens,40561001008,0,0,0,0.62
2020,CB2020,081,4,Queens,40561001009,0,0,0,70.01
2020,CB2020,081,4,Queens,40561001010,0,0,0,37.64
2020,CB2020,081,4,Queens,40561001011,0,0,0,1.4
2020,CB2020,081,4,Queens,40562001000,94,48,46,2.74
2020,CB2020,081,4,Queens,40562001001,150,56,94,3.13
2020,CB2020,081,4,Queens,40562001002,175,76,99,3.37
2020,CB2020,081,4,Queens,40562001003,128,55,73,3.26
2020,CB2020,081,4,Queens,40562001004,129,87,42,3.12
2020,CB2020,081,4,Queens,40562001005,70,28,42,2.75
2020,CB2020,081,4,Queens,40562001006,108,54,54,2.75
2020,CB2020,081,4,Queens,40562001007,91,40,51,3.29
2020,CB2020,081,4,Queens,40562001008,84,38,46,3.13
2020,CB2020,081,4,Queens,40562001009,92,30,62,3.13
2020,CB2020,081,4,Queens,40562001010,110,64,46,2.74
2020,CB2020,081,4,Queens,40562001011,99,66,33,2.75
2020,CB2020,081,4,Queens,40562001012,130,53,77,3.52
2020,CB2020,081,4,Queens,40564001000,72,26,46,1.99
2020,CB2020,081,4,Queens,40564001001,95,43,52,4.17
2020,CB2020,081,4,Queens,40564001002,281,147,134,8.15
2020,CB2020,081,4,Queens,40564001003,82,46,36,3.13
2020,CB2020,081,4,Queens,40564001004,127,67,60,3.91
2020,CB2020,081,4,Queens,40564001005,74,52,22,1.85
2020,CB2020,081,4,Queens,40564001006,77,30,47,1.73
2020,CB2020,081,4,Queens,40564001007,140,65,75,3.88
2020,CB2020,081,4,Queens,40564001008,168,74,94,3.93
2020,CB2020,081,4,Queens,40564001009,87,50,37,2.37
2020,CB2020,081,4,Queens,40564001010,55,20,35,2.19
2020,CB2020,081,4,Queens,40564001011,201,84,117,5.95
2020,CB2020,081,4,Queens,40564001012,100,52,48,2.83
2020,CB2020,081,4,Queens,40564001013,0,0,0,0.18
2020,CB2020,081,4,Queens,40565001000,198,91,107,4.42
2020,CB2020,081,4,Queens,40565001001,34,9,25,1.33
2020,CB2020,081,4,Queens,40565001002,306,174,132,3.97
2020,CB2020,081,4,Queens,40565001003,168,90,78,3.54
2020,CB2020,081,4,Queens,40565001004,170,80,90,3.37
2020,CB2020,081,4,Queens,40565001005,384,167,217,6.33
2020,CB2020,081,4,Queens,40565001006,108,64,44,1.66
2020,CB2020,081,4,Queens,40565001007,156,85,71,2.3
2020,CB2020,081,4,Queens,40565001008,115,64,51,1.45
2020,CB2020,081,4,Queens,40565001009,42,8,34,0.74
2020,CB2020,081,4,Queens,40566001000,101,42,59,3.08
2020,CB2020,081,4,Queens,40566001001,184,100,84,4.58
2020,CB2020,081,4,Queens,40566001002,127,58,69,4.19
2020,CB2020,081,4,Queens,40566001003,306,148,158,7.55
2020,CB2020,081,4,Queens,40566001004,94,31,63,3.35
2020,CB2020,081,4,Queens,40566002000,26,17,9,1.03
2020,CB2020,081,4,Queens,40566002001,125,47,78,4.18
2020,CB2020,081,4,Queens,40566002002,30,11,19,1.6
2020,CB2020,081,4,Queens,40566002003,37,12,25,1.62
2020,CB2020,081,4,Queens,40566002004,156,67,89,4.63
2020,CB2020,081,4,Queens,40566002005,116,54,62,4.19
2020,CB2020,081,4,Queens,40566002006,153,78,75,3.88
2020,CB2020,081,4,Queens,40566002007,126,86,40,4.1
2020,CB2020,081,4,Queens,40567001000,84,56,28,2.31
2020,CB2020,081,4,Queens,40567001001,71,19,52,1.8
2020,CB2020,081,4,Queens,40567001002,117,52,65,1.8
2020,CB2020,081,4,Queens,40567001003,133,77,56,3.35
2020,CB2020,081,4,Queens,40567001004,148,66,82,3.32
2020,CB2020,081,4,Queens,40567001005,187,78,109,4.38
2020,CB2020,081,4,Queens,40567002000,628,305,323,10.97
2020,CB2020,081,4,Queens,40567002001,197,86,111,4.64
2020,CB2020,081,4,Queens,40567002002,142,49,93,3.34
2020,CB2020,081,4,Queens,40567002003,128,64,64,1.79
2020,CB2020,081,4,Queens,40567002004,133,82,51,1.79
2020,CB2020,081,4,Queens,40567002005,128,68,60,3.33
2020,CB2020,081,4,Queens,40567003000,180,81,99,4.43
2020,CB2020,081,4,Queens,40567003001,101,52,49,1.35
2020,CB2020,081,4,Queens,40567003002,234,116,118,3.39
2020,CB2020,081,4,Queens,40567003003,173,93,80,3.16
2020,CB2020,081,4,Queens,40567003004,264,132,132,2.69
2020,CB2020,081,4,Queens,40567003005,229,120,109,2.69
2020,CB2020,081,4,Queens,40567004000,427,225,202,4.38
2020,CB2020,081,4,Queens,40567004001,250,135,115,3.16
2020,CB2020,081,4,Queens,40567004002,311,151,160,3.28
2020,CB2020,081,4,Queens,40567004003,264,130,134,2.9
2020,CB2020,081,4,Queens,40567004004,222,84,138,3.18
2020,CB2020,081,4,Queens,40568001000,290,112,178,3.24
2020,CB2020,081,4,Queens,40568001001,44,35,9,3.44
2020,CB2020,081,4,Queens,40568001002,96,61,35,2.76
2020,CB2020,081,4,Queens,40568001003,51,20,31,5.83
2020,CB2020,081,4,Queens,40568001004,378,232,146,9.85
2020,CB2020,081,4,Queens,40568001005,184,102,82,8.59
2020,CB2020,081,4,Queens,40568001006,31,22,9,1.11
2020,CB2020,081,4,Queens,40568001007,0,0,0,12.86
2020,CB2020,081,4,Queens,40568001008,0,0,0,3.46
2020,CB2020,081,4,Queens,40568001009,151,59,92,3.38
2020,CB2020,081,4,Queens,40568001010,108,83,25,2.41
2020,CB2020,081,4,Queens,40568001011,146,56,90,2.35
2020,CB2020,081,4,Queens,40568001012,105,54,51,3.39
2020,CB2020,081,4,Queens,40568001013,115,50,65,3.99
2020,CB2020,081,4,Queens,40568001014,160,48,112,3.4
2020,CB2020,081,4,Queens,40568001015,107,56,51,2.8
2020,CB2020,081,4,Queens,40568002000,0,0,0,2
2020,CB2020,081,4,Queens,40568002001,17,10,7,2.57
2020,CB2020,081,4,Queens,40568002002,70,34,36,2.09
2020,CB2020,081,4,Queens,40568002003,27,16,11,1.5
2020,CB2020,081,4,Queens,40568002004,60,43,17,1.93
2020,CB2020,081,4,Queens,40568002005,89,51,38,5.25
2020,CB2020,081,4,Queens,40568002006,58,25,33,1.93
2020,CB2020,081,4,Queens,40568002007,74,38,36,2.57
2020,CB2020,081,4,Queens,40568002008,74,37,37,2.58
2020,CB2020,081,4,Queens,40568002009,166,71,95,3.17
2020,CB2020,081,4,Queens,40568002010,105,36,69,3.06
2020,CB2020,081,4,Queens,40568002011,54,25,29,1.94
2020,CB2020,081,4,Queens,40568002012,51,19,32,1.34
2020,CB2020,081,4,Queens,40568002013,30,18,12,1.56
2020,CB2020,081,4,Queens,40568002014,70,35,35,3.17
2020,CB2020,081,4,Queens,40568002015,0,0,0,5.29
2020,CB2020,081,4,Queens,40568002016,0,0,0,14.14
2020,CB2020,081,4,Queens,40568003000,80,36,44,2.86
2020,CB2020,081,4,Queens,40568003001,81,56,25,2.79
2020,CB2020,081,4,Queens,40568003002,93,43,50,2.7
2020,CB2020,081,4,Queens,40568003003,105,38,67,1.81
2020,CB2020,081,4,Queens,40568003004,77,34,43,2.96
2020,CB2020,081,4,Queens,40568003005,88,31,57,3.01
2020,CB2020,081,4,Queens,40568003006,128,62,66,3.04
2020,CB2020,081,4,Queens,40568003007,114,68,46,2.99
2020,CB2020,081,4,Queens,40568003008,58,39,19,1.86
2020,CB2020,081,4,Queens,40568004000,9,7,2,5.27
2020,CB2020,081,4,Queens,40568004001,0,0,0,7.18
2020,CB2020,081,4,Queens,40568004002,96,62,34,10.65
2020,CB2020,081,4,Queens,40568004003,12,5,7,0.45
2020,CB2020,081,4,Queens,40568004004,25,14,11,4.09
2020,CB2020,081,4,Queens,40568004005,126,52,74,3.47
2020,CB2020,081,4,Queens,40568004006,72,49,23,3.49
2020,CB2020,081,4,Queens,40568004007,22,6,16,2.89
2020,CB2020,081,4,Queens,40568004008,32,26,6,1.66
2020,CB2020,081,4,Queens,40568004009,269,147,122,4.29
2020,CB2020,081,4,Queens,40568004010,0,0,0,1.39
2020,CB2020,081,4,Queens,40568004011,16,5,11,1.38
2020,CB2020,081,4,Queens,40568004012,189,79,110,3.66
2020,CB2020,081,4,Queens,40568004013,209,90,119,3.66
2020,CB2020,081,4,Queens,40568004014,50,15,35,3.8
2020,CB2020,081,4,Queens,40577001000,290,130,160,3.43
2020,CB2020,081,4,Queens,40577001001,409,201,208,3.13
2020,CB2020,081,4,Queens,40577001002,354,173,181,2.86
2020,CB2020,081,4,Queens,40577001003,0,0,0,3.67
2020,CB2020,081,4,Queens,40577002000,237,136,101,3.62
2020,CB2020,081,4,Queens,40577002001,115,63,52,2
2020,CB2020,081,4,Queens,40577002002,0,0,0,0.3
2020,CB2020,081,4,Queens,40577002003,87,22,65,1.4
2020,CB2020,081,4,Queens,40577002004,104,50,54,1.48
2020,CB2020,081,4,Queens,40577002005,304,157,147,3.02
2020,CB2020,081,4,Queens,40577002006,145,60,85,2.28
2020,CB2020,081,4,Queens,40577002007,506,239,267,4.34
2020,CB2020,081,4,Queens,40577003000,461,208,253,4.68
2020,CB2020,081,4,Queens,40577003001,447,243,204,4.9
2020,CB2020,081,4,Queens,40577003002,249,106,143,3.03
2020,CB2020,081,4,Queens,40577003003,315,146,169,1.99
2020,CB2020,081,4,Queens,40579001000,143,60,83,2.28
2020,CB2020,081,4,Queens,40579001001,427,215,212,3.22
2020,CB2020,081,4,Queens,40579001002,556,270,286,3.23
2020,CB2020,081,4,Queens,40579002000,83,53,30,1.55
2020,CB2020,081,4,Queens,40579002001,326,146,180,3.24
2020,CB2020,081,4,Queens,40579002002,208,102,106,2.3
2020,CB2020,081,4,Queens,40579002003,0,0,0,1.08
2020,CB2020,081,4,Queens,40580001000,0,0,0,5.84
2020,CB2020,081,4,Queens,40580001001,0,0,0,2.4
2020,CB2020,081,4,Queens,40580001002,86,36,50,12.24
2020,CB2020,081,4,Queens,40580001003,69,32,37,2.11
2020,CB2020,081,4,Queens,40580001004,80,43,37,2.64
2020,CB2020,081,4,Queens,40580001005,111,43,68,2.96
2020,CB2020,081,4,Queens,40580001006,134,58,76,2.96
2020,CB2020,081,4,Queens,40580001007,110,62,48,2.95
2020,CB2020,081,4,Queens,40580001008,108,41,67,2.95
2020,CB2020,081,4,Queens,40580001009,99,46,53,2.95
2020,CB2020,081,4,Queens,40580002000,0,0,0,2.38
2020,CB2020,081,4,Queens,40580002001,0,0,0,1.43
2020,CB2020,081,4,Queens,40580002002,0,0,0,2.84
2020,CB2020,081,4,Queens,40580002003,109,54,55,3.22
2020,CB2020,081,4,Queens,40580002004,120,77,43,3.93
2020,CB2020,081,4,Queens,40580002005,105,46,59,3.16
2020,CB2020,081,4,Queens,40580002006,92,51,41,2.55
2020,CB2020,081,4,Queens,40580002007,127,51,76,4.07
2020,CB2020,081,4,Queens,40580002008,102,39,63,3.28
2020,CB2020,081,4,Queens,40580002009,77,38,39,3.28
2020,CB2020,081,4,Queens,40580002010,102,34,68,4.17
2020,CB2020,081,4,Queens,40580002011,122,50,72,4.44
2020,CB2020,081,4,Queens,40580002012,185,86,99,3.34
2020,CB2020,081,4,Queens,40580003000,75,52,23,3.02
2020,CB2020,081,4,Queens,40580003001,109,53,56,2.98
2020,CB2020,081,4,Queens,40580003002,224,105,119,6.34
2020,CB2020,081,4,Queens,40580003003,174,86,88,4.6
2020,CB2020,081,4,Queens,40580003004,82,42,40,3.02
2020,CB2020,081,4,Queens,40580003005,93,31,62,2.98
2020,CB2020,081,4,Queens,40580003006,115,50,65,2.98
2020,CB2020,081,4,Queens,40580003007,92,40,52,3.03
2020,CB2020,081,4,Queens,40580004000,61,29,32,3.02
2020,CB2020,081,4,Queens,40580004001,65,31,34,3.01
2020,CB2020,081,4,Queens,40580004002,96,61,35,2.69
2020,CB2020,081,4,Queens,40580004003,87,55,32,3.14
2020,CB2020,081,4,Queens,40580004004,80,37,43,3.19
2020,CB2020,081,4,Queens,40580004005,102,26,76,3.3
2020,CB2020,081,4,Queens,40580004006,118,43,75,3.29
2020,CB2020,081,4,Queens,40580004007,78,33,45,3.34
2020,CB2020,081,4,Queens,40581001000,183,90,93,2.86
2020,CB2020,081,4,Queens,40581001001,253,125,128,3.06
2020,CB2020,081,4,Queens,40581001002,202,115,87,3.05
2020,CB2020,081,4,Queens,40581001003,232,100,132,3.55
2020,CB2020,081,4,Queens,40581001004,146,80,66,2.18
2020,CB2020,081,4,Queens,40581001005,49,21,28,0.6
2020,CB2020,081,4,Queens,40581002000,327,163,164,3.05
2020,CB2020,081,4,Queens,40581002001,363,191,172,3.14
2020,CB2020,081,4,Queens,40581002002,248,102,146,2.79
2020,CB2020,081,4,Queens,40581002003,0,0,0,0.49
2020,CB2020,081,4,Queens,40581002004,440,203,237,4.43
2020,CB2020,081,4,Queens,40581002005,78,34,44,1.72
2020,CB2020,081,4,Queens,40581002006,264,128,136,4.57
2020,CB2020,081,4,Queens,40582001000,166,40,126,11.35
2020,CB2020,081,4,Queens,40582001001,109,24,85,2.73
2020,CB2020,081,4,Queens,40582001002,177,98,79,5.23
2020,CB2020,081,4,Queens,40582001003,114,78,36,3.92
2020,CB2020,081,4,Queens,40582001004,59,30,29,1.96
2020,CB2020,081,4,Queens,40582001005,42,27,15,1.29
2020,CB2020,081,4,Queens,40582001006,108,39,69,2.82
2020,CB2020,081,4,Queens,40582001007,70,33,37,1.74
2020,CB2020,081,4,Queens,40582001008,111,50,61,3.61
2020,CB2020,081,4,Queens,40582001009,145,81,64,3.4
2020,CB2020,081,4,Queens,40582001010,173,83,90,3.42
2020,CB2020,081,4,Queens,40582002000,247,109,138,4.78
2020,CB2020,081,4,Queens,40582002001,284,126,158,5.94
2020,CB2020,081,4,Queens,40582002002,69,27,42,2.3
2020,CB2020,081,4,Queens,40582002003,117,63,54,2.97
2020,CB2020,081,4,Queens,40582002004,196,92,104,5.51
2020,CB2020,081,4,Queens,40582002005,63,26,37,2.01
2020,CB2020,081,4,Queens,40582002006,776,376,400,27.01
2020,CB2020,081,4,Queens,40582002007,153,66,87,6.21
2020,CB2020,081,4,Queens,40582002008,85,46,39,3.3
2020,CB2020,081,4,Queens,40582002009,78,47,31,3.01
2020,CB2020,081,4,Queens,40582003000,99,53,46,3.29
2020,CB2020,081,4,Queens,40582003001,83,18,65,3.29
2020,CB2020,081,4,Queens,40582003002,81,31,50,3.29
2020,CB2020,081,4,Queens,40582003003,116,49,67,3.4
2020,CB2020,081,4,Queens,40582003004,145,48,97,3.79
2020,CB2020,081,4,Queens,40582003005,123,57,66,3.36
2020,CB2020,081,4,Queens,40582003006,95,66,29,3.34
2020,CB2020,081,4,Queens,40582003007,96,41,55,3.35
2020,CB2020,081,4,Queens,40582003008,118,51,67,3.36
2020,CB2020,081,4,Queens,40582003009,211,96,115,4.31
2020,CB2020,081,4,Queens,40583001000,275,133,142,3.34
2020,CB2020,081,4,Queens,40583001001,317,155,162,3.23
2020,CB2020,081,4,Queens,40583001002,357,165,192,3.08
2020,CB2020,081,4,Queens,40583001003,497,236,261,4.21
2020,CB2020,081,4,Queens,40583002000,280,132,148,3.33
2020,CB2020,081,4,Queens,40583002001,266,136,130,3.32
2020,CB2020,081,4,Queens,40583002002,294,127,167,3.31
2020,CB2020,081,4,Queens,40583002003,306,188,118,2.82
2020,CB2020,081,4,Queens,40583003000,261,115,146,2.63
2020,CB2020,081,4,Queens,40583003001,228,134,94,2.72
2020,CB2020,081,4,Queens,40583003002,229,99,130,2.8
2020,CB2020,081,4,Queens,40583003003,52,23,29,0.57
2020,CB2020,081,4,Queens,40585001000,386,219,167,4.04
2020,CB2020,081,4,Queens,40585001001,356,156,200,3.08
2020,CB2020,081,4,Queens,40585001002,327,167,160,3.06
2020,CB2020,081,4,Queens,40585001003,135,67,68,3.15
2020,CB2020,081,4,Queens,40585002000,256,136,120,2.27
2020,CB2020,081,4,Queens,40585002001,165,79,86,1.88
2020,CB2020,081,4,Queens,40585002002,249,97,152,2.99
2020,CB2020,081,4,Queens,40585002003,293,144,149,2.93
2020,CB2020,081,4,Queens,40585002004,299,154,145,3
2020,CB2020,081,4,Queens,40585003000,202,109,93,2.7
2020,CB2020,081,4,Queens,40585003001,308,160,148,3.15
2020,CB2020,081,4,Queens,40585003002,296,131,165,2.46
2020,CB2020,081,4,Queens,40585003003,241,112,129,2.22
2020,CB2020,081,4,Queens,40585003004,288,153,135,2.32
2020,CB2020,081,4,Queens,40585003005,101,37,64,0.94
2020,CB2020,081,4,Queens,40585003006,226,111,115,2.09
2020,CB2020,081,4,Queens,40587001000,403,202,201,5.23
2020,CB2020,081,4,Queens,40587001001,397,200,197,5.33
2020,CB2020,081,4,Queens,40587001002,285,141,144,3.78
2020,CB2020,081,4,Queens,40587001003,356,171,185,3.98
2020,CB2020,081,4,Queens,40587002000,382,178,204,5.33
2020,CB2020,081,4,Queens,40587002001,362,179,183,3.79
2020,CB2020,081,4,Queens,40587003000,850,426,424,4.64
2020,CB2020,081,4,Queens,40587003001,301,127,174,3.63
2020,CB2020,081,4,Queens,40589001000,286,121,165,3.29
2020,CB2020,081,4,Queens,40589001001,346,167,179,3.29
2020,CB2020,081,4,Queens,40589001002,524,257,267,2.98
2020,CB2020,081,4,Queens,40589001003,170,89,81,1.43
2020,CB2020,081,4,Queens,40589001004,215,112,103,1.54
2020,CB2020,081,4,Queens,40589002000,92,38,54,0.46
2020,CB2020,081,4,Queens,40589002001,525,262,263,3.34
2020,CB2020,081,4,Queens,40589002002,366,195,171,3.29
2020,CB2020,081,4,Queens,40589002003,521,263,258,2.97
2020,CB2020,081,4,Queens,40589002004,0,0,0,2.19
2020,CB2020,081,4,Queens,40589002005,47,20,27,1.28
2020,CB2020,081,4,Queens,40589003000,377,199,178,2.96
2020,CB2020,081,4,Queens,40589003001,253,109,144,2.96
2020,CB2020,081,4,Queens,40589003002,353,163,190,2.97
2020,CB2020,081,4,Queens,40589003003,3,2,1,2.95
2020,CB2020,081,4,Queens,40589003004,230,122,108,2.95
2020,CB2020,081,4,Queens,40590001000,33,23,10,1.63
2020,CB2020,081,4,Queens,40590001001,73,42,31,1.62
2020,CB2020,081,4,Queens,40590001002,114,44,70,2.66
2020,CB2020,081,4,Queens,40590001003,88,42,46,1.59
2020,CB2020,081,4,Queens,40590001004,44,14,30,1.58
2020,CB2020,081,4,Queens,40590001005,85,41,44,3.36
2020,CB2020,081,4,Queens,40590001006,91,52,39,3.35
2020,CB2020,081,4,Queens,40590001007,174,55,119,4.86
2020,CB2020,081,4,Queens,40590001008,98,47,51,1.78
2020,CB2020,081,4,Queens,40590001009,100,59,41,3.5
2020,CB2020,081,4,Queens,40590001010,100,51,49,3.97
2020,CB2020,081,4,Queens,40590001011,38,10,28,1.82
2020,CB2020,081,4,Queens,40590001012,23,17,6,2.31
2020,CB2020,081,4,Queens,40590001013,74,18,56,2.33
2020,CB2020,081,4,Queens,40590001014,47,24,23,2.82
2020,CB2020,081,4,Queens,40591001000,360,190,170,3.28
2020,CB2020,081,4,Queens,40591001001,302,162,140,3.29
2020,CB2020,081,4,Queens,40591001002,366,180,186,3.28
2020,CB2020,081,4,Queens,40591001003,254,118,136,3.29
2020,CB2020,081,4,Queens,40591002000,293,133,160,3.29
2020,CB2020,081,4,Queens,40591002001,352,177,175,2.97
2020,CB2020,081,4,Queens,40591002002,345,186,159,3.1
2020,CB2020,081,4,Queens,40591002003,313,155,158,3.11
2020,CB2020,081,4,Queens,40591003000,184,105,79,2.98
2020,CB2020,081,4,Queens,40591003001,352,162,190,3.09
2020,CB2020,081,4,Queens,40591003002,391,224,167,3.1
2020,CB2020,081,4,Queens,40591003003,375,160,215,2.99
2020,CB2020,081,4,Queens,40591004000,256,136,120,2.99
2020,CB2020,081,4,Queens,40591004001,406,184,222,3.09
2020,CB2020,081,4,Queens,40591004002,381,181,200,3.1
2020,CB2020,081,4,Queens,40591004003,296,137,159,2.99
2020,CB2020,081,4,Queens,40592001000,0,0,0,0.75
2020,CB2020,081,4,Queens,40592001001,0,0,0,1.17
2020,CB2020,081,4,Queens,40592001002,0,0,0,4.66
2020,CB2020,081,4,Queens,40592001003,0,0,0,1.43
2020,CB2020,081,4,Queens,40592001004,0,0,0,4.65
2020,CB2020,081,4,Queens,40592001005,0,0,0,1.38
2020,CB2020,081,4,Queens,40592001006,105,37,68,4.53
2020,CB2020,081,4,Queens,40592001007,156,59,97,3.35
2020,CB2020,081,4,Queens,40592001008,97,41,56,3.36
2020,CB2020,081,4,Queens,40592001009,43,12,31,1.62
2020,CB2020,081,4,Queens,40592001010,28,6,22,1.82
2020,CB2020,081,4,Queens,40592001011,62,24,38,2.2
2020,CB2020,081,4,Queens,40592001012,49,15,34,2.27
2020,CB2020,081,4,Queens,40592001013,139,73,66,4.79
2020,CB2020,081,4,Queens,40592001014,96,45,51,3.35
2020,CB2020,081,4,Queens,40592001015,80,42,38,3.36
2020,CB2020,081,4,Queens,40592001016,52,34,18,1.61
2020,CB2020,081,4,Queens,40592001017,38,15,23,1.4
2020,CB2020,081,4,Queens,40592001018,89,46,43,3.3
2020,CB2020,081,4,Queens,40592001019,152,73,79,4.89
2020,CB2020,081,4,Queens,40593001000,185,93,92,3.87
2020,CB2020,081,4,Queens,40593001001,47,23,24,5.3
2020,CB2020,081,4,Queens,40593001002,247,138,109,4.45
2020,CB2020,081,4,Queens,40593001003,289,160,129,4.11
2020,CB2020,081,4,Queens,40593001004,166,89,77,2.26
2020,CB2020,081,4,Queens,40593001005,146,53,93,2.41
2020,CB2020,081,4,Queens,40593001006,311,150,161,4.37
2020,CB2020,081,4,Queens,40593002000,449,215,234,6.65
2020,CB2020,081,4,Queens,40593002001,418,208,210,5.02
2020,CB2020,081,4,Queens,40593002002,384,190,194,5.14
2020,CB2020,081,4,Queens,40593002003,243,101,142,3.65
2020,CB2020,081,4,Queens,40593002004,287,162,125,3.78
2020,CB2020,081,4,Queens,40593002005,348,154,194,4.62
2020,CB2020,081,4,Queens,40593002006,240,133,107,3.27
2020,CB2020,081,4,Queens,40593002007,235,123,112,2.01
2020,CB2020,081,4,Queens,40593002008,97,55,42,1.4
2020,CB2020,081,4,Queens,40594001000,158,40,118,5.61
2020,CB2020,081,4,Queens,40594001001,139,75,64,5.07
2020,CB2020,081,4,Queens,40594001002,135,77,58,4.55
2020,CB2020,081,4,Queens,40594001003,137,59,78,4.52
2020,CB2020,081,4,Queens,40594001004,81,37,44,3.35
2020,CB2020,081,4,Queens,40594001005,89,42,47,3.93
2020,CB2020,081,4,Queens,40594001006,74,47,27,3.46
2020,CB2020,081,4,Queens,40594002000,103,49,54,4.06
2020,CB2020,081,4,Queens,40594002001,110,66,44,4.06
2020,CB2020,081,4,Queens,40594002002,120,38,82,4.07
2020,CB2020,081,4,Queens,40594002003,145,64,81,4.06
2020,CB2020,081,4,Queens,40594002004,91,46,45,4.08
2020,CB2020,081,4,Queens,40594002005,124,44,80,4.06
2020,CB2020,081,4,Queens,40595011000,214,124,90,5.37
2020,CB2020,081,4,Queens,40595011001,182,73,109,2.95
2020,CB2020,081,4,Queens,40595011002,183,99,84,2.93
2020,CB2020,081,4,Queens,40595011003,112,49,63,1.72
2020,CB2020,081,4,Queens,40595011004,239,123,116,2.55
2020,CB2020,081,4,Queens,40595011005,116,46,70,1.62
2020,CB2020,081,4,Queens,40595012000,210,96,114,3.58
2020,CB2020,081,4,Queens,40595012001,155,69,86,3.21
2020,CB2020,081,4,Queens,40595012002,0,0,0,7.64
2020,CB2020,081,4,Queens,40595012003,170,80,90,2.56
2020,CB2020,081,4,Queens,40595012004,233,112,121,3.26
2020,CB2020,081,4,Queens,40595012005,277,164,113,3.35
2020,CB2020,081,4,Queens,40595021000,193,129,64,2.99
2020,CB2020,081,4,Queens,40595021001,127,79,48,5.21
2020,CB2020,081,4,Queens,40595021002,0,0,0,6.89
2020,CB2020,081,4,Queens,40595021003,0,0,0,0.74
2020,CB2020,081,4,Queens,40595021004,126,50,76,7.27
2020,CB2020,081,4,Queens,40595021005,225,78,147,6.74
2020,CB2020,081,4,Queens,40595021006,38,17,21,2.06
2020,CB2020,081,4,Queens,40595021007,195,85,110,2.09
2020,CB2020,081,4,Queens,40595021008,102,47,55,1.18
2020,CB2020,081,4,Queens,40595021009,113,45,68,1.2
2020,CB2020,081,4,Queens,40595022000,0,0,0,0.56
2020,CB2020,081,4,Queens,40595022001,0,0,0,0.59
2020,CB2020,081,4,Queens,40595022002,97,46,51,1.97
2020,CB2020,081,4,Queens,40595022003,147,70,77,1.82
2020,CB2020,081,4,Queens,40595022004,259,138,121,2.87
2020,CB2020,081,4,Queens,40595022005,266,131,135,2.85
2020,CB2020,081,4,Queens,40595022006,165,75,90,1.84
2020,CB2020,081,4,Queens,40595022007,102,57,45,1.59
2020,CB2020,081,4,Queens,40595022008,314,134,180,3.66
2020,CB2020,081,4,Queens,40595022009,68,31,37,0.56
2020,CB2020,081,4,Queens,40595022010,58,35,23,0.72
2020,CB2020,081,4,Queens,40595022011,117,71,46,1.72
2020,CB2020,081,4,Queens,40596001000,74,31,43,4.06
2020,CB2020,081,4,Queens,40596001001,65,35,30,4.07
2020,CB2020,081,4,Queens,40596001002,118,55,63,3.95
2020,CB2020,081,4,Queens,40596001003,125,78,47,3.94
2020,CB2020,081,4,Queens,40596001004,158,52,106,3.89
2020,CB2020,081,4,Queens,40596001005,102,41,61,3.88
2020,CB2020,081,4,Queens,40596002000,116,58,58,4.14
2020,CB2020,081,4,Queens,40596002001,100,40,60,4.14
2020,CB2020,081,4,Queens,40596002002,108,39,69,4.03
2020,CB2020,081,4,Queens,40596002003,131,55,76,4.01
2020,CB2020,081,4,Queens,40596002004,126,65,61,3.97
2020,CB2020,081,4,Queens,40596002005,150,64,86,3.98
2020,CB2020,081,4,Queens,40598001000,107,53,54,4.05
2020,CB2020,081,4,Queens,40598001001,119,50,69,4.08
2020,CB2020,081,4,Queens,40598001002,0,0,0,3.93
2020,CB2020,081,4,Queens,40598001003,164,49,115,3.94
2020,CB2020,081,4,Queens,40598001004,108,39,69,3.85
2020,CB2020,081,4,Queens,40598001005,150,79,71,3.83
2020,CB2020,081,4,Queens,40598002000,155,80,75,4.09
2020,CB2020,081,4,Queens,40598002001,300,138,162,5.77
2020,CB2020,081,4,Queens,40598002002,233,98,135,5.49
2020,CB2020,081,4,Queens,40598002003,138,67,71,3.94
2020,CB2020,081,4,Queens,40598002004,159,71,88,3.81
2020,CB2020,081,4,Queens,40598002005,131,72,59,4.24
2020,CB2020,081,4,Queens,40599001000,113,62,51,3.33
2020,CB2020,081,4,Queens,40599001001,139,68,71,3.15
2020,CB2020,081,4,Queens,40599001002,213,123,90,3.29
2020,CB2020,081,4,Queens,40599001003,239,92,147,4.45
2020,CB2020,081,4,Queens,40599002000,129,62,67,2.32
2020,CB2020,081,4,Queens,40599002001,164,78,86,2.16
2020,CB2020,081,4,Queens,40599002002,144,86,58,2.1
2020,CB2020,081,4,Queens,40599002003,189,83,106,3.53
2020,CB2020,081,4,Queens,40599002004,30,18,12,4.04
2020,CB2020,081,4,Queens,40599002005,234,124,110,3.04
2020,CB2020,081,4,Queens,40600001000,79,48,31,3.94
2020,CB2020,081,4,Queens,40600001001,79,34,45,3.94
2020,CB2020,081,4,Queens,40600001002,93,34,59,3.94
2020,CB2020,081,4,Queens,40600001003,127,72,55,3.94
2020,CB2020,081,4,Queens,40600001004,132,40,92,3.94
2020,CB2020,081,4,Queens,40600001005,117,50,67,3.95
2020,CB2020,081,4,Queens,40600001006,123,51,72,3.97
2020,CB2020,081,4,Queens,40600001007,102,48,54,3.99
2020,CB2020,081,4,Queens,40600001008,158,83,75,4
2020,CB2020,081,4,Queens,40600001009,107,31,76,4.01
2020,CB2020,081,4,Queens,40600001010,106,55,51,4.04
2020,CB2020,081,4,Queens,40601001000,450,232,218,5.59
2020,CB2020,081,4,Queens,40601001001,169,60,109,2.78
2020,CB2020,081,4,Queens,40601001002,272,137,135,4.26
2020,CB2020,081,4,Queens,40601001003,291,153,138,2.79
2020,CB2020,081,4,Queens,40601001004,186,91,95,3.14
2020,CB2020,081,4,Queens,40601002000,164,76,88,3.04
2020,CB2020,081,4,Queens,40601002001,287,152,135,4.07
2020,CB2020,081,4,Queens,40601002002,329,164,165,6.27
2020,CB2020,081,4,Queens,40601002003,113,59,54,3.41
2020,CB2020,081,4,Queens,40601002004,119,67,52,2.4
2020,CB2020,081,4,Queens,40601002005,34,9,25,0.41
2020,CB2020,081,4,Queens,40603001000,91,36,55,2.53
2020,CB2020,081,4,Queens,40603001001,203,127,76,3.38
2020,CB2020,081,4,Queens,40603001002,326,189,137,5.04
2020,CB2020,081,4,Queens,40603001003,108,50,58,3.24
2020,CB2020,081,4,Queens,40603001004,0,0,0,3.98
2020,CB2020,081,4,Queens,40603001005,35,13,22,1.85
2020,CB2020,081,4,Queens,40603001006,123,71,52,2.16
2020,CB2020,081,4,Queens,40603001007,195,73,122,3.01
2020,CB2020,081,4,Queens,40603001008,242,101,141,4.05
2020,CB2020,081,4,Queens,40603001009,313,122,191,5.96
2020,CB2020,081,4,Queens,40603001010,13,2,11,3.06
2020,CB2020,081,4,Queens,40603001011,66,33,33,1.61
2020,CB2020,081,4,Queens,40603001012,0,0,0,0.58
2020,CB2020,081,4,Queens,40603001013,139,94,45,4.35
2020,CB2020,081,4,Queens,40606001000,85,46,39,3.44
2020,CB2020,081,4,Queens,40606001001,83,30,53,3.5
2020,CB2020,081,4,Queens,40606001002,65,29,36,3.53
2020,CB2020,081,4,Queens,40606001003,120,59,61,3.52
2020,CB2020,081,4,Queens,40606001004,88,37,51,3.58
2020,CB2020,081,4,Queens,40606001005,97,57,40,3.56
2020,CB2020,081,4,Queens,40606001006,101,35,66,3.64
2020,CB2020,081,4,Queens,40606002000,92,33,59,4.06
2020,CB2020,081,4,Queens,40606002001,78,33,45,4.04
2020,CB2020,081,4,Queens,40606002002,107,36,71,4.06
2020,CB2020,081,4,Queens,40606002003,98,55,43,4.02
2020,CB2020,081,4,Queens,40606002004,107,40,67,4.06
2020,CB2020,081,4,Queens,40606002005,97,35,62,4.05
2020,CB2020,081,4,Queens,40606002006,110,47,63,4.13
2020,CB2020,081,4,Queens,40607011000,3,0,3,75.62
2020,CB2020,081,4,Queens,40607011001,0,0,0,53.36
2020,CB2020,081,4,Queens,40607011002,0,0,0,41.19
2020,CB2020,081,4,Queens,40607011003,0,0,0,6.01
2020,CB2020,081,4,Queens,40608001000,88,40,48,3.67
2020,CB2020,081,4,Queens,40608001001,77,29,48,3.62
2020,CB2020,081,4,Queens,40608001002,129,36,93,3.64
2020,CB2020,081,4,Queens,40608001003,89,18,71,3.67
2020,CB2020,081,4,Queens,40608001004,87,60,27,5.23
2020,CB2020,081,4,Queens,40608001005,173,77,96,5.26
2020,CB2020,081,4,Queens,40608001006,162,77,85,5.49
2020,CB2020,081,4,Queens,40608001007,167,76,91,5.01
2020,CB2020,081,4,Queens,40608001008,122,53,69,4.05
2020,CB2020,081,4,Queens,40608001009,127,75,52,4.05
2020,CB2020,081,4,Queens,40608001010,120,63,57,4.07
2020,CB2020,081,4,Queens,40608001011,134,55,79,4.14
2020,CB2020,081,4,Queens,40608001012,0,0,0,0.34
2020,CB2020,081,4,Queens,40610001000,89,28,61,3.9
2020,CB2020,081,4,Queens,40610001001,76,45,31,3.82
2020,CB2020,081,4,Queens,40610001002,69,30,39,3.98
2020,CB2020,081,4,Queens,40610001003,72,38,34,3.16
2020,CB2020,081,4,Queens,40610001004,101,44,57,2.83
2020,CB2020,081,4,Queens,40610001005,41,14,27,3.99
2020,CB2020,081,4,Queens,40610001006,52,14,38,2.41
2020,CB2020,081,4,Queens,40610001007,43,26,17,2.18
2020,CB2020,081,4,Queens,40610001008,63,19,44,3
2020,CB2020,081,4,Queens,40610001009,70,35,35,8.55
2020,CB2020,081,4,Queens,40610001010,105,42,63,3.83
2020,CB2020,081,4,Queens,40610001011,68,52,16,3.78
2020,CB2020,081,4,Queens,40610001012,117,35,82,4.48
2020,CB2020,081,4,Queens,40610001013,168,68,100,5.01
2020,CB2020,081,4,Queens,40610001014,0,0,0,0.4
2020,CB2020,081,4,Queens,40610001015,70,22,48,3.23
2020,CB2020,081,4,Queens,40612001000,87,43,44,3.81
2020,CB2020,081,4,Queens,40612001001,95,28,67,3.83
2020,CB2020,081,4,Queens,40612001002,106,51,55,3.82
2020,CB2020,081,4,Queens,40612001003,96,57,39,3.84
2020,CB2020,081,4,Queens,40612001004,87,23,64,3.82
2020,CB2020,081,4,Queens,40612001005,98,58,40,3.81
2020,CB2020,081,4,Queens,40612001006,81,30,51,3.82
2020,CB2020,081,4,Queens,40612001007,102,37,65,3.89
2020,CB2020,081,4,Queens,40612002000,117,48,69,3.89
2020,CB2020,081,4,Queens,40612002001,90,34,56,3.89
2020,CB2020,081,4,Queens,40612002002,88,57,31,3.9
2020,CB2020,081,4,Queens,40612002003,94,32,62,3.86
2020,CB2020,081,4,Queens,40612002004,93,40,53,3.88
2020,CB2020,081,4,Queens,40612002005,101,48,53,3.88
2020,CB2020,081,4,Queens,40612002006,70,37,33,3.88
2020,CB2020,081,4,Queens,40612002007,98,48,50,4.16
2020,CB2020,081,4,Queens,40612002008,49,36,13,2.89
2020,CB2020,081,4,Queens,40613011000,0,0,0,13.78
2020,CB2020,081,4,Queens,40613011001,214,122,92,35.04
2020,CB2020,081,4,Queens,40613011002,230,124,106,3.42
2020,CB2020,081,4,Queens,40613011003,415,179,236,10.93
2020,CB2020,081,4,Queens,40613011004,225,118,107,2.64
2020,CB2020,081,4,Queens,40613011005,186,85,101,2.42
2020,CB2020,081,4,Queens,40613012000,0,0,0,25.55
2020,CB2020,081,4,Queens,40613012001,907,457,450,45.38
2020,CB2020,081,4,Queens,40613012002,136,64,72,1.61
2020,CB2020,081,4,Queens,40613012003,85,42,43,1.66
2020,CB2020,081,4,Queens,40613012004,108,61,47,1.53
2020,CB2020,081,4,Queens,40613013000,145,86,59,2.13
2020,CB2020,081,4,Queens,40613013001,45,24,21,0.7
2020,CB2020,081,4,Queens,40613013002,407,179,228,4.14
2020,CB2020,081,4,Queens,40613013003,275,153,122,3.71
2020,CB2020,081,4,Queens,40613013004,125,59,66,2.4
2020,CB2020,081,4,Queens,40613013005,459,228,231,3.86
2020,CB2020,081,4,Queens,40613014000,268,122,146,3.54
2020,CB2020,081,4,Queens,40613014001,551,296,255,3.6
2020,CB2020,081,4,Queens,40613014002,626,315,311,3.43
2020,CB2020,081,4,Queens,40613014003,356,175,181,4.63
2020,CB2020,081,4,Queens,40613021000,0,0,0,120.35
2020,CB2020,081,4,Queens,40614001000,34,18,16,5.77
2020,CB2020,081,4,Queens,40614001001,67,17,50,3
2020,CB2020,081,4,Queens,40614001002,76,38,38,3.81
2020,CB2020,081,4,Queens,40614001003,86,39,47,3.82
2020,CB2020,081,4,Queens,40614001004,92,36,56,3.81
2020,CB2020,081,4,Queens,40614001005,88,49,39,3.82
2020,CB2020,081,4,Queens,40614001006,86,52,34,3.82
2020,CB2020,081,4,Queens,40614001007,98,62,36,3.82
2020,CB2020,081,4,Queens,40614001008,100,39,61,3.89
2020,CB2020,081,4,Queens,40614001009,111,50,61,3.87
2020,CB2020,081,4,Queens,40614001010,135,57,78,3.93
2020,CB2020,081,4,Queens,40614001011,108,35,73,3.88
2020,CB2020,081,4,Queens,40614001012,30,5,25,7.76
2020,CB2020,081,4,Queens,40614001013,94,45,49,3.88
2020,CB2020,081,4,Queens,40614001014,0,0,0,0.88
2020,CB2020,081,4,Queens,40614001015,0,0,0,1.09
2020,CB2020,081,4,Queens,40614001016,0,0,0,2.84
2020,CB2020,081,4,Queens,40616011000,55,33,22,3.17
2020,CB2020,081,4,Queens,40616011001,101,39,62,4.32
2020,CB2020,081,4,Queens,40616011002,98,53,45,4.36
2020,CB2020,081,4,Queens,40616011003,100,60,40,4.44
2020,CB2020,081,4,Queens,40616011004,106,44,62,4.54
2020,CB2020,081,4,Queens,40616011005,108,25,83,4.73
2020,CB2020,081,4,Queens,40616011006,28,11,17,1.73
2020,CB2020,081,4,Queens,40616011007,58,35,23,2.46
2020,CB2020,081,4,Queens,40616011008,49,15,34,1.2
2020,CB2020,081,4,Queens,40616011009,79,34,45,2.54
2020,CB2020,081,4,Queens,40616011010,56,28,28,2.77
2020,CB2020,081,4,Queens,40616012000,17,0,17,1.34
2020,CB2020,081,4,Queens,40616012001,106,50,56,4.22
2020,CB2020,081,4,Queens,40616012002,102,57,45,4.19
2020,CB2020,081,4,Queens,40616012003,110,50,60,4.22
2020,CB2020,081,4,Queens,40616012004,85,40,45,4.27
2020,CB2020,081,4,Queens,40616012005,93,33,60,4.3
2020,CB2020,081,4,Queens,40616012006,80,25,55,2.93
2020,CB2020,081,4,Queens,40616012007,52,18,34,1.73
2020,CB2020,081,4,Queens,40616012008,37,19,18,1.99
2020,CB2020,081,4,Queens,40616012009,45,35,10,3.62
2020,CB2020,081,4,Queens,40616013000,0,0,0,1
2020,CB2020,081,4,Queens,40616013001,19,11,8,1.77
2020,CB2020,081,4,Queens,40616013002,70,22,48,3.19
2020,CB2020,081,4,Queens,40616013003,24,9,15,1.39
2020,CB2020,081,4,Queens,40616013004,122,51,71,4.47
2020,CB2020,081,4,Queens,40616013005,120,56,64,4.56
2020,CB2020,081,4,Queens,40616013006,96,47,49,4.38
2020,CB2020,081,4,Queens,40616013007,79,46,33,4.15
2020,CB2020,081,4,Queens,40616021000,0,0,0,6.49
2020,CB2020,081,4,Queens,40616021001,69,36,33,2.56
2020,CB2020,081,4,Queens,40616021002,57,24,33,2.48
2020,CB2020,081,4,Queens,40616021003,289,150,139,17.47
2020,CB2020,081,4,Queens,40616021004,55,16,39,1.93
2020,CB2020,081,4,Queens,40616021005,59,25,34,1.51
2020,CB2020,081,4,Queens,40616021006,98,42,56,4.54
2020,CB2020,081,4,Queens,40616021007,133,53,80,4.02
2020,CB2020,081,4,Queens,40616021008,0,0,0,2.63
2020,CB2020,081,4,Queens,40616021009,19,10,9,5
2020,CB2020,081,4,Queens,40616022000,11,8,3,7.02
2020,CB2020,081,4,Queens,40616022001,0,0,0,3.96
2020,CB2020,081,4,Queens,40616022002,0,0,0,10.06
2020,CB2020,081,4,Queens,40616022003,0,0,0,6.99
2020,CB2020,081,4,Queens,40616022004,97,49,48,3.47
2020,CB2020,081,4,Queens,40616022005,90,36,54,3.25
2020,CB2020,081,4,Queens,40616022006,33,13,20,1.71
2020,CB2020,081,4,Queens,40616022007,0,0,0,1.5
2020,CB2020,081,4,Queens,40616022008,25,3,22,4.07
2020,CB2020,081,4,Queens,40616022009,120,52,68,3.84
2020,CB2020,081,4,Queens,40616022010,218,102,116,8.79
2020,CB2020,081,4,Queens,40616022011,29,12,17,1.06
2020,CB2020,081,4,Queens,40618001000,413,171,242,11.18
2020,CB2020,081,4,Queens,40618001001,183,66,117,5.65
2020,CB2020,081,4,Queens,40618001002,75,24,51,3.14
2020,CB2020,081,4,Queens,40618001003,68,30,38,2.09
2020,CB2020,081,4,Queens,40618002000,188,92,96,5.18
2020,CB2020,081,4,Queens,40618002001,157,58,99,5.55
2020,CB2020,081,4,Queens,40618002002,150,70,80,5.65
2020,CB2020,081,4,Queens,40618002003,120,59,61,3.2
2020,CB2020,081,4,Queens,40618002004,90,34,56,3.23
2020,CB2020,081,4,Queens,40618002005,77,26,51,2.97
2020,CB2020,081,4,Queens,40618002006,47,9,38,3.05
2020,CB2020,081,4,Queens,40618002007,60,26,34,3.5
2020,CB2020,081,4,Queens,40618002008,108,64,44,5.3
2020,CB2020,081,4,Queens,40619001000,336,155,181,4.8
2020,CB2020,081,4,Queens,40619001001,387,203,184,4.94
2020,CB2020,081,4,Queens,40619001002,168,78,90,2.47
2020,CB2020,081,4,Queens,40619001003,98,41,57,2.35
2020,CB2020,081,4,Queens,40619001004,139,61,78,2.37
2020,CB2020,081,4,Queens,40619001005,127,67,60,2.27
2020,CB2020,081,4,Queens,40619001006,75,44,31,3.59
2020,CB2020,081,4,Queens,40619001007,164,84,80,3.54
2020,CB2020,081,4,Queens,40619001008,139,69,70,3.09
2020,CB2020,081,4,Queens,40619001009,112,48,64,1.57
2020,CB2020,081,4,Queens,40619001010,0,0,0,1.89
2020,CB2020,081,4,Queens,40619002000,216,112,104,3.57
2020,CB2020,081,4,Queens,40619002001,137,67,70,2.73
2020,CB2020,081,4,Queens,40619002002,95,46,49,11.7
2020,CB2020,081,4,Queens,40619002003,252,125,127,3.32
2020,CB2020,081,4,Queens,40619002004,153,60,93,2.81
2020,CB2020,081,4,Queens,40619002005,229,108,121,3.12
2020,CB2020,081,4,Queens,40619002006,270,142,128,3.59
2020,CB2020,081,4,Queens,40620001000,87,55,32,2.91
2020,CB2020,081,4,Queens,40620001001,99,20,79,4.59
2020,CB2020,081,4,Queens,40620001002,130,58,72,4.81
2020,CB2020,081,4,Queens,40620001003,163,73,90,4.87
2020,CB2020,081,4,Queens,40620001004,100,55,45,3.9
2020,CB2020,081,4,Queens,40620001005,137,43,94,4.83
2020,CB2020,081,4,Queens,40620001006,171,68,103,4.79
2020,CB2020,081,4,Queens,40620001007,57,38,19,2.65
2020,CB2020,081,4,Queens,40620001008,21,10,11,1.44
2020,CB2020,081,4,Queens,40620001009,57,14,43,2.94
2020,CB2020,081,4,Queens,40620001010,53,27,26,1.45
2020,CB2020,081,4,Queens,40620001011,131,62,69,4.46
2020,CB2020,081,4,Queens,40620001012,82,58,24,4.58
2020,CB2020,081,4,Queens,40620001013,131,57,74,5.22
2020,CB2020,081,4,Queens,40621001000,124,81,43,3.29
2020,CB2020,081,4,Queens,40621001001,145,64,81,3.16
2020,CB2020,081,4,Queens,40621001002,161,80,81,3.06
2020,CB2020,081,4,Queens,40621001003,242,144,98,3.36
2020,CB2020,081,4,Queens,40621001004,101,17,84,3.75
2020,CB2020,081,4,Queens,40621001005,251,127,124,3.07
2020,CB2020,081,4,Queens,40621002000,305,158,147,4.92
2020,CB2020,081,4,Queens,40621002001,162,69,93,2.28
2020,CB2020,081,4,Queens,40621002002,176,93,83,3.09
2020,CB2020,081,4,Queens,40621002003,120,35,85,3.63
2020,CB2020,081,4,Queens,40621002004,52,39,13,0.84
2020,CB2020,081,4,Queens,40621002005,155,118,37,14.07
2020,CB2020,081,4,Queens,40621002006,0,0,0,0.83
2020,CB2020,081,4,Queens,40621003000,321,135,186,4.16
2020,CB2020,081,4,Queens,40621003001,265,140,125,2.98
2020,CB2020,081,4,Queens,40621003002,183,90,93,2.72
2020,CB2020,081,4,Queens,40621003003,388,192,196,4.61
2020,CB2020,081,4,Queens,40622001000,0,0,0,5.66
2020,CB2020,081,4,Queens,40622001001,0,0,0,2.24
2020,CB2020,081,4,Queens,40622001002,0,0,0,4.26
2020,CB2020,081,4,Queens,40622001003,67,23,44,3.42
2020,CB2020,081,4,Queens,40622001004,67,28,39,4.07
2020,CB2020,081,4,Queens,40622001005,107,66,41,3.95
2020,CB2020,081,4,Queens,40622001006,86,53,33,3.95
2020,CB2020,081,4,Queens,40622001007,87,34,53,3.61
2020,CB2020,081,4,Queens,40622001008,25,8,17,0.48
2020,CB2020,081,4,Queens,40622001009,121,59,62,5.12
2020,CB2020,081,4,Queens,40622001010,93,45,48,4.73
2020,CB2020,081,4,Queens,40622001011,98,38,60,4.32
2020,CB2020,081,4,Queens,40622001012,76,20,56,4.09
2020,CB2020,081,4,Queens,40622001013,0,0,0,4.49
2020,CB2020,081,4,Queens,40622001014,180,83,97,4.93
2020,CB2020,081,4,Queens,40622001015,3,2,1,0.68
2020,CB2020,081,4,Queens,40622002000,0,0,0,3.92
2020,CB2020,081,4,Queens,40622002001,0,0,0,3.21
2020,CB2020,081,4,Queens,40622002002,39,5,34,2.57
2020,CB2020,081,4,Queens,40622002003,39,16,23,2.31
2020,CB2020,081,4,Queens,40622002004,95,41,54,2.39
2020,CB2020,081,4,Queens,40622002005,114,68,46,2.79
2020,CB2020,081,4,Queens,40622002006,87,23,64,3.19
2020,CB2020,081,4,Queens,40622002007,108,48,60,4.05
2020,CB2020,081,4,Queens,40622002008,85,48,37,4.06
2020,CB2020,081,4,Queens,40622002009,77,46,31,4.06
2020,CB2020,081,4,Queens,40622002010,99,43,56,4.05
2020,CB2020,081,4,Queens,40622002011,88,39,49,4.05
2020,CB2020,081,4,Queens,40622002012,84,26,58,4.08
2020,CB2020,081,4,Queens,40622002013,10,2,8,1.06
2020,CB2020,081,4,Queens,40622002014,44,14,30,2.28
2020,CB2020,081,4,Queens,40623001000,24,11,13,0.91
2020,CB2020,081,4,Queens,40623001001,99,44,55,2.58
2020,CB2020,081,4,Queens,40623001002,53,29,24,2.34
2020,CB2020,081,4,Queens,40623001003,150,91,59,3.06
2020,CB2020,081,4,Queens,40623001004,167,77,90,3.51
2020,CB2020,081,4,Queens,40623001005,224,116,108,3.37
2020,CB2020,081,4,Queens,40623001006,200,85,115,4.43
2020,CB2020,081,4,Queens,40623002000,147,65,82,2.87
2020,CB2020,081,4,Queens,40623002001,154,95,59,3.04
2020,CB2020,081,4,Queens,40623002002,229,110,119,4.52
2020,CB2020,081,4,Queens,40623002003,214,87,127,4.01
2020,CB2020,081,4,Queens,40623002004,142,65,77,2.44
2020,CB2020,081,4,Queens,40623002005,120,59,61,1.62
2020,CB2020,081,4,Queens,40624001000,0,0,0,126.54
2020,CB2020,081,4,Queens,40625001000,39,14,25,4.28
2020,CB2020,081,4,Queens,40625001001,94,21,73,1.81
2020,CB2020,081,4,Queens,40625001002,64,44,20,1.21
2020,CB2020,081,4,Queens,40625001003,250,116,134,3.09
2020,CB2020,081,4,Queens,40625001004,125,50,75,3.04
2020,CB2020,081,4,Queens,40625001005,109,67,42,3.19
2020,CB2020,081,4,Queens,40625001006,191,95,96,2.97
2020,CB2020,081,4,Queens,40625001007,254,131,123,3.11
2020,CB2020,081,4,Queens,40625002000,314,174,140,5.03
2020,CB2020,081,4,Queens,40625002001,314,168,146,5.59
2020,CB2020,081,4,Queens,40625002002,258,83,175,5.26
2020,CB2020,081,4,Queens,40625002003,386,186,200,4.99
2020,CB2020,081,4,Queens,40625002004,227,105,122,4.74
2020,CB2020,081,4,Queens,40625002005,0,0,0,0.81
2020,CB2020,081,4,Queens,40626001000,62,14,48,3.76
2020,CB2020,081,4,Queens,40626001001,62,35,27,2.87
2020,CB2020,081,4,Queens,40626001002,58,10,48,2.27
2020,CB2020,081,4,Queens,40626001003,67,30,37,1.85
2020,CB2020,081,4,Queens,40626001004,41,11,30,1.89
2020,CB2020,081,4,Queens,40626001005,112,77,35,3.88
2020,CB2020,081,4,Queens,40626001006,146,74,72,3.57
2020,CB2020,081,4,Queens,40626001007,75,34,41,3.24
2020,CB2020,081,4,Queens,40626001008,26,15,11,3.4
2020,CB2020,081,4,Queens,40626001009,24,11,13,3.39
2020,CB2020,081,4,Queens,40626002000,79,20,59,2.2
2020,CB2020,081,4,Queens,40626002001,130,62,68,4.78
2020,CB2020,081,4,Queens,40626002002,108,58,50,4.8
2020,CB2020,081,4,Queens,40626002003,113,44,69,4.81
2020,CB2020,081,4,Queens,40626002004,176,96,80,5.32
2020,CB2020,081,4,Queens,40626002005,158,64,94,5.31
2020,CB2020,081,4,Queens,40626002006,204,99,105,5.31
2020,CB2020,081,4,Queens,40626002007,87,45,42,2.84
2020,CB2020,081,4,Queens,40626002008,59,29,30,2.85
2020,CB2020,081,4,Queens,40626002009,65,27,38,2.77
2020,CB2020,081,4,Queens,40626002010,41,14,27,2.8
2020,CB2020,081,4,Queens,40626003000,71,22,49,3.54
2020,CB2020,081,4,Queens,40626003001,122,48,74,5.11
2020,CB2020,081,4,Queens,40626003002,113,57,56,4.33
2020,CB2020,081,4,Queens,40626003003,100,58,42,4.55
2020,CB2020,081,4,Queens,40626003004,82,38,44,2.84
2020,CB2020,081,4,Queens,40626003005,64,34,30,2.13
2020,CB2020,081,4,Queens,40626003006,81,33,48,2.41
2020,CB2020,081,4,Queens,40626003007,106,42,64,4.02
2020,CB2020,081,4,Queens,40626003008,57,19,38,3.28
2020,CB2020,081,4,Queens,40627001000,137,50,87,2.39
2020,CB2020,081,4,Queens,40627001001,134,67,67,2.69
2020,CB2020,081,4,Queens,40627001002,133,84,49,2.68
2020,CB2020,081,4,Queens,40627001003,155,74,81,2.66
2020,CB2020,081,4,Queens,40627001004,210,116,94,3.11
2020,CB2020,081,4,Queens,40627001005,253,106,147,3.1
2020,CB2020,081,4,Queens,40627001006,268,121,147,3.11
2020,CB2020,081,4,Queens,40627001007,240,97,143,3.1
2020,CB2020,081,4,Queens,40627002000,429,221,208,4.43
2020,CB2020,081,4,Queens,40627002001,398,168,230,4.16
2020,CB2020,081,4,Queens,40627002002,337,178,159,3.86
2020,CB2020,081,4,Queens,40627002003,316,141,175,3.59
2020,CB2020,081,4,Queens,40629001000,137,57,80,2.9
2020,CB2020,081,4,Queens,40629001001,171,97,74,2.74
2020,CB2020,081,4,Queens,40629001002,264,153,111,3.31
2020,CB2020,081,4,Queens,40629001003,180,80,100,3.64
2020,CB2020,081,4,Queens,40629001004,239,103,136,3.42
2020,CB2020,081,4,Queens,40629001005,52,16,36,0.76
2020,CB2020,081,4,Queens,40629002000,68,41,27,1.01
2020,CB2020,081,4,Queens,40629002001,75,45,30,1.64
2020,CB2020,081,4,Queens,40629002002,194,89,105,3.33
2020,CB2020,081,4,Queens,40629002003,179,87,92,3.92
2020,CB2020,081,4,Queens,40629002004,334,140,194,3.3
2020,CB2020,081,4,Queens,40629002005,192,90,102,1.67
2020,CB2020,081,4,Queens,40629002006,111,62,49,1.77
2020,CB2020,081,4,Queens,40629003000,303,124,179,3.45
2020,CB2020,081,4,Queens,40629003001,213,108,105,3.63
2020,CB2020,081,4,Queens,40629003002,330,179,151,3.91
2020,CB2020,081,4,Queens,40629003003,0,0,0,0.94
2020,CB2020,081,4,Queens,40630001000,264,105,159,5.31
2020,CB2020,081,4,Queens,40630001001,221,103,118,5.33
2020,CB2020,081,4,Queens,40630001002,165,67,98,5.31
2020,CB2020,081,4,Queens,40630001003,75,35,40,2.85
2020,CB2020,081,4,Queens,40630001004,67,32,35,2.75
2020,CB2020,081,4,Queens,40630001005,59,28,31,3.33
2020,CB2020,081,4,Queens,40630001006,121,62,59,3.77
2020,CB2020,081,4,Queens,40630002000,90,45,45,4.08
2020,CB2020,081,4,Queens,40630002001,103,56,47,4.79
2020,CB2020,081,4,Queens,40630002002,215,81,134,4.82
2020,CB2020,081,4,Queens,40630002003,222,97,125,4.74
2020,CB2020,081,4,Queens,40632001000,164,93,71,5.3
2020,CB2020,081,4,Queens,40632001001,165,68,97,5.3
2020,CB2020,081,4,Queens,40632001002,186,86,100,5.31
2020,CB2020,081,4,Queens,40632001003,208,72,136,5.31
2020,CB2020,081,4,Queens,40632002000,98,52,46,2.97
2020,CB2020,081,4,Queens,40632002001,81,41,40,3
2020,CB2020,081,4,Queens,40632002002,67,36,31,2.96
2020,CB2020,081,4,Queens,40632002003,82,38,44,2.9
2020,CB2020,081,4,Queens,40632002004,102,47,55,3.72
2020,CB2020,081,4,Queens,40632002005,72,33,39,3.85
2020,CB2020,081,4,Queens,40632002006,128,42,86,3.92
2020,CB2020,081,4,Queens,40632002007,147,73,74,3.82
2020,CB2020,081,4,Queens,40632002008,129,65,64,4.1
2020,CB2020,081,4,Queens,40632002009,115,44,71,4.15
2020,CB2020,081,4,Queens,40632002010,122,54,68,3.92
2020,CB2020,081,4,Queens,40632002011,63,18,45,2.37
2020,CB2020,081,4,Queens,40632002012,72,43,29,1.63
2020,CB2020,081,4,Queens,40632002013,123,54,69,4.03
2020,CB2020,081,4,Queens,40632002014,46,31,15,2.93
2020,CB2020,081,4,Queens,40632002015,91,19,72,1.86
2020,CB2020,081,4,Queens,40633011000,235,106,129,4.92
2020,CB2020,081,4,Queens,40633011001,64,20,44,4.46
2020,CB2020,081,4,Queens,40633011002,28,7,21,2.78
2020,CB2020,081,4,Queens,40633011003,229,88,141,4.42
2020,CB2020,081,4,Queens,40633011004,270,160,110,4.41
2020,CB2020,081,4,Queens,40633011005,280,141,139,4.25
2020,CB2020,081,4,Queens,40633011006,340,172,168,4.33
2020,CB2020,081,4,Queens,40633011007,132,53,79,3.43
2020,CB2020,081,4,Queens,40633011008,9,3,6,0.29
2020,CB2020,081,4,Queens,40633021000,54,21,33,2.73
2020,CB2020,081,4,Queens,40633021001,188,101,87,4.29
2020,CB2020,081,4,Queens,40633021002,231,105,126,4.01
2020,CB2020,081,4,Queens,40633021003,231,118,113,4.26
2020,CB2020,081,4,Queens,40633022000,98,47,51,3.09
2020,CB2020,081,4,Queens,40633022001,231,86,145,4.13
2020,CB2020,081,4,Queens,40633022002,193,95,98,3.73
2020,CB2020,081,4,Queens,40633022003,188,95,93,3.65
2020,CB2020,081,4,Queens,40633022004,251,137,114,4.38
2020,CB2020,081,4,Queens,40635001000,59,23,36,2.15
2020,CB2020,081,4,Queens,40635001001,66,30,36,2.22
2020,CB2020,081,4,Queens,40635001002,107,50,57,2.3
2020,CB2020,081,4,Queens,40635001003,123,88,35,3.08
2020,CB2020,081,4,Queens,40635001004,83,16,67,2.07
2020,CB2020,081,4,Queens,40635001005,273,127,146,5.24
2020,CB2020,081,4,Queens,40635001006,307,161,146,5.15
2020,CB2020,081,4,Queens,40635002000,100,58,42,1.62
2020,CB2020,081,4,Queens,40635002001,124,75,49,1.56
2020,CB2020,081,4,Queens,40635002002,124,59,65,1.55
2020,CB2020,081,4,Queens,40635002003,417,230,187,6.38
2020,CB2020,081,4,Queens,40635002004,229,85,144,3.51
2020,CB2020,081,4,Queens,40635002005,287,138,149,3.58
2020,CB2020,081,4,Queens,40635002006,247,110,137,2.96
2020,CB2020,081,4,Queens,40635002007,238,91,147,3.45
2020,CB2020,081,4,Queens,40637001000,0,0,0,18.73
2020,CB2020,081,4,Queens,40637001001,0,0,0,5.48
2020,CB2020,081,4,Queens,40637001002,48,20,28,10.55
2020,CB2020,081,4,Queens,40637002000,122,58,64,4.74
2020,CB2020,081,4,Queens,40637002001,224,96,128,7.18
2020,CB2020,081,4,Queens,40637002002,287,141,146,7.86
2020,CB2020,081,4,Queens,40637002003,240,127,113,4.33
2020,CB2020,081,4,Queens,40637002004,164,90,74,3.48
2020,CB2020,081,4,Queens,40637002005,54,17,37,3.39
2020,CB2020,081,4,Queens,40637002006,45,12,33,3.86
2020,CB2020,081,4,Queens,40637003000,298,158,140,38.17
2020,CB2020,081,4,Queens,40637003001,220,108,112,7.13
2020,CB2020,081,4,Queens,40637003002,93,20,73,2.07
2020,CB2020,081,4,Queens,40637003003,84,51,33,1.97
2020,CB2020,081,4,Queens,40637003004,110,58,52,1.85
2020,CB2020,081,4,Queens,40637003005,0,0,0,2.5
2020,CB2020,081,4,Queens,40637003006,156,82,74,4.5
2020,CB2020,081,4,Queens,40637003007,327,131,196,5.12
2020,CB2020,081,4,Queens,40637003008,121,76,45,3.41
2020,CB2020,081,4,Queens,40637004000,164,83,81,3.39
2020,CB2020,081,4,Queens,40637004001,203,103,100,6.02
2020,CB2020,081,4,Queens,40637004002,137,53,84,3.55
2020,CB2020,081,4,Queens,40637004003,126,68,58,5.37
2020,CB2020,081,4,Queens,40637004004,0,0,0,3.65
2020,CB2020,081,4,Queens,40637004005,39,14,25,6.3
2020,CB2020,081,4,Queens,40637004006,99,42,57,3.14
2020,CB2020,081,4,Queens,40637004007,146,69,77,4.03
2020,CB2020,081,4,Queens,40638001000,24,18,6,2.51
2020,CB2020,081,4,Queens,40638001001,101,46,55,4.3
2020,CB2020,081,4,Queens,40638001002,61,22,39,2.93
2020,CB2020,081,4,Queens,40638001003,15,4,11,7.95
2020,CB2020,081,4,Queens,40638001004,87,30,57,2.92
2020,CB2020,081,4,Queens,40638001005,0,0,0,2.11
2020,CB2020,081,4,Queens,40638001006,0,0,0,2.62
2020,CB2020,081,4,Queens,40638001007,92,40,52,3.13
2020,CB2020,081,4,Queens,40638001008,99,55,44,3.11
2020,CB2020,081,4,Queens,40638001009,23,10,13,3.11
2020,CB2020,081,4,Queens,40638001010,86,42,44,3.09
2020,CB2020,081,4,Queens,40638001011,64,25,39,3.09
2020,CB2020,081,4,Queens,40638001012,89,40,49,3.1
2020,CB2020,081,4,Queens,40638002000,0,0,0,1.53
2020,CB2020,081,4,Queens,40638002001,0,0,0,2.36
2020,CB2020,081,4,Queens,40638002002,0,0,0,6.15
2020,CB2020,081,4,Queens,40638002003,0,0,0,1.55
2020,CB2020,081,4,Queens,40638002004,75,50,25,4.96
2020,CB2020,081,4,Queens,40638002005,86,43,43,5.16
2020,CB2020,081,4,Queens,40638002006,42,35,7,3.11
2020,CB2020,081,4,Queens,40638002007,126,61,65,3.11
2020,CB2020,081,4,Queens,40638002008,115,32,83,3.09
2020,CB2020,081,4,Queens,40638002009,72,50,22,2.41
2020,CB2020,081,4,Queens,40638002010,88,37,51,2.93
2020,CB2020,081,4,Queens,40638002011,63,28,35,2.35
2020,CB2020,081,4,Queens,40638002012,95,44,51,2.84
2020,CB2020,081,4,Queens,40638002013,0,0,0,0.87
2020,CB2020,081,4,Queens,40638003000,53,25,28,2.25
2020,CB2020,081,4,Queens,40638003001,74,36,38,2.92
2020,CB2020,081,4,Queens,40638003002,84,38,46,3.1
2020,CB2020,081,4,Queens,40638003003,75,55,20,3.12
2020,CB2020,081,4,Queens,40638003004,81,20,61,3.08
2020,CB2020,081,4,Queens,40638003005,48,27,21,2.4
2020,CB2020,081,4,Queens,40638003006,22,14,8,1.13
2020,CB2020,081,4,Queens,40638003007,68,38,30,1.75
2020,CB2020,081,4,Queens,40638003008,36,17,19,1.49
2020,CB2020,081,4,Queens,40638004000,24,12,12,1.01
2020,CB2020,081,4,Queens,40638004001,62,27,35,1.91
2020,CB2020,081,4,Queens,40638004002,53,23,30,3.11
2020,CB2020,081,4,Queens,40638004003,75,40,35,3.09
2020,CB2020,081,4,Queens,40638004004,75,28,47,3.11
2020,CB2020,081,4,Queens,40638004005,65,46,19,3.12
2020,CB2020,081,4,Queens,40638004006,159,66,93,5.44
2020,CB2020,081,4,Queens,40638004007,52,31,21,2.1
2020,CB2020,081,4,Queens,40638004008,39,18,21,1.26
2020,CB2020,081,4,Queens,40638004009,24,13,11,1.45
2020,CB2020,081,4,Queens,40638004010,50,29,21,1.94
2020,CB2020,081,4,Queens,40638004011,187,90,97,5.52
2020,CB2020,081,4,Queens,40638005000,114,53,61,6.71
2020,CB2020,081,4,Queens,40638005001,52,38,14,2.25
2020,CB2020,081,4,Queens,40638005002,78,25,53,3.58
2020,CB2020,081,4,Queens,40638005003,93,38,55,3.13
2020,CB2020,081,4,Queens,40638005004,67,27,40,3.09
2020,CB2020,081,4,Queens,40638005005,82,53,29,3.1
2020,CB2020,081,4,Queens,40638005006,67,22,45,2.66
2020,CB2020,081,4,Queens,40638005007,8,1,7,1.11
2020,CB2020,081,4,Queens,40638005008,30,15,15,0.56
2020,CB2020,081,4,Queens,40638005009,58,18,40,3.05
2020,CB2020,081,4,Queens,40638005010,26,13,13,0.78
2020,CB2020,081,4,Queens,40639001000,427,197,230,3.2
2020,CB2020,081,4,Queens,40639001001,165,100,65,7.06
2020,CB2020,081,4,Queens,40639001002,165,83,82,2.69
2020,CB2020,081,4,Queens,40639001003,103,53,50,3.57
2020,CB2020,081,4,Queens,40639001004,215,113,102,4.37
2020,CB2020,081,4,Queens,40639001005,0,0,0,1.33
2020,CB2020,081,4,Queens,40639001006,288,146,142,4.74
2020,CB2020,081,4,Queens,40639001007,250,135,115,4.19
2020,CB2020,081,4,Queens,40639001008,116,31,85,2.46
2020,CB2020,081,4,Queens,40639001009,279,113,166,5.25
2020,CB2020,081,4,Queens,40639001010,37,22,15,0.67
2020,CB2020,081,4,Queens,40639001011,0,0,0,0.36
2020,CB2020,081,4,Queens,40639002000,330,175,155,9.27
2020,CB2020,081,4,Queens,40639002001,0,0,0,1.43
2020,CB2020,081,4,Queens,40639002002,0,0,0,0.51
2020,CB2020,081,4,Queens,40639002003,92,32,60,2.57
2020,CB2020,081,4,Queens,40639002004,59,43,16,0.98
2020,CB2020,081,4,Queens,40639002005,186,82,104,3.4
2020,CB2020,081,4,Queens,40639002006,82,45,37,2.43
2020,CB2020,081,4,Queens,40639002007,0,0,0,1.74
2020,CB2020,081,4,Queens,40641011000,815,413,402,6.94
2020,CB2020,081,4,Queens,40641011001,0,0,0,0.63
2020,CB2020,081,4,Queens,40641011002,1563,770,793,13.55
2020,CB2020,081,4,Queens,40641021000,0,0,0,11.82
2020,CB2020,081,4,Queens,40641021001,0,0,0,78.26
2020,CB2020,081,4,Queens,40641021002,0,0,0,2.62
2020,CB2020,081,4,Queens,40641021003,0,0,0,14.31
2020,CB2020,081,4,Queens,40641021004,0,0,0,14.52
2020,CB2020,081,4,Queens,40641021005,1,1,0,84.61
2020,CB2020,081,4,Queens,40641021006,0,0,0,3.07
2020,CB2020,081,4,Queens,40641021007,0,0,0,14.75
2020,CB2020,081,4,Queens,40641021008,3,1,2,145.57
2020,CB2020,081,4,Queens,40641021009,0,0,0,1.59
2020,CB2020,081,4,Queens,40641021010,0,0,0,0.85
2020,CB2020,081,4,Queens,40641021011,0,0,0,18.73
2020,CB2020,081,4,Queens,40641021012,0,0,0,6.17
2020,CB2020,081,4,Queens,40641021013,0,0,0,0.66
2020,CB2020,081,4,Queens,40641021014,0,0,0,67.1
2020,CB2020,081,4,Queens,40641021015,0,0,0,3.49
2020,CB2020,081,4,Queens,40641021016,0,0,0,17.08
2020,CB2020,081,4,Queens,40641021017,0,0,0,36.14
2020,CB2020,081,4,Queens,40641021018,0,0,0,28.55
2020,CB2020,081,4,Queens,40645001000,100,39,61,3.26
2020,CB2020,081,4,Queens,40645001001,81,36,45,2.68
2020,CB2020,081,4,Queens,40645001002,104,51,53,3.2
2020,CB2020,081,4,Queens,40645001003,108,29,79,3.33
2020,CB2020,081,4,Queens,40645001004,106,69,37,3.58
2020,CB2020,081,4,Queens,40645001005,117,54,63,4.42
2020,CB2020,081,4,Queens,40645001006,196,103,93,5.4
2020,CB2020,081,4,Queens,40645002000,160,73,87,4.29
2020,CB2020,081,4,Queens,40645002001,185,85,100,4.05
2020,CB2020,081,4,Queens,40645002002,183,114,69,4.1
2020,CB2020,081,4,Queens,40645002003,167,77,90,4.05
2020,CB2020,081,4,Queens,40645002004,245,122,123,19.16
2020,CB2020,081,4,Queens,40645002005,18,7,11,1.73
2020,CB2020,081,4,Queens,40645002006,185,94,91,3.84
2020,CB2020,081,4,Queens,40645002007,64,27,37,1.22
2020,CB2020,081,4,Queens,40645002008,45,22,23,1.89
2020,CB2020,081,4,Queens,40645002009,0,0,0,6.31
2020,CB2020,081,4,Queens,40646001000,175,74,101,4.06
2020,CB2020,081,4,Queens,40646001001,171,48,123,4.06
2020,CB2020,081,4,Queens,40646001002,79,49,30,2
2020,CB2020,081,4,Queens,40646001003,68,41,27,2.05
2020,CB2020,081,4,Queens,40646001004,176,79,97,4.06
2020,CB2020,081,4,Queens,40646001005,183,89,94,4.26
2020,CB2020,081,4,Queens,40646001006,119,37,82,4.24
2020,CB2020,081,4,Queens,40646001007,128,63,65,4.06
2020,CB2020,081,4,Queens,40646001008,94,38,56,4.24
2020,CB2020,081,4,Queens,40646001009,139,68,71,4.26
2020,CB2020,081,4,Queens,40646001010,74,29,45,4.08
2020,CB2020,081,4,Queens,40646001011,123,68,55,4.2
2020,CB2020,081,4,Queens,40646001012,99,55,44,3.11
2020,CB2020,081,4,Queens,40646001013,73,33,40,1.84
2020,CB2020,081,4,Queens,40646002000,151,65,86,4.33
2020,CB2020,081,4,Queens,40646002001,150,73,77,4.06
2020,CB2020,081,4,Queens,40646002002,67,25,42,2.02
2020,CB2020,081,4,Queens,40646002003,81,35,46,2.04
2020,CB2020,081,4,Queens,40646002004,139,62,77,4.06
2020,CB2020,081,4,Queens,40646002005,138,69,69,4.28
2020,CB2020,081,4,Queens,40646002006,89,33,56,4.22
2020,CB2020,081,4,Queens,40646002007,25,23,2,4.07
2020,CB2020,081,4,Queens,40646002008,64,28,36,4.25
2020,CB2020,081,4,Queens,40646002009,110,47,63,4.26
2020,CB2020,081,4,Queens,40646002010,109,43,66,4.09
2020,CB2020,081,4,Queens,40646002011,96,46,50,4.23
2020,CB2020,081,4,Queens,40646002012,105,46,59,4.2
2020,CB2020,081,4,Queens,40650001000,55,29,26,2.48
2020,CB2020,081,4,Queens,40650001001,164,62,102,4.06
2020,CB2020,081,4,Queens,40650001002,64,27,37,2.02
2020,CB2020,081,4,Queens,40650001003,102,44,58,2.05
2020,CB2020,081,4,Queens,40650001004,146,62,84,4.06
2020,CB2020,081,4,Queens,40650001005,148,93,55,4.28
2020,CB2020,081,4,Queens,40650001006,103,50,53,4.23
2020,CB2020,081,4,Queens,40650001007,102,54,48,4.06
2020,CB2020,081,4,Queens,40650001008,96,38,58,4.25
2020,CB2020,081,4,Queens,40650001009,103,34,69,4.25
2020,CB2020,081,4,Queens,40650001010,97,40,57,4.06
2020,CB2020,081,4,Queens,40650001011,101,44,57,4.24
2020,CB2020,081,4,Queens,40650001012,82,27,55,4.25
2020,CB2020,081,4,Queens,40650002000,142,79,63,3.44
2020,CB2020,081,4,Queens,40650002001,51,33,18,1.31
2020,CB2020,081,4,Queens,40650002002,67,41,26,2.3
2020,CB2020,081,4,Queens,40650002003,141,74,67,4.03
2020,CB2020,081,4,Queens,40650002004,116,27,89,4.26
2020,CB2020,081,4,Queens,40650002005,132,45,87,4.25
2020,CB2020,081,4,Queens,40650002006,105,22,83,4.06
2020,CB2020,081,4,Queens,40650002007,124,58,66,4.27
2020,CB2020,081,4,Queens,40650002008,83,21,62,4.24
2020,CB2020,081,4,Queens,40650002009,115,53,62,4.09
2020,CB2020,081,4,Queens,40650002010,95,56,39,4.24
2020,CB2020,081,4,Queens,40650002011,108,43,65,4.29
2020,CB2020,081,4,Queens,40650002012,175,90,85,4.32
2020,CB2020,081,4,Queens,40650002013,14,6,8,1.42
2020,CB2020,081,4,Queens,40654011000,77,47,30,8.55
2020,CB2020,081,4,Queens,40654011001,0,0,0,4.96
2020,CB2020,081,4,Queens,40654011002,0,0,0,3.5
2020,CB2020,081,4,Queens,40654011003,0,0,0,0.42
2020,CB2020,081,4,Queens,40654011004,41,22,19,2.56
2020,CB2020,081,4,Queens,40654011005,69,27,42,4.28
2020,CB2020,081,4,Queens,40654011006,143,84,59,4.45
2020,CB2020,081,4,Queens,40654011007,85,40,45,2.54
2020,CB2020,081,4,Queens,40654011008,76,42,34,3.16
2020,CB2020,081,4,Queens,40654011009,158,57,101,4.09
2020,CB2020,081,4,Queens,40654011010,129,53,76,4.09
2020,CB2020,081,4,Queens,40654011011,163,96,67,4.09
2020,CB2020,081,4,Queens,40654011012,164,65,99,4.09
2020,CB2020,081,4,Queens,40654012000,95,57,38,2.56
2020,CB2020,081,4,Queens,40654012001,94,49,45,2.42
2020,CB2020,081,4,Queens,40654012002,100,45,55,2.77
2020,CB2020,081,4,Queens,40654012003,111,54,57,2.78
2020,CB2020,081,4,Queens,40654012004,88,18,70,2.78
2020,CB2020,081,4,Queens,40654012005,102,51,51,2.31
2020,CB2020,081,4,Queens,40654012006,114,39,75,2.25
2020,CB2020,081,4,Queens,40654012007,97,34,63,2.77
2020,CB2020,081,4,Queens,40654012008,100,54,46,2.78
2020,CB2020,081,4,Queens,40654012009,111,56,55,2.32
2020,CB2020,081,4,Queens,40654013000,0,0,0,4.55
2020,CB2020,081,4,Queens,40654013001,0,0,0,3.25
2020,CB2020,081,4,Queens,40654013002,0,0,0,1.21
2020,CB2020,081,4,Queens,40654013003,122,53,69,2.84
2020,CB2020,081,4,Queens,40654013004,25,12,13,1.02
2020,CB2020,081,4,Queens,40654013005,97,48,49,3.01
2020,CB2020,081,4,Queens,40654013006,99,52,47,2.79
2020,CB2020,081,4,Queens,40654013007,64,31,33,2.78
2020,CB2020,081,4,Queens,40654013008,132,60,72,2.96
2020,CB2020,081,4,Queens,40654013009,107,61,46,2.8
2020,CB2020,081,4,Queens,40654013010,73,18,55,2.78
2020,CB2020,081,4,Queens,40654021000,5,2,3,62.41
2020,CB2020,081,4,Queens,40654021001,0,0,0,0
2020,CB2020,081,4,Queens,40655011000,3,1,2,151.88
2020,CB2020,081,4,Queens,40655011001,0,0,0,48.79
2020,CB2020,081,4,Queens,40656001000,65,33,32,3.44
2020,CB2020,081,4,Queens,40656001001,0,0,0,0.81
2020,CB2020,081,4,Queens,40656001002,74,34,40,3.03
2020,CB2020,081,4,Queens,40656001003,67,32,35,3.79
2020,CB2020,081,4,Queens,40656001004,55,18,37,1.46
2020,CB2020,081,4,Queens,40656001005,119,43,76,3.17
2020,CB2020,081,4,Queens,40656001006,99,54,45,3.19
2020,CB2020,081,4,Queens,40656001007,124,50,74,3.41
2020,CB2020,081,4,Queens,40656001008,99,61,38,3.22
2020,CB2020,081,4,Queens,40656001009,101,51,50,3.19
2020,CB2020,081,4,Queens,40656001010,178,57,121,3.19
2020,CB2020,081,4,Queens,40656001011,111,66,45,3.19
2020,CB2020,081,4,Queens,40656001012,148,34,114,3.19
2020,CB2020,081,4,Queens,40656001013,131,69,62,4.04
2020,CB2020,081,4,Queens,40656002000,122,77,45,2.67
2020,CB2020,081,4,Queens,40656002001,76,37,39,2.82
2020,CB2020,081,4,Queens,40656002002,95,51,44,3.19
2020,CB2020,081,4,Queens,40656002003,104,42,62,3.19
2020,CB2020,081,4,Queens,40656002004,100,46,54,2.31
2020,CB2020,081,4,Queens,40656002005,75,32,43,2.3
2020,CB2020,081,4,Queens,40656002006,43,11,32,1.89
2020,CB2020,081,4,Queens,40656002007,89,48,41,1.91
2020,CB2020,081,4,Queens,40656002008,127,43,84,2.87
2020,CB2020,081,4,Queens,40656002009,171,69,102,3.56
2020,CB2020,081,4,Queens,40656002010,151,70,81,3.16
2020,CB2020,081,4,Queens,40656002011,99,60,39,3.19
2020,CB2020,081,4,Queens,40656003000,77,41,36,1.52
2020,CB2020,081,4,Queens,40656003001,142,65,77,3.77
2020,CB2020,081,4,Queens,40656003002,151,78,73,3.56
2020,CB2020,081,4,Queens,40656003003,83,27,56,1.41
2020,CB2020,081,4,Queens,40656003004,101,43,58,1.37
2020,CB2020,081,4,Queens,40656003005,154,71,83,3.26
2020,CB2020,081,4,Queens,40656003006,44,13,31,1.51
2020,CB2020,081,4,Queens,40656003007,94,39,55,1.35
2020,CB2020,081,4,Queens,40656003008,308,145,163,11.18
2020,CB2020,081,4,Queens,40656003009,294,140,154,8.75
2020,CB2020,081,4,Queens,40656003010,133,88,45,3.9
2020,CB2020,081,4,Queens,40656003011,169,98,71,3.5
2020,CB2020,081,4,Queens,40656003012,161,62,99,4.53
2020,CB2020,081,4,Queens,40656003013,15,11,4,0.53
2020,CB2020,081,4,Queens,40656003014,190,69,121,5.48
2020,CB2020,081,4,Queens,40656003015,217,85,132,5.32
2020,CB2020,081,4,Queens,40656003016,216,86,130,5.4
2020,CB2020,081,4,Queens,40656003017,251,126,125,4.7
2020,CB2020,081,4,Queens,40657021000,355,184,171,6.07
2020,CB2020,081,4,Queens,40657021001,120,41,79,3.37
2020,CB2020,081,4,Queens,40657021002,173,94,79,3.15
2020,CB2020,081,4,Queens,40657021003,165,68,97,3.46
2020,CB2020,081,4,Queens,40657021004,340,134,206,6.55
2020,CB2020,081,4,Queens,40657021005,97,64,33,2.28
2020,CB2020,081,4,Queens,40657021006,270,134,136,5.83
2020,CB2020,081,4,Queens,40657021007,255,138,117,4.9
2020,CB2020,081,4,Queens,40657031000,147,97,50,3.11
2020,CB2020,081,4,Queens,40657031001,149,61,88,3.02
2020,CB2020,081,4,Queens,40657031002,211,82,129,4.62
2020,CB2020,081,4,Queens,40657031003,67,15,52,1.7
2020,CB2020,081,4,Queens,40657031004,287,128,159,5.69
2020,CB2020,081,4,Queens,40657031005,279,138,141,4.99
2020,CB2020,081,4,Queens,40657032000,190,91,99,4.21
2020,CB2020,081,4,Queens,40657032001,211,104,107,5
2020,CB2020,081,4,Queens,40657032002,286,161,125,7.85
2020,CB2020,081,4,Queens,40657032003,193,95,98,7.77
2020,CB2020,081,4,Queens,40657033000,164,80,84,3.9
2020,CB2020,081,4,Queens,40657033001,190,101,89,3.65
2020,CB2020,081,4,Queens,40657033002,158,92,66,3.57
2020,CB2020,081,4,Queens,40657033003,93,29,64,2.32
2020,CB2020,081,4,Queens,40657033004,99,29,70,2.43
2020,CB2020,081,4,Queens,40657033005,105,32,73,2.5
2020,CB2020,081,4,Queens,40659001000,110,51,59,2.23
2020,CB2020,081,4,Queens,40659001001,159,72,87,3.16
2020,CB2020,081,4,Queens,40659001002,108,47,61,2.87
2020,CB2020,081,4,Queens,40659001003,109,48,61,3.15
2020,CB2020,081,4,Queens,40659001004,116,45,71,2.77
2020,CB2020,081,4,Queens,40659001005,97,63,34,2.47
2020,CB2020,081,4,Queens,40659001006,86,51,35,2.55
2020,CB2020,081,4,Queens,40659001007,140,62,78,3.52
2020,CB2020,081,4,Queens,40659002000,104,58,46,2.79
2020,CB2020,081,4,Queens,40659002001,140,59,81,2.92
2020,CB2020,081,4,Queens,40659002002,172,111,61,3.21
2020,CB2020,081,4,Queens,40659002003,104,40,64,2.35
2020,CB2020,081,4,Queens,40659002004,8,3,5,2.16
2020,CB2020,081,4,Queens,40659002005,0,0,0,1.24
2020,CB2020,081,4,Queens,40659002006,196,93,103,3.36
2020,CB2020,081,4,Queens,40659002007,0,0,0,2.6
2020,CB2020,081,4,Queens,40659002008,55,23,32,1.55
2020,CB2020,081,4,Queens,40659002009,146,58,88,2.99
2020,CB2020,081,4,Queens,40660001000,135,66,69,3.18
2020,CB2020,081,4,Queens,40660001001,157,58,99,3.18
2020,CB2020,081,4,Queens,40660001002,72,35,37,3.19
2020,CB2020,081,4,Queens,40660001003,88,50,38,3.18
2020,CB2020,081,4,Queens,40660001004,89,48,41,3.18
2020,CB2020,081,4,Queens,40660001005,176,107,69,3.43
2020,CB2020,081,4,Queens,40660001006,235,69,166,3.9
2020,CB2020,081,4,Queens,40660001007,216,101,115,5.24
2020,CB2020,081,4,Queens,40660001008,105,56,49,2.86
2020,CB2020,081,4,Queens,40660001009,85,40,45,2.89
2020,CB2020,081,4,Queens,40660001010,135,68,67,3.59
2020,CB2020,081,4,Queens,40660002000,130,55,75,3.1
2020,CB2020,081,4,Queens,40660002001,120,37,83,3.23
2020,CB2020,081,4,Queens,40660002002,68,36,32,1.83
2020,CB2020,081,4,Queens,40660002003,158,71,87,3.78
2020,CB2020,081,4,Queens,40660002004,38,29,9,3.15
2020,CB2020,081,4,Queens,40660002005,204,97,107,5.98
2020,CB2020,081,4,Queens,40660002006,125,47,78,3.98
2020,CB2020,081,4,Queens,40660002007,96,33,63,3.26
2020,CB2020,081,4,Queens,40660002008,207,103,104,5.76
2020,CB2020,081,4,Queens,40660002009,175,62,113,5.65
2020,CB2020,081,4,Queens,40660002010,123,80,43,3.1
2020,CB2020,081,4,Queens,40660002011,95,49,46,3.46
2020,CB2020,081,4,Queens,40660002012,94,68,26,4
2020,CB2020,081,4,Queens,40660002013,168,74,94,3.83
2020,CB2020,081,4,Queens,40660002014,217,89,128,3.59
2020,CB2020,081,4,Queens,40661001000,197,96,101,4.14
2020,CB2020,081,4,Queens,40661001001,256,88,168,4.59
2020,CB2020,081,4,Queens,40661001002,252,106,146,4.69
2020,CB2020,081,4,Queens,40661001003,178,97,81,4.73
2020,CB2020,081,4,Queens,40661001004,153,87,66,3.99
2020,CB2020,081,4,Queens,40661001005,182,71,111,3.18
2020,CB2020,081,4,Queens,40661001006,146,81,65,2.55
2020,CB2020,081,4,Queens,40661001007,125,70,55,2.43
2020,CB2020,081,4,Queens,40661001008,84,29,55,2.7
2020,CB2020,081,4,Queens,40663011000,173,94,79,4.13
2020,CB2020,081,4,Queens,40663011001,19,13,6,0.38
2020,CB2020,081,4,Queens,40663011002,142,85,57,4.28
2020,CB2020,081,4,Queens,40663011003,121,52,69,3.15
2020,CB2020,081,4,Queens,40663011004,77,38,39,2.23
2020,CB2020,081,4,Queens,40663011005,15,9,6,0.5
2020,CB2020,081,4,Queens,40663011006,157,71,86,4.16
2020,CB2020,081,4,Queens,40663011007,232,115,117,4.57
2020,CB2020,081,4,Queens,40663011008,209,107,102,4.29
2020,CB2020,081,4,Queens,40663011009,144,55,89,3.51
2020,CB2020,081,4,Queens,40663011010,100,51,49,2.45
2020,CB2020,081,4,Queens,40663011011,64,29,35,1.59
2020,CB2020,081,4,Queens,40663011012,28,11,17,0.9
2020,CB2020,081,4,Queens,40663012000,241,135,106,4.71
2020,CB2020,081,4,Queens,40663012001,207,119,88,4.72
2020,CB2020,081,4,Queens,40663012002,163,76,87,4.71
2020,CB2020,081,4,Queens,40663012003,139,41,98,4.56
2020,CB2020,081,4,Queens,40663012004,0,0,0,0.87
2020,CB2020,081,4,Queens,40663012005,60,21,39,1.74
2020,CB2020,081,4,Queens,40663012006,0,0,0,2.27
2020,CB2020,081,4,Queens,40663012007,108,55,53,2.68
2020,CB2020,081,4,Queens,40663012008,138,47,91,3.18
2020,CB2020,081,4,Queens,40663012009,176,75,101,3.66
2020,CB2020,081,4,Queens,40663021000,0,0,0,7.91
2020,CB2020,081,4,Queens,40663021001,4,1,3,51.64
2020,CB2020,081,4,Queens,40663021002,0,0,0,0.96
2020,CB2020,081,4,Queens,40664011000,14,9,5,83.6
2020,CB2020,081,4,Queens,40664011001,0,0,0,0.54
2020,CB2020,081,4,Queens,40664011002,213,203,10,4.77
2020,CB2020,081,4,Queens,40664011003,0,0,0,40.29
2020,CB2020,081,4,Queens,40664011004,0,0,0,33.68
2020,CB2020,081,4,Queens,40664011005,36,19,17,4.27
2020,CB2020,081,4,Queens,40664011006,13,8,5,9.04
2020,CB2020,081,4,Queens,40664011007,33,19,14,3.77
2020,CB2020,081,4,Queens,40664011008,0,0,0,0
2020,CB2020,081,4,Queens,40664011009,0,0,0,0
2020,CB2020,081,4,Queens,40664011010,23,9,14,3.09
2020,CB2020,081,4,Queens,40664011011,43,29,14,1.2
2020,CB2020,081,4,Queens,40664011012,0,0,0,0.69
2020,CB2020,081,4,Queens,40664011013,0,0,0,2.29
2020,CB2020,081,4,Queens,40664011014,0,0,0,1.03
2020,CB2020,081,4,Queens,40664011015,25,7,18,0.43
2020,CB2020,081,4,Queens,40664012000,475,219,256,15.83
2020,CB2020,081,4,Queens,40664012001,98,46,52,3.28
2020,CB2020,081,4,Queens,40664012002,135,69,66,3.17
2020,CB2020,081,4,Queens,40664012003,189,92,97,31.28
2020,CB2020,081,4,Queens,40664012004,163,75,88,5.1
2020,CB2020,081,4,Queens,40664012005,186,81,105,4.18
2020,CB2020,081,4,Queens,40664012006,106,39,67,3.55
2020,CB2020,081,4,Queens,40664012007,96,40,56,2.87
2020,CB2020,081,4,Queens,40664012008,75,31,44,2.13
2020,CB2020,081,4,Queens,40664012009,0,0,0,0
2020,CB2020,081,4,Queens,40664012010,0,0,0,14.89
2020,CB2020,081,4,Queens,40664021000,102,50,52,2.49
2020,CB2020,081,4,Queens,40664021001,107,35,72,2.77
2020,CB2020,081,4,Queens,40664021002,305,141,164,7.37
2020,CB2020,081,4,Queens,40664021003,13,9,4,0.54
2020,CB2020,081,4,Queens,40664021004,46,25,21,1.41
2020,CB2020,081,4,Queens,40664021005,131,53,78,3.09
2020,CB2020,081,4,Queens,40664021006,108,49,59,3.42
2020,CB2020,081,4,Queens,40664021007,56,35,21,2.25
2020,CB2020,081,4,Queens,40664021008,201,98,103,4.09
2020,CB2020,081,4,Queens,40664021009,48,10,38,2.53
2020,CB2020,081,4,Queens,40664021010,65,48,17,1.95
2020,CB2020,081,4,Queens,40664022000,183,71,112,3.64
2020,CB2020,081,4,Queens,40664022001,147,48,99,3.65
2020,CB2020,081,4,Queens,40664022002,207,95,112,3.98
2020,CB2020,081,4,Queens,40664022003,127,60,67,3.45
2020,CB2020,081,4,Queens,40664022004,121,64,57,2.56
2020,CB2020,081,4,Queens,40664022005,138,63,75,3.29
2020,CB2020,081,4,Queens,40664022006,152,59,93,4.28
2020,CB2020,081,4,Queens,40664022007,126,56,70,3.52
2020,CB2020,081,4,Queens,40664022008,80,44,36,3.35
2020,CB2020,081,4,Queens,40664023000,126,53,73,3.82
2020,CB2020,081,4,Queens,40664023001,167,76,91,3.82
2020,CB2020,081,4,Queens,40664023002,252,118,134,4.11
2020,CB2020,081,4,Queens,40664023003,152,66,86,3.5
2020,CB2020,081,4,Queens,40664023004,58,21,37,1.87
2020,CB2020,081,4,Queens,40664023005,196,105,91,4.63
2020,CB2020,081,4,Queens,40664023006,252,108,144,4.14
2020,CB2020,081,4,Queens,40664023007,157,59,98,3.82
2020,CB2020,081,4,Queens,40664023008,119,51,68,3.8
2020,CB2020,081,4,Queens,40664031000,118,50,68,3.84
2020,CB2020,081,4,Queens,40664031001,228,100,128,3.82
2020,CB2020,081,4,Queens,40664031002,297,144,153,4.17
2020,CB2020,081,4,Queens,40664031003,212,91,121,4.01
2020,CB2020,081,4,Queens,40664031004,157,54,103,3.01
2020,CB2020,081,4,Queens,40664031005,25,6,19,4.2
2020,CB2020,081,4,Queens,40664031006,263,81,182,3.97
2020,CB2020,081,4,Queens,40664031007,162,91,71,3.83
2020,CB2020,081,4,Queens,40664032000,198,92,106,3.4
2020,CB2020,081,4,Queens,40664032001,0,0,0,0.63
2020,CB2020,081,4,Queens,40664032002,537,227,310,11.53
2020,CB2020,081,4,Queens,40664032003,0,0,0,0
2020,CB2020,081,4,Queens,40664032004,259,122,137,3.88
2020,CB2020,081,4,Queens,40664032005,75,25,50,2.8
2020,CB2020,081,4,Queens,40664032006,184,92,92,3.23
2020,CB2020,081,4,Queens,40664032007,255,121,134,3.53
2020,CB2020,081,4,Queens,40664032008,230,109,121,3.82
2020,CB2020,081,4,Queens,40664033000,298,128,170,4.76
2020,CB2020,081,4,Queens,40664033001,131,77,54,2.52
2020,CB2020,081,4,Queens,40664033002,148,84,64,2.78
2020,CB2020,081,4,Queens,40664033003,222,95,127,4.54
2020,CB2020,081,4,Queens,40664033004,175,76,99,3.01
2020,CB2020,081,4,Queens,40664033005,140,79,61,2.6
2020,CB2020,081,4,Queens,40664033006,166,79,87,2.71
2020,CB2020,081,4,Queens,40664033007,0,0,0,0
2020,CB2020,081,4,Queens,40664041000,0,0,0,227.76
2020,CB2020,081,4,Queens,40664041001,0,0,0,0
2020,CB2020,081,4,Queens,40664041002,0,0,0,7.63
2020,CB2020,081,4,Queens,40665011000,178,92,86,3.07
2020,CB2020,081,4,Queens,40665011001,142,96,46,2.94
2020,CB2020,081,4,Queens,40665011002,126,36,90,2.77
2020,CB2020,081,4,Queens,40665011003,122,62,60,2.54
2020,CB2020,081,4,Queens,40665011004,100,31,69,2.61
2020,CB2020,081,4,Queens,40665011005,105,42,63,2.77
2020,CB2020,081,4,Queens,40665011006,54,45,9,1.4
2020,CB2020,081,4,Queens,40665011007,130,68,62,2.78
2020,CB2020,081,4,Queens,40665012000,265,136,129,7.68
2020,CB2020,081,4,Queens,40665012001,163,88,75,5.16
2020,CB2020,081,4,Queens,40665012002,123,62,61,1.58
2020,CB2020,081,4,Queens,40665012003,139,79,60,2.55
2020,CB2020,081,4,Queens,40665012004,155,77,78,2.53
2020,CB2020,081,4,Queens,40665012005,133,39,94,2.66
2020,CB2020,081,4,Queens,40665013000,67,34,33,8.48
2020,CB2020,081,4,Queens,40665013001,315,129,186,4.78
2020,CB2020,081,4,Queens,40665013002,313,169,144,4.84
2020,CB2020,081,4,Queens,40665013003,312,162,150,5.01
2020,CB2020,081,4,Queens,40665014000,222,94,128,4.77
2020,CB2020,081,4,Queens,40665014001,201,86,115,4.06
2020,CB2020,081,4,Queens,40665014002,173,105,68,3.19
2020,CB2020,081,4,Queens,40665014003,0,0,0,1.19
2020,CB2020,081,4,Queens,40665014004,0,0,0,0.89
2020,CB2020,081,4,Queens,40665014005,0,0,0,0.74
2020,CB2020,081,4,Queens,40667011000,164,72,92,2.73
2020,CB2020,081,4,Queens,40667011001,174,102,72,2.77
2020,CB2020,081,4,Queens,40667011002,80,36,44,1.72
2020,CB2020,081,4,Queens,40667011003,82,43,39,1.63
2020,CB2020,081,4,Queens,40667011004,142,86,56,2.71
2020,CB2020,081,4,Queens,40667011005,64,36,28,1.79
2020,CB2020,081,4,Queens,40667011006,110,47,63,2.82
2020,CB2020,081,4,Queens,40667011007,126,49,77,2.9
2020,CB2020,081,4,Queens,40667011008,47,22,25,1.39
2020,CB2020,081,4,Queens,40667011009,114,47,67,2.34
2020,CB2020,081,4,Queens,40667011010,115,34,81,2.92
2020,CB2020,081,4,Queens,40667011011,94,58,36,1.87
2020,CB2020,081,4,Queens,40667011012,66,47,19,1.84
2020,CB2020,081,4,Queens,40667011013,86,32,54,2.17
2020,CB2020,081,4,Queens,40667011014,17,7,10,0.97
2020,CB2020,081,4,Queens,40667011015,71,23,48,1.26
2020,CB2020,081,4,Queens,40667012000,237,149,88,4.39
2020,CB2020,081,4,Queens,40667012001,257,124,133,4.43
2020,CB2020,081,4,Queens,40667012002,185,85,100,4.6
2020,CB2020,081,4,Queens,40667012003,196,89,107,5.14
2020,CB2020,081,4,Queens,40667012004,170,74,96,5.02
2020,CB2020,081,4,Queens,40667012005,192,72,120,5.02
2020,CB2020,081,4,Queens,40669001000,156,84,72,3.38
2020,CB2020,081,4,Queens,40669001001,116,52,64,2.2
2020,CB2020,081,4,Queens,40669001002,104,58,46,4.06
2020,CB2020,081,4,Queens,40669001003,142,46,96,3.75
2020,CB2020,081,4,Queens,40669001004,344,164,180,6.35
2020,CB2020,081,4,Queens,40669001005,129,69,60,2.98
2020,CB2020,081,4,Queens,40669002000,213,99,114,3.09
2020,CB2020,081,4,Queens,40669002001,175,94,81,3.68
2020,CB2020,081,4,Queens,40669002002,219,102,117,5.02
2020,CB2020,081,4,Queens,40669002003,104,48,56,2.25
2020,CB2020,081,4,Queens,40669002004,88,37,51,2.81
2020,CB2020,081,4,Queens,40671001000,46,34,12,1.74
2020,CB2020,081,4,Queens,40671001001,121,63,58,2.24
2020,CB2020,081,4,Queens,40671001002,134,63,71,2.77
2020,CB2020,081,4,Queens,40671001003,201,86,115,4.85
2020,CB2020,081,4,Queens,40671001004,208,108,100,4.87
2020,CB2020,081,4,Queens,40671001005,225,84,141,5.02
2020,CB2020,081,4,Queens,40671001006,222,118,104,4.88
2020,CB2020,081,4,Queens,40671002000,215,108,107,4.94
2020,CB2020,081,4,Queens,40671002001,168,73,95,3.53
2020,CB2020,081,4,Queens,40671002002,67,26,41,2.45
2020,CB2020,081,4,Queens,40671002003,72,29,43,2.58
2020,CB2020,081,4,Queens,40671002004,21,14,7,0.99
2020,CB2020,081,4,Queens,40671002005,131,69,62,4.26
2020,CB2020,081,4,Queens,40671002006,205,98,107,4.84
2020,CB2020,081,4,Queens,40671002007,0,0,0,0.42
2020,CB2020,081,4,Queens,40671002008,0,0,0,1.17
2020,CB2020,081,4,Queens,40671002009,212,124,88,5.05
2020,CB2020,081,4,Queens,40677001000,160,64,96,3.1
2020,CB2020,081,4,Queens,40677001001,146,78,68,3.11
2020,CB2020,081,4,Queens,40677001002,122,39,83,3.11
2020,CB2020,081,4,Queens,40677001003,108,29,79,2.89
2020,CB2020,081,4,Queens,40677001004,109,63,46,2.89
2020,CB2020,081,4,Queens,40677001005,102,73,29,2.92
2020,CB2020,081,4,Queens,40677001006,105,57,48,2.65
2020,CB2020,081,4,Queens,40677001007,50,27,23,1.88
2020,CB2020,081,4,Queens,40677002000,72,25,47,2.28
2020,CB2020,081,4,Queens,40677002001,82,23,59,2.44
2020,CB2020,081,4,Queens,40677002002,75,43,32,2.58
2020,CB2020,081,4,Queens,40677002003,81,41,40,2.09
2020,CB2020,081,4,Queens,40677002004,195,108,87,4.92
2020,CB2020,081,4,Queens,40677002005,15,7,8,0.98
2020,CB2020,081,4,Queens,40677002006,133,61,72,3.29
2020,CB2020,081,4,Queens,40677002007,155,83,72,2.74
2020,CB2020,081,4,Queens,40677002008,122,50,72,2.08
2020,CB2020,081,4,Queens,40679001000,8,7,1,3.95
2020,CB2020,081,4,Queens,40679001001,53,26,27,2.36
2020,CB2020,081,4,Queens,40679001002,68,29,39,1.96
2020,CB2020,081,4,Queens,40679001003,111,58,53,3.34
2020,CB2020,081,4,Queens,40679001004,184,90,94,2.74
2020,CB2020,081,4,Queens,40679002000,1712,746,966,11.26
2020,CB2020,081,4,Queens,40679002001,745,375,370,4.23
2020,CB2020,081,4,Queens,40679002002,139,67,72,2.73
2020,CB2020,081,4,Queens,40679003000,35,16,19,1.11
2020,CB2020,081,4,Queens,40679003001,76,36,40,1.41
2020,CB2020,081,4,Queens,40679003002,137,62,75,2.54
2020,CB2020,081,4,Queens,40679003003,51,31,20,1
2020,CB2020,081,4,Queens,40679003004,84,28,56,1.68
2020,CB2020,081,4,Queens,40679003005,208,111,97,4.73
2020,CB2020,081,4,Queens,40679003006,139,73,66,3.11
2020,CB2020,081,4,Queens,40679003007,137,68,69,2.78
2020,CB2020,081,4,Queens,40679003008,219,98,121,2.89
2020,CB2020,081,4,Queens,40679003009,90,40,50,2.96
2020,CB2020,081,4,Queens,40679003010,109,66,43,2.93
2020,CB2020,081,4,Queens,40679003011,92,54,38,2.98
2020,CB2020,081,4,Queens,40680001000,0,0,0,2.58
2020,CB2020,081,4,Queens,40680001001,0,0,0,0.5
2020,CB2020,081,4,Queens,40680001002,0,0,0,4.27
2020,CB2020,081,4,Queens,40680001003,0,0,0,4.03
2020,CB2020,081,4,Queens,40680001004,0,0,0,8.46
2020,CB2020,081,4,Queens,40680001005,0,0,0,3.67
2020,CB2020,081,4,Queens,40680001006,0,0,0,6.83
2020,CB2020,081,4,Queens,40680001007,0,0,0,0.41
2020,CB2020,081,4,Queens,40680001008,107,44,63,4.67
2020,CB2020,081,4,Queens,40680001009,59,38,21,1.98
2020,CB2020,081,4,Queens,40680001010,154,80,74,3.73
2020,CB2020,081,4,Queens,40680001011,209,100,109,5.42
2020,CB2020,081,4,Queens,40680001012,66,34,32,1.96
2020,CB2020,081,4,Queens,40680001013,53,36,17,1.28
2020,CB2020,081,4,Queens,40680001014,214,73,141,5.21
2020,CB2020,081,4,Queens,40680001015,148,70,78,4.75
2020,CB2020,081,4,Queens,40680002000,169,81,88,3.54
2020,CB2020,081,4,Queens,40680002001,137,54,83,2.53
2020,CB2020,081,4,Queens,40680002002,117,54,63,4.09
2020,CB2020,081,4,Queens,40680002003,162,88,74,3.94
2020,CB2020,081,4,Queens,40680002004,156,62,94,4.23
2020,CB2020,081,4,Queens,40680002005,157,86,71,4.4
2020,CB2020,081,4,Queens,40680002006,190,96,94,4.41
2020,CB2020,081,4,Queens,40680002007,151,64,87,4.09
2020,CB2020,081,4,Queens,40680002008,53,14,39,1.33
2020,CB2020,081,4,Queens,40680002009,0,0,0,0.25
2020,CB2020,081,4,Queens,40680002010,124,53,71,4.1
2020,CB2020,081,4,Queens,40680002011,122,63,59,4.23
2020,CB2020,081,4,Queens,40680003000,274,133,141,8.88
2020,CB2020,081,4,Queens,40680003001,68,30,38,2.8
2020,CB2020,081,4,Queens,40680003002,56,21,35,2.35
2020,CB2020,081,4,Queens,40680003003,52,13,39,2.11
2020,CB2020,081,4,Queens,40680003004,161,71,90,5.16
2020,CB2020,081,4,Queens,40680003005,178,83,95,3.8
2020,CB2020,081,4,Queens,40680003006,112,56,56,3.95
2020,CB2020,081,4,Queens,40680003007,125,64,61,3.94
2020,CB2020,081,4,Queens,40680003008,132,51,81,3.93
2020,CB2020,081,4,Queens,40680003009,102,42,60,4.24
2020,CB2020,081,4,Queens,40680003010,24,15,9,2.36
2020,CB2020,081,4,Queens,40680003011,146,57,89,2.47
2020,CB2020,081,4,Queens,40680003012,108,37,71,2.28
2020,CB2020,081,4,Queens,40680003013,122,63,59,2.28
2020,CB2020,081,4,Queens,40680004000,0,0,0,4.12
2020,CB2020,081,4,Queens,40680004001,0,0,0,3.16
2020,CB2020,081,4,Queens,40680004002,0,0,0,0.78
2020,CB2020,081,4,Queens,40680004003,0,0,0,1.77
2020,CB2020,081,4,Queens,40680004004,86,35,51,2.7
2020,CB2020,081,4,Queens,40680004005,119,49,70,3.64
2020,CB2020,081,4,Queens,40680004006,0,0,0,0.95
2020,CB2020,081,4,Queens,40680004007,0,0,0,0.61
2020,CB2020,081,4,Queens,40680004008,0,0,0,0.75
2020,CB2020,081,4,Queens,40680004009,119,55,64,2.3
2020,CB2020,081,4,Queens,40680004010,121,51,70,2.31
2020,CB2020,081,4,Queens,40680004011,38,12,26,1.42
2020,CB2020,081,4,Queens,40680004012,101,50,51,2.29
2020,CB2020,081,4,Queens,40680004013,162,82,80,3.84
2020,CB2020,081,4,Queens,40680004014,0,0,0,0.69
2020,CB2020,081,4,Queens,40680004015,177,85,92,3.76
2020,CB2020,081,4,Queens,40680004016,89,29,60,2.29
2020,CB2020,081,4,Queens,40682001000,130,49,81,5.69
2020,CB2020,081,4,Queens,40682001001,84,60,24,2.77
2020,CB2020,081,4,Queens,40682001002,206,79,127,6.9
2020,CB2020,081,4,Queens,40682001003,34,18,16,2.41
2020,CB2020,081,4,Queens,40682001004,146,69,77,3.5
2020,CB2020,081,4,Queens,40682001005,57,25,32,2.93
2020,CB2020,081,4,Queens,40682001006,28,13,15,0.59
2020,CB2020,081,4,Queens,40682001007,28,2,26,0.54
2020,CB2020,081,4,Queens,40682001008,25,25,0,0.69
2020,CB2020,081,4,Queens,40682001009,0,0,0,2.04
2020,CB2020,081,4,Queens,40682001010,7,4,3,3.78
2020,CB2020,081,4,Queens,40682001011,25,9,16,0.63
2020,CB2020,081,4,Queens,40682002000,47,18,29,9.07
2020,CB2020,081,4,Queens,40682002001,28,15,13,0.78
2020,CB2020,081,4,Queens,40682002002,53,16,37,1.3
2020,CB2020,081,4,Queens,40682002003,38,22,16,1.28
2020,CB2020,081,4,Queens,40682002004,84,27,57,2.18
2020,CB2020,081,4,Queens,40682002005,0,0,0,0.38
2020,CB2020,081,4,Queens,40682002006,22,17,5,1.84
2020,CB2020,081,4,Queens,40682002007,137,54,83,3.5
2020,CB2020,081,4,Queens,40682002008,13,5,8,1.36
2020,CB2020,081,4,Queens,40682002009,32,22,10,1.15
2020,CB2020,081,4,Queens,40682002010,38,10,28,1.56
2020,CB2020,081,4,Queens,40683001000,715,339,376,3
2020,CB2020,081,4,Queens,40683001001,665,306,359,4.99
2020,CB2020,081,4,Queens,40683001002,0,0,0,6.97
2020,CB2020,081,4,Queens,40683001003,365,167,198,3.32
2020,CB2020,081,4,Queens,40683001004,0,0,0,1.17
2020,CB2020,081,4,Queens,40683002000,470,242,228,3
2020,CB2020,081,4,Queens,40683002001,677,279,398,3
2020,CB2020,081,4,Queens,40683002002,0,0,0,7.96
2020,CB2020,081,4,Queens,40683002003,0,0,0,7.72
2020,CB2020,081,4,Queens,40683002004,0,0,0,0.53
2020,CB2020,081,4,Queens,40683002005,0,0,0,1.47
2020,CB2020,081,4,Queens,40683002006,0,0,0,1.77
2020,CB2020,081,4,Queens,40683003000,704,327,377,3.01
2020,CB2020,081,4,Queens,40683003001,0,0,0,9.14
2020,CB2020,081,4,Queens,40683003002,453,201,252,1.75
2020,CB2020,081,4,Queens,40683003003,3,3,0,1.6
2020,CB2020,081,4,Queens,40687001000,0,0,0,2.09
2020,CB2020,081,4,Queens,40687001001,890,411,479,3.94
2020,CB2020,081,4,Queens,40687001002,407,178,229,3.67
2020,CB2020,081,4,Queens,40687002000,298,160,138,3.46
2020,CB2020,081,4,Queens,40687002001,167,83,84,3.39
2020,CB2020,081,4,Queens,40687002002,209,80,129,4
2020,CB2020,081,4,Queens,40687002003,555,238,317,3.98
2020,CB2020,081,4,Queens,40687003000,0,0,0,1.21
2020,CB2020,081,4,Queens,40687003001,0,0,0,1.18
2020,CB2020,081,4,Queens,40687003002,18,12,6,0.73
2020,CB2020,081,4,Queens,40687003003,0,0,0,3.41
2020,CB2020,081,4,Queens,40687003004,0,0,0,0.76
2020,CB2020,081,4,Queens,40687003005,0,0,0,1.04
2020,CB2020,081,4,Queens,40687003006,0,0,0,1.4
2020,CB2020,081,4,Queens,40687003007,0,0,0,0.78
2020,CB2020,081,4,Queens,40687003008,199,96,103,2.83
2020,CB2020,081,4,Queens,40687003009,60,27,33,2.09
2020,CB2020,081,4,Queens,40687003010,30,13,17,0.84
2020,CB2020,081,4,Queens,40687003011,112,45,67,1.01
2020,CB2020,081,4,Queens,40687003012,236,104,132,4.6
2020,CB2020,081,4,Queens,40687003013,149,74,75,4.44
2020,CB2020,081,4,Queens,40687003014,147,70,77,5.68
2020,CB2020,081,4,Queens,40687003015,452,229,223,1.8
2020,CB2020,081,4,Queens,40687003016,63,15,48,3.99
2020,CB2020,081,4,Queens,40687003017,398,209,189,2.44
2020,CB2020,081,4,Queens,40687003018,207,120,87,4.07
2020,CB2020,081,4,Queens,40690001000,16,10,6,4.38
2020,CB2020,081,4,Queens,40690001001,22,16,6,4.49
2020,CB2020,081,4,Queens,40690001002,239,136,103,4.27
2020,CB2020,081,4,Queens,40690001003,219,114,105,4.31
2020,CB2020,081,4,Queens,40690001004,300,128,172,4.32
2020,CB2020,081,4,Queens,40690001005,173,73,100,4.3
2020,CB2020,081,4,Queens,40690001006,190,64,126,4.3
2020,CB2020,081,4,Queens,40690001007,235,121,114,4.29
2020,CB2020,081,4,Queens,40690001008,101,41,60,3.75
2020,CB2020,081,4,Queens,40690001009,48,9,39,1.9
2020,CB2020,081,4,Queens,40690001010,159,56,103,3.02
2020,CB2020,081,4,Queens,40690001011,222,88,134,4.1
2020,CB2020,081,4,Queens,40690002000,59,32,27,1.27
2020,CB2020,081,4,Queens,40690002001,86,25,61,2.87
2020,CB2020,081,4,Queens,40690002002,144,64,80,3.51
2020,CB2020,081,4,Queens,40690002003,172,80,92,4.03
2020,CB2020,081,4,Queens,40690002004,141,74,67,4.39
2020,CB2020,081,4,Queens,40690002005,227,99,128,4.91
2020,CB2020,081,4,Queens,40690002006,167,60,107,2.53
2020,CB2020,081,4,Queens,40690002007,178,85,93,2.76
2020,CB2020,081,4,Queens,40690002008,138,45,93,2.82
2020,CB2020,081,4,Queens,40690002009,168,95,73,2.96
2020,CB2020,081,4,Queens,40690002010,184,97,87,3.34
2020,CB2020,081,4,Queens,40690002011,199,88,111,3.79
2020,CB2020,081,4,Queens,40693001000,0,0,0,2.03
2020,CB2020,081,4,Queens,40693001001,0,0,0,2.23
2020,CB2020,081,4,Queens,40693001002,532,232,300,4.07
2020,CB2020,081,4,Queens,40693001003,298,155,143,3.85
2020,CB2020,081,4,Queens,40693001004,655,302,353,3.85
2020,CB2020,081,4,Queens,40693001005,218,101,117,4.09
2020,CB2020,081,4,Queens,40693002000,133,54,79,3.85
2020,CB2020,081,4,Queens,40693002001,244,118,126,4.07
2020,CB2020,081,4,Queens,40693002002,515,294,221,4.06
2020,CB2020,081,4,Queens,40693002003,292,125,167,3.22
2020,CB2020,081,4,Queens,40694001000,56,29,27,2.12
2020,CB2020,081,4,Queens,40694001001,118,51,67,2.9
2020,CB2020,081,4,Queens,40694001002,255,79,176,17.11
2020,CB2020,081,4,Queens,40694001003,83,47,36,1.27
2020,CB2020,081,4,Queens,40694001004,0,0,0,0
2020,CB2020,081,4,Queens,40694001005,39,19,20,19.92
2020,CB2020,081,4,Queens,40694001006,126,39,87,3.42
2020,CB2020,081,4,Queens,40694001007,102,39,63,2.55
2020,CB2020,081,4,Queens,40694001008,158,74,84,3.25
2020,CB2020,081,4,Queens,40694001009,115,58,57,3.38
2020,CB2020,081,4,Queens,40694001010,168,85,83,4.02
2020,CB2020,081,4,Queens,40694001011,219,120,99,4.69
2020,CB2020,081,4,Queens,40694001012,163,74,89,5.7
2020,CB2020,081,4,Queens,40694002000,379,152,227,8.67
2020,CB2020,081,4,Queens,40694002001,184,87,97,4.83
2020,CB2020,081,4,Queens,40694002002,172,95,77,4.28
2020,CB2020,081,4,Queens,40694002003,124,52,72,3.64
2020,CB2020,081,4,Queens,40694002004,141,51,90,3.14
2020,CB2020,081,4,Queens,40694002005,142,54,88,2.79
2020,CB2020,081,4,Queens,40694002006,123,38,85,2.63
2020,CB2020,081,4,Queens,40694002007,70,43,27,2.35
2020,CB2020,081,4,Queens,40694002008,138,76,62,3.41
2020,CB2020,081,4,Queens,40694002009,113,78,35,3.48
2020,CB2020,081,4,Queens,40694002010,136,72,64,4.08
2020,CB2020,081,4,Queens,40694002011,173,65,108,3.03
2020,CB2020,081,4,Queens,40694002012,0,0,0,2.76
2020,CB2020,081,4,Queens,40694002013,29,19,10,7.68
2020,CB2020,081,4,Queens,40694002014,78,27,51,1.39
2020,CB2020,081,4,Queens,40695001000,24,15,9,3.7
2020,CB2020,081,4,Queens,40695001001,94,59,35,3.83
2020,CB2020,081,4,Queens,40695001002,272,139,133,3.99
2020,CB2020,081,4,Queens,40695001003,383,171,212,4.01
2020,CB2020,081,4,Queens,40695001004,367,164,203,4
2020,CB2020,081,4,Queens,40695001005,129,76,53,4.25
2020,CB2020,081,4,Queens,40695001006,124,41,83,4.06
2020,CB2020,081,4,Queens,40695001007,0,0,0,1.13
2020,CB2020,081,4,Queens,40695001008,0,0,0,0.48
2020,CB2020,081,4,Queens,40695002000,222,107,115,3.54
2020,CB2020,081,4,Queens,40695002001,112,48,64,4.04
2020,CB2020,081,4,Queens,40695002002,336,168,168,6.53
2020,CB2020,081,4,Queens,40695002003,185,106,79,5.43
2020,CB2020,081,4,Queens,40695002004,203,104,99,3.71
2020,CB2020,081,4,Queens,40697011000,0,0,0,2.09
2020,CB2020,081,4,Queens,40697011001,654,311,343,3.92
2020,CB2020,081,4,Queens,40697011002,901,452,449,3.94
2020,CB2020,081,4,Queens,40697012000,834,375,459,3.94
2020,CB2020,081,4,Queens,40697012001,350,183,167,2.23
2020,CB2020,081,4,Queens,40697013000,879,396,483,4.45
2020,CB2020,081,4,Queens,40697013001,817,396,421,12.16
2020,CB2020,081,4,Queens,40697021000,290,149,141,8.08
2020,CB2020,081,4,Queens,40697021001,45,21,24,0.98
2020,CB2020,081,4,Queens,40697021002,91,38,53,3.21
2020,CB2020,081,4,Queens,40697021003,85,24,61,3.3
2020,CB2020,081,4,Queens,40697021004,36,23,13,0.94
2020,CB2020,081,4,Queens,40697021005,123,65,58,4.38
2020,CB2020,081,4,Queens,40697022000,113,53,60,3.94
2020,CB2020,081,4,Queens,40697022001,102,61,41,3.05
2020,CB2020,081,4,Queens,40697022002,50,31,19,2.15
2020,CB2020,081,4,Queens,40697022003,82,27,55,2.93
2020,CB2020,081,4,Queens,40697022004,93,65,28,3.45
2020,CB2020,081,4,Queens,40697022005,67,34,33,2.24
2020,CB2020,081,4,Queens,40697022006,114,49,65,3.15
2020,CB2020,081,4,Queens,40697022007,103,31,72,4.04
2020,CB2020,081,4,Queens,40697022008,0,0,0,4.78
2020,CB2020,081,4,Queens,40697023000,166,71,95,4.39
2020,CB2020,081,4,Queens,40697023001,490,214,276,5.06
2020,CB2020,081,4,Queens,40697023002,148,89,59,5.25
2020,CB2020,081,4,Queens,40697023003,123,59,64,3.61
2020,CB2020,081,4,Queens,40697023004,163,84,79,4.77
2020,CB2020,081,4,Queens,40697024000,510,247,263,5.17
2020,CB2020,081,4,Queens,40697024001,62,32,30,4.52
2020,CB2020,081,4,Queens,40697024002,196,108,88,6.1
2020,CB2020,081,4,Queens,40697024003,74,33,41,2.81
2020,CB2020,081,4,Queens,40697024004,78,24,54,2.21
2020,CB2020,081,4,Queens,40697024005,157,86,71,4.55
2020,CB2020,081,4,Queens,40697024006,225,110,115,5.97
2020,CB2020,081,4,Queens,40697024007,143,50,93,4.04
2020,CB2020,081,4,Queens,40703001000,190,89,101,3.86
2020,CB2020,081,4,Queens,40703001001,234,136,98,8.14
2020,CB2020,081,4,Queens,40703001002,183,99,84,3.44
2020,CB2020,081,4,Queens,40703001003,143,51,92,3.07
2020,CB2020,081,4,Queens,40703001004,129,58,71,3.57
2020,CB2020,081,4,Queens,40703001005,118,65,53,3.04
2020,CB2020,081,4,Queens,40703001006,134,47,87,2.68
2020,CB2020,081,4,Queens,40703002000,213,72,141,4.81
2020,CB2020,081,4,Queens,40703002001,120,67,53,3.84
2020,CB2020,081,4,Queens,40703002002,141,76,65,2.99
2020,CB2020,081,4,Queens,40703002003,111,63,48,2.47
2020,CB2020,081,4,Queens,40703002004,280,149,131,9.4
2020,CB2020,081,4,Queens,40703002005,89,58,31,2.48
2020,CB2020,081,4,Queens,40703002006,81,30,51,2.9
2020,CB2020,081,4,Queens,40703002007,0,0,0,0.72
2020,CB2020,081,4,Queens,40703002008,59,34,25,2.16
2020,CB2020,081,4,Queens,40707001000,135,74,61,3.94
2020,CB2020,081,4,Queens,40707001001,92,39,53,2.22
2020,CB2020,081,4,Queens,40707001002,145,66,79,4.24
2020,CB2020,081,4,Queens,40707001003,74,39,35,1.27
2020,CB2020,081,4,Queens,40707001004,138,54,84,3.92
2020,CB2020,081,4,Queens,40707001005,153,84,69,3.92
2020,CB2020,081,4,Queens,40707001006,0,0,0,0.35
2020,CB2020,081,4,Queens,40707002000,209,104,105,3.37
2020,CB2020,081,4,Queens,40707002001,231,99,132,4.18
2020,CB2020,081,4,Queens,40707002002,124,61,63,3.6
2020,CB2020,081,4,Queens,40707003000,164,95,69,3.94
2020,CB2020,081,4,Queens,40707003001,186,78,108,4.02
2020,CB2020,081,4,Queens,40707003002,162,85,77,3.95
2020,CB2020,081,4,Queens,40707003003,109,44,65,0.97
2020,CB2020,081,4,Queens,40707003004,148,50,98,3.12
2020,CB2020,081,4,Queens,40707003005,166,87,79,3.95
2020,CB2020,081,4,Queens,40707003006,190,107,83,3.94
2020,CB2020,081,4,Queens,40709001000,176,85,91,3.94
2020,CB2020,081,4,Queens,40709001001,194,91,103,4.41
2020,CB2020,081,4,Queens,40709001002,21,8,13,0.92
2020,CB2020,081,4,Queens,40709001003,289,105,184,3.15
2020,CB2020,081,4,Queens,40709001004,293,134,159,6.48
2020,CB2020,081,4,Queens,40709001005,47,19,28,1.58
2020,CB2020,081,4,Queens,40709001006,187,126,61,4.23
2020,CB2020,081,4,Queens,40709001007,170,91,79,3.94
2020,CB2020,081,4,Queens,40709002000,184,84,100,3.94
2020,CB2020,081,4,Queens,40709002001,157,80,77,4.07
2020,CB2020,081,4,Queens,40709002002,299,114,185,1.96
2020,CB2020,081,4,Queens,40709002003,169,88,81,4.64
2020,CB2020,081,4,Queens,40709002004,108,52,56,3.07
2020,CB2020,081,4,Queens,40709002005,165,102,63,3.98
2020,CB2020,081,4,Queens,40709002006,176,89,87,3.94
2020,CB2020,081,4,Queens,40711001000,467,203,264,4.53
2020,CB2020,081,4,Queens,40711001001,239,124,115,12.87
2020,CB2020,081,4,Queens,40711001002,58,30,28,1.26
2020,CB2020,081,4,Queens,40711001003,374,186,188,2.6
2020,CB2020,081,4,Queens,40711002000,25,16,9,8.84
2020,CB2020,081,4,Queens,40711002001,204,90,114,5.32
2020,CB2020,081,4,Queens,40711002002,467,218,249,5.21
2020,CB2020,081,4,Queens,40711002003,385,190,195,4.55
2020,CB2020,081,4,Queens,40711002004,311,159,152,3.46
2020,CB2020,081,4,Queens,40711002005,466,206,260,9.38
2020,CB2020,081,4,Queens,40711002006,383,164,219,3.49
2020,CB2020,081,4,Queens,40711003000,273,147,126,3.72
2020,CB2020,081,4,Queens,40711003001,237,114,123,4.28
2020,CB2020,081,4,Queens,40711003002,622,274,348,3.71
2020,CB2020,081,4,Queens,40711004000,8,6,2,3.67
2020,CB2020,081,4,Queens,40711004001,0,0,0,1.33
2020,CB2020,081,4,Queens,40711004002,272,124,148,4.1
2020,CB2020,081,4,Queens,40711004003,77,35,42,3.02
2020,CB2020,081,4,Queens,40711004004,0,0,0,2.81
2020,CB2020,081,4,Queens,40711004005,819,348,471,4.64
2020,CB2020,081,4,Queens,40713031000,960,451,509,4.8
2020,CB2020,081,4,Queens,40713031001,286,130,156,2.05
2020,CB2020,081,4,Queens,40713031002,0,0,0,0.29
2020,CB2020,081,4,Queens,40713031003,856,389,467,5.04
2020,CB2020,081,4,Queens,40713032000,748,337,411,4.65
2020,CB2020,081,4,Queens,40713032001,639,292,347,4.27
2020,CB2020,081,4,Queens,40713033000,636,310,326,4.29
2020,CB2020,081,4,Queens,40713033001,669,315,354,3.95
2020,CB2020,081,4,Queens,40713033002,262,103,159,3.43
2020,CB2020,081,4,Queens,40713033003,251,118,133,1.98
2020,CB2020,081,4,Queens,40713041000,847,398,449,4
2020,CB2020,081,4,Queens,40713041001,565,240,325,3.95
2020,CB2020,081,4,Queens,40713042000,460,225,235,2.35
2020,CB2020,081,4,Queens,40713042001,0,0,0,1.83
2020,CB2020,081,4,Queens,40713042002,1212,547,665,4.17
2020,CB2020,081,4,Queens,40713043000,477,206,271,3.86
2020,CB2020,081,4,Queens,40713043001,452,226,226,2.61
2020,CB2020,081,4,Queens,40713043002,0,0,0,1.2
2020,CB2020,081,4,Queens,40713044000,639,308,331,4.84
2020,CB2020,081,4,Queens,40713044001,790,367,423,4.99
2020,CB2020,081,4,Queens,40713044002,944,400,544,4.46
2020,CB2020,081,4,Queens,40713051000,419,199,220,4.12
2020,CB2020,081,4,Queens,40713051001,711,323,388,5.14
2020,CB2020,081,4,Queens,40713051002,0,0,0,4.11
2020,CB2020,081,4,Queens,40713052000,444,206,238,4.22
2020,CB2020,081,4,Queens,40713052001,926,398,528,6.23
2020,CB2020,081,4,Queens,40713053000,1712,826,886,5.99
2020,CB2020,081,4,Queens,40713054000,914,438,476,3.15
2020,CB2020,081,4,Queens,40713054001,0,0,0,0.4
2020,CB2020,081,4,Queens,40713061000,870,395,475,3.94
2020,CB2020,081,4,Queens,40713061001,837,385,452,3.94
2020,CB2020,081,4,Queens,40713062000,226,114,112,3.75
2020,CB2020,081,4,Queens,40713062001,381,189,192,4.14
2020,CB2020,081,4,Queens,40713062002,1597,708,889,7.69
2020,CB2020,081,4,Queens,40713063000,0,0,0,1.07
2020,CB2020,081,4,Queens,40713063001,266,117,149,3.37
2020,CB2020,081,4,Queens,40713063002,416,206,210,1.82
2020,CB2020,081,4,Queens,40713063003,589,253,336,3.05
2020,CB2020,081,4,Queens,40713064000,0,0,0,2.11
2020,CB2020,081,4,Queens,40713064001,0,0,0,2.11
2020,CB2020,081,4,Queens,40713064002,540,245,295,3.91
2020,CB2020,081,4,Queens,40713064003,459,236,223,3.92
2020,CB2020,081,4,Queens,40716001000,0,0,0,380.38
2020,CB2020,081,4,Queens,40716001001,1,1,0,2707.66
2020,CB2020,081,4,Queens,40716001002,0,0,0,1.13
2020,CB2020,081,4,Queens,40716001003,0,0,0,0
2020,CB2020,081,4,Queens,40716001004,0,0,0,2.01
2020,CB2020,081,4,Queens,40716001005,0,0,0,524.77
2020,CB2020,081,4,Queens,40716001006,0,0,0,0
2020,CB2020,081,4,Queens,40716001007,0,0,0,0
2020,CB2020,081,4,Queens,40716001008,0,0,0,1
2020,CB2020,081,4,Queens,40716001009,0,0,0,33.85
2020,CB2020,081,4,Queens,40716001010,0,0,0,1.69
2020,CB2020,081,4,Queens,40716001011,0,0,0,0
2020,CB2020,081,4,Queens,40716001012,0,0,0,118.95
2020,CB2020,081,4,Queens,40716001013,0,0,0,5.48
2020,CB2020,081,4,Queens,40716001014,0,0,0,9.67
2020,CB2020,081,4,Queens,40716001015,0,0,0,612.07
2020,CB2020,081,4,Queens,40716001016,0,0,0,8.41
2020,CB2020,081,4,Queens,40716001017,0,0,0,15.18
2020,CB2020,081,4,Queens,40716001018,0,0,0,0.52
2020,CB2020,081,4,Queens,40716001019,0,0,0,13.84
2020,CB2020,081,4,Queens,40716001020,0,0,0,3.65
2020,CB2020,081,4,Queens,40716001021,1,0,1,9.02
2020,CB2020,081,4,Queens,40716001022,0,0,0,4.98
2020,CB2020,081,4,Queens,40716001023,0,0,0,4.85
2020,CB2020,081,4,Queens,40716001024,0,0,0,18.34
2020,CB2020,081,4,Queens,40716001025,0,0,0,1
2020,CB2020,081,4,Queens,40716001026,0,0,0,5
2020,CB2020,081,4,Queens,40716001027,0,0,0,21.06
2020,CB2020,081,4,Queens,40716001028,0,0,0,6.66
2020,CB2020,081,4,Queens,40716001029,0,0,0,5.64
2020,CB2020,081,4,Queens,40716001030,0,0,0,7.16
2020,CB2020,081,4,Queens,40716001031,0,0,0,2.77
2020,CB2020,081,4,Queens,40717011000,1521,661,860,6.41
2020,CB2020,081,4,Queens,40717012000,254,130,124,3
2020,CB2020,081,4,Queens,40717012001,616,300,316,4
2020,CB2020,081,4,Queens,40717012002,32,14,18,1.72
2020,CB2020,081,4,Queens,40717012003,314,148,166,2.92
2020,CB2020,081,4,Queens,40717012004,0,0,0,1.67
2020,CB2020,081,4,Queens,40717013000,1382,623,759,6.78
2020,CB2020,081,4,Queens,40717013001,31,18,13,7.83
2020,CB2020,081,4,Queens,40717013002,0,0,0,2.97
2020,CB2020,081,4,Queens,40717014000,454,217,237,2.92
2020,CB2020,081,4,Queens,40717014001,221,116,105,2.74
2020,CB2020,081,4,Queens,40717014002,732,305,427,4.01
2020,CB2020,081,4,Queens,40717021000,2609,1184,1425,10.75
2020,CB2020,081,4,Queens,40717022000,0,0,0,1.77
2020,CB2020,081,4,Queens,40717022001,0,0,0,0.91
2020,CB2020,081,4,Queens,40717022002,0,0,0,0.89
2020,CB2020,081,4,Queens,40717022003,0,0,0,1.7
2020,CB2020,081,4,Queens,40717022004,0,0,0,1.43
2020,CB2020,081,4,Queens,40717022005,0,0,0,1.18
2020,CB2020,081,4,Queens,40717022006,0,0,0,1.51
2020,CB2020,081,4,Queens,40717022007,0,0,0,1.7
2020,CB2020,081,4,Queens,40717022008,0,0,0,1.36
2020,CB2020,081,4,Queens,40717022009,0,0,0,0.38
2020,CB2020,081,4,Queens,40717022010,1,0,1,0.36
2020,CB2020,081,4,Queens,40717022011,0,0,0,0.29
2020,CB2020,081,4,Queens,40717022012,8,4,4,10.59
2020,CB2020,081,4,Queens,40717022013,594,313,281,8.39
2020,CB2020,081,4,Queens,40717022014,1119,488,631,4.26
2020,CB2020,081,4,Queens,40717022015,0,0,0,4.26
2020,CB2020,081,4,Queens,40717022016,0,0,0,1.37
2020,CB2020,081,4,Queens,40717022017,329,135,194,2.99
2020,CB2020,081,4,Queens,40719001000,0,0,0,1.96
2020,CB2020,081,4,Queens,40719001001,0,0,0,2.01
2020,CB2020,081,4,Queens,40719001002,79,37,42,2.34
2020,CB2020,081,4,Queens,40719001003,665,312,353,3.98
2020,CB2020,081,4,Queens,40719001004,477,232,245,3.9
2020,CB2020,081,4,Queens,40719001005,0,0,0,2.76
2020,CB2020,081,4,Queens,40719002000,467,221,246,3.95
2020,CB2020,081,4,Queens,40719002001,170,88,82,3.93
2020,CB2020,081,4,Queens,40719002002,204,92,112,3.88
2020,CB2020,081,4,Queens,40719002003,198,103,95,3.89
2020,CB2020,081,4,Queens,40719002004,264,118,146,3.84
2020,CB2020,081,4,Queens,40719002005,363,205,158,4.56
2020,CB2020,081,4,Queens,40721001000,166,88,78,3.01
2020,CB2020,081,4,Queens,40721001001,1068,476,592,4.88
2020,CB2020,081,4,Queens,40721002000,0,0,0,3.12
2020,CB2020,081,4,Queens,40721002001,894,417,477,4.76
2020,CB2020,081,4,Queens,40721003000,558,269,289,3.15
2020,CB2020,081,4,Queens,40721003001,644,307,337,4.73
2020,CB2020,081,4,Queens,40721004000,27,15,12,3.15
2020,CB2020,081,4,Queens,40721004001,662,326,336,4.76
2020,CB2020,081,4,Queens,40721005000,463,181,282,3.08
2020,CB2020,081,4,Queens,40721005001,431,210,221,4.79
2020,CB2020,081,4,Queens,40721005002,127,77,50,2.67
2020,CB2020,081,4,Queens,40723001000,246,134,112,2.24
2020,CB2020,081,4,Queens,40723001001,27,10,17,14.78
2020,CB2020,081,4,Queens,40723001002,29,20,9,2.95
2020,CB2020,081,4,Queens,40723001003,78,24,54,4.95
2020,CB2020,081,4,Queens,40723002000,60,47,13,3.94
2020,CB2020,081,4,Queens,40723002001,80,18,62,3.93
2020,CB2020,081,4,Queens,40723002002,43,13,30,4.02
2020,CB2020,081,4,Queens,40723002003,90,51,39,3.97
2020,CB2020,081,4,Queens,40723002004,126,62,64,3.93
2020,CB2020,081,4,Queens,40723002005,110,59,51,3.94
2020,CB2020,081,4,Queens,40723002006,71,42,29,4
2020,CB2020,081,4,Queens,40723002007,91,42,49,4
2020,CB2020,081,4,Queens,40723002008,103,47,56,3.94
2020,CB2020,081,4,Queens,40723002009,77,43,34,3.94
2020,CB2020,081,4,Queens,40723002010,76,37,39,4
2020,CB2020,081,4,Queens,40723003000,0,0,0,2.18
2020,CB2020,081,4,Queens,40723003001,43,14,29,3.35
2020,CB2020,081,4,Queens,40723003002,44,27,17,4.02
2020,CB2020,081,4,Queens,40723003003,66,11,55,4.27
2020,CB2020,081,4,Queens,40723003004,9,5,4,1.6
2020,CB2020,081,4,Queens,40723003005,91,32,59,3.88
2020,CB2020,081,4,Queens,40723003006,91,55,36,4
2020,CB2020,081,4,Queens,40723003007,40,28,12,2.76
2020,CB2020,081,4,Queens,40723003008,15,4,11,1.1
2020,CB2020,081,4,Queens,40723003009,80,15,65,4
2020,CB2020,081,4,Queens,40723003010,93,56,37,3.99
2020,CB2020,081,4,Queens,40723003011,152,100,52,4
2020,CB2020,081,4,Queens,40723003012,80,59,21,4.02
2020,CB2020,081,4,Queens,40723003013,47,18,29,4.47
2020,CB2020,081,4,Queens,40729001000,62,32,30,3.98
2020,CB2020,081,4,Queens,40729001001,26,10,16,3.94
2020,CB2020,081,4,Queens,40729001002,133,66,67,3.95
2020,CB2020,081,4,Queens,40729001003,84,36,48,4.01
2020,CB2020,081,4,Queens,40729001004,175,92,83,4
2020,CB2020,081,4,Queens,40729001005,149,67,82,3.93
2020,CB2020,081,4,Queens,40729001006,143,73,70,3.99
2020,CB2020,081,4,Queens,40729002000,142,70,72,3.94
2020,CB2020,081,4,Queens,40729002001,147,68,79,3.92
2020,CB2020,081,4,Queens,40729002002,171,73,98,3.99
2020,CB2020,081,4,Queens,40729002003,101,62,39,2.87
2020,CB2020,081,4,Queens,40729002004,94,45,49,2.96
2020,CB2020,081,4,Queens,40729002005,63,44,19,2.4
2020,CB2020,081,4,Queens,40731001000,93,45,48,4.68
2020,CB2020,081,4,Queens,40731001001,112,49,63,3.84
2020,CB2020,081,4,Queens,40731001002,105,56,49,3.68
2020,CB2020,081,4,Queens,40731001003,133,74,59,4.56
2020,CB2020,081,4,Queens,40731001004,166,74,92,4
2020,CB2020,081,4,Queens,40731001005,152,71,81,4
2020,CB2020,081,4,Queens,40731002000,151,72,79,4.01
2020,CB2020,081,4,Queens,40731002001,145,56,89,4.01
2020,CB2020,081,4,Queens,40731002002,155,73,82,3.99
2020,CB2020,081,4,Queens,40731002003,79,30,49,3.21
2020,CB2020,081,4,Queens,40731002004,114,54,60,2.59
2020,CB2020,081,4,Queens,40731002005,145,88,57,4.34
2020,CB2020,081,4,Queens,40737001000,57,25,32,4
2020,CB2020,081,4,Queens,40737001001,401,195,206,3.61
2020,CB2020,081,4,Queens,40737001002,452,189,263,3.54
2020,CB2020,081,4,Queens,40737001003,9,5,4,3.73
2020,CB2020,081,4,Queens,40737002000,272,116,156,6.53
2020,CB2020,081,4,Queens,40737002001,10,6,4,2.57
2020,CB2020,081,4,Queens,40737002002,159,84,75,3.58
2020,CB2020,081,4,Queens,40737002003,198,88,110,2.35
2020,CB2020,081,4,Queens,40737002004,81,51,30,2.54
2020,CB2020,081,4,Queens,40737002005,0,0,0,0.51
2020,CB2020,081,4,Queens,40737002006,0,0,0,1.71
2020,CB2020,081,4,Queens,40737002007,47,28,19,3.25
2020,CB2020,081,4,Queens,40737002008,166,77,89,1.38
2020,CB2020,081,4,Queens,40737002009,157,80,77,3.63
2020,CB2020,081,4,Queens,40737002010,24,10,14,1.6
2020,CB2020,081,4,Queens,40737002011,155,53,102,2.26
2020,CB2020,081,4,Queens,40737002012,56,15,41,2.8
2020,CB2020,081,4,Queens,40737002013,33,22,11,2.46
2020,CB2020,081,4,Queens,40739001000,192,97,95,4
2020,CB2020,081,4,Queens,40739001001,489,243,246,3.17
2020,CB2020,081,4,Queens,40739001002,347,146,201,2.69
2020,CB2020,081,4,Queens,40739002000,157,87,70,3.99
2020,CB2020,081,4,Queens,40739002001,161,78,83,4.01
2020,CB2020,081,4,Queens,40739002002,492,201,291,2.45
2020,CB2020,081,4,Queens,40739003000,255,95,160,4
2020,CB2020,081,4,Queens,40739003001,432,213,219,2.89
2020,CB2020,081,4,Queens,40739003002,564,254,310,3.79
2020,CB2020,081,4,Queens,40739003003,150,49,101,4
2020,CB2020,081,4,Queens,40739004000,191,69,122,4
2020,CB2020,081,4,Queens,40739004001,600,275,325,4.57
2020,CB2020,081,4,Queens,40739004002,0,0,0,0.95
2020,CB2020,081,4,Queens,40739004003,404,165,239,2.76
2020,CB2020,081,4,Queens,40739005000,567,257,310,3.72
2020,CB2020,081,4,Queens,40739005001,356,159,197,2.73
2020,CB2020,081,4,Queens,40739005002,191,92,99,1.71
2020,CB2020,081,4,Queens,40741001000,117,59,58,3.87
2020,CB2020,081,4,Queens,40741001001,503,240,263,3.14
2020,CB2020,081,4,Queens,40741002000,72,30,42,3.56
2020,CB2020,081,4,Queens,40741002001,61,34,27,3.46
2020,CB2020,081,4,Queens,40741002002,494,224,270,3.21
2020,CB2020,081,4,Queens,40741002003,418,190,228,2.88
2020,CB2020,081,4,Queens,40741003000,70,23,47,3.92
2020,CB2020,081,4,Queens,40741003001,596,269,327,3.49
2020,CB2020,081,4,Queens,40741004000,83,25,58,4
2020,CB2020,081,4,Queens,40741004001,56,30,26,4
2020,CB2020,081,4,Queens,40741004002,102,65,37,3.46
2020,CB2020,081,4,Queens,40741004003,592,240,352,3.56
2020,CB2020,081,4,Queens,40743001000,236,116,120,4.16
2020,CB2020,081,4,Queens,40743001001,215,97,118,4
2020,CB2020,081,4,Queens,40743001002,198,88,110,4
2020,CB2020,081,4,Queens,40743002000,151,48,103,4.01
2020,CB2020,081,4,Queens,40743002001,432,228,204,4
2020,CB2020,081,4,Queens,40743002002,366,189,177,3.99
2020,CB2020,081,4,Queens,40743003000,507,248,259,3.94
2020,CB2020,081,4,Queens,40743003001,556,242,314,3.94
2020,CB2020,081,4,Queens,40743003002,510,234,276,3.84
2020,CB2020,081,4,Queens,40743004000,245,132,113,4.05
2020,CB2020,081,4,Queens,40743004001,642,294,348,3.94
2020,CB2020,081,4,Queens,40743004002,375,172,203,3.93
2020,CB2020,081,4,Queens,40745001000,0,0,0,1.68
2020,CB2020,081,4,Queens,40745001001,0,0,0,3.16
2020,CB2020,081,4,Queens,40745001002,771,314,457,10.82
2020,CB2020,081,4,Queens,40745001003,942,439,503,4.12
2020,CB2020,081,4,Queens,40745001004,451,211,240,4.16
2020,CB2020,081,4,Queens,40745002000,0,0,0,0.9
2020,CB2020,081,4,Queens,40745002001,0,0,0,1.62
2020,CB2020,081,4,Queens,40745002002,0,0,0,4.21
2020,CB2020,081,4,Queens,40745002003,0,0,0,0.3
2020,CB2020,081,4,Queens,40745002004,767,403,364,4.01
2020,CB2020,081,4,Queens,40745002005,97,41,56,1.36
2020,CB2020,081,4,Queens,40745002006,300,150,150,2.62
2020,CB2020,081,4,Queens,40745002007,331,136,195,3.9
2020,CB2020,081,4,Queens,40745002008,0,0,0,0.26
2020,CB2020,081,4,Queens,40747001000,920,437,483,8.54
2020,CB2020,081,4,Queens,40747001001,305,150,155,4.64
2020,CB2020,081,4,Queens,40747001002,276,125,151,4.48
2020,CB2020,081,4,Queens,40747001003,214,90,124,4.26
2020,CB2020,081,4,Queens,40747001004,259,127,132,4
2020,CB2020,081,4,Queens,40747001005,143,68,75,3.99
2020,CB2020,081,4,Queens,40747001006,202,114,88,4.05
2020,CB2020,081,4,Queens,40747002000,706,359,347,9.76
2020,CB2020,081,4,Queens,40747002001,0,0,0,12.25
2020,CB2020,081,4,Queens,40747002002,299,162,137,3.62
2020,CB2020,081,4,Queens,40747002003,84,35,49,4.09
2020,CB2020,081,4,Queens,40747002004,52,17,35,5.39
2020,CB2020,081,4,Queens,40747002005,79,36,43,3.95
2020,CB2020,081,4,Queens,40749001000,24,18,6,2.7
2020,CB2020,081,4,Queens,40749001001,0,0,0,1.59
2020,CB2020,081,4,Queens,40749001002,64,19,45,4.39
2020,CB2020,081,4,Queens,40749001003,68,31,37,3.03
2020,CB2020,081,4,Queens,40749001004,89,31,58,1.59
2020,CB2020,081,4,Queens,40749001005,71,27,44,3.63
2020,CB2020,081,4,Queens,40749001006,23,10,13,1.61
2020,CB2020,081,4,Queens,40749001007,49,8,41,2.27
2020,CB2020,081,4,Queens,40749001008,77,49,28,4.09
2020,CB2020,081,4,Queens,40749001009,60,35,25,4.28
2020,CB2020,081,4,Queens,40749001010,125,65,60,3.88
2020,CB2020,081,4,Queens,40749001011,113,70,43,4.01
2020,CB2020,081,4,Queens,40749002000,97,54,43,3.15
2020,CB2020,081,4,Queens,40749002001,42,12,30,2.91
2020,CB2020,081,4,Queens,40749002002,34,15,19,2.37
2020,CB2020,081,4,Queens,40749002003,32,17,15,2.94
2020,CB2020,081,4,Queens,40749002004,65,39,26,6.71
2020,CB2020,081,4,Queens,40749002005,65,34,31,3.58
2020,CB2020,081,4,Queens,40749002006,97,63,34,3.64
2020,CB2020,081,4,Queens,40749002007,37,20,17,1.97
2020,CB2020,081,4,Queens,40749002008,19,17,2,2.42
2020,CB2020,081,4,Queens,40749002009,22,12,10,3.83
2020,CB2020,081,4,Queens,40749002010,47,19,28,3.38
2020,CB2020,081,4,Queens,40749002011,58,32,26,3.58
2020,CB2020,081,4,Queens,40749002012,38,24,14,2.13
2020,CB2020,081,4,Queens,40749002013,0,0,0,0.3
2020,CB2020,081,4,Queens,40749002014,0,0,0,0.2
2020,CB2020,081,4,Queens,40749002015,58,5,53,3.6
2020,CB2020,081,4,Queens,40749002016,30,15,15,2.48
2020,CB2020,081,4,Queens,40749002017,59,23,36,2.5
2020,CB2020,081,4,Queens,40757011000,772,349,423,5.77
2020,CB2020,081,4,Queens,40757011001,519,264,255,4.46
2020,CB2020,081,4,Queens,40757011002,713,320,393,7.02
2020,CB2020,081,4,Queens,40757011003,0,0,0,0.56
2020,CB2020,081,4,Queens,40757012000,288,128,160,2.27
2020,CB2020,081,4,Queens,40757012001,542,233,309,4.53
2020,CB2020,081,4,Queens,40757012002,488,202,286,2.93
2020,CB2020,081,4,Queens,40757012003,208,84,124,1.9
2020,CB2020,081,4,Queens,40757013000,520,247,273,3.19
2020,CB2020,081,4,Queens,40757013001,299,156,143,3.14
2020,CB2020,081,4,Queens,40757013002,287,102,185,4.01
2020,CB2020,081,4,Queens,40757013003,307,147,160,4.03
2020,CB2020,081,4,Queens,40757013004,167,76,91,5.04
2020,CB2020,081,4,Queens,40757021000,766,346,420,3.93
2020,CB2020,081,4,Queens,40757021001,871,385,486,4.32
2020,CB2020,081,4,Queens,40757022000,57,17,40,3.2
2020,CB2020,081,4,Queens,40757022001,52,20,32,3.36
2020,CB2020,081,4,Queens,40757022002,88,27,61,3.94
2020,CB2020,081,4,Queens,40757022003,79,35,44,3.94
2020,CB2020,081,4,Queens,40757022004,70,55,15,3.94
2020,CB2020,081,4,Queens,40757022005,46,21,25,3.48
2020,CB2020,081,4,Queens,40757022006,83,42,41,3.5
2020,CB2020,081,4,Queens,40757022007,44,27,17,3.52
2020,CB2020,081,4,Queens,40757022008,62,17,45,3.94
2020,CB2020,081,4,Queens,40757022009,59,48,11,3.93
2020,CB2020,081,4,Queens,40757022010,67,35,32,3.94
2020,CB2020,081,4,Queens,40757022011,25,20,5,3.51
2020,CB2020,081,4,Queens,40757022012,604,271,333,15.28
2020,CB2020,081,4,Queens,40757022013,0,0,0,1.89
2020,CB2020,081,4,Queens,40757022014,134,81,53,1.77
2020,CB2020,081,4,Queens,40757022015,75,25,50,3.94
2020,CB2020,081,4,Queens,40757022016,79,37,42,3.94
2020,CB2020,081,4,Queens,40757023000,839,371,468,3.94
2020,CB2020,081,4,Queens,40757023001,971,451,520,3.95
2020,CB2020,081,4,Queens,40769011000,432,201,231,4.78
2020,CB2020,081,4,Queens,40769011001,244,100,144,2.7
2020,CB2020,081,4,Queens,40769011002,597,275,322,4.85
2020,CB2020,081,4,Queens,40769011003,832,393,439,11.1
2020,CB2020,081,4,Queens,40769011004,0,0,0,0.27
2020,CB2020,081,4,Queens,40769011005,0,0,0,0.27
2020,CB2020,081,4,Queens,40769012000,539,220,319,4.04
2020,CB2020,081,4,Queens,40769012001,663,319,344,4.24
2020,CB2020,081,4,Queens,40769012002,95,41,54,3.59
2020,CB2020,081,4,Queens,40769012003,263,126,137,4.38
2020,CB2020,081,4,Queens,40769012004,609,276,333,4.51
2020,CB2020,081,4,Queens,40769021000,652,265,387,4.55
2020,CB2020,081,4,Queens,40769021001,350,164,186,4.48
2020,CB2020,081,4,Queens,40769021002,39,27,12,4.03
2020,CB2020,081,4,Queens,40769021003,35,30,5,2.7
2020,CB2020,081,4,Queens,40769021004,73,35,38,2.75
2020,CB2020,081,4,Queens,40769021005,214,125,89,2.81
2020,CB2020,081,4,Queens,40769021006,0,0,0,2.21
2020,CB2020,081,4,Queens,40769021007,27,15,12,0.95
2020,CB2020,081,4,Queens,40769021008,0,0,0,0.54
2020,CB2020,081,4,Queens,40773001000,0,0,0,0.76
2020,CB2020,081,4,Queens,40773001001,0,0,0,0.54
2020,CB2020,081,4,Queens,40773001002,475,220,255,6.2
2020,CB2020,081,4,Queens,40773001003,129,58,71,4.73
2020,CB2020,081,4,Queens,40773001004,66,35,31,4.56
2020,CB2020,081,4,Queens,40773001005,40,23,17,2.92
2020,CB2020,081,4,Queens,40773001006,417,202,215,2.04
2020,CB2020,081,4,Queens,40773002000,0,0,0,0.4
2020,CB2020,081,4,Queens,40773002001,223,106,117,2.48
2020,CB2020,081,4,Queens,40773002002,269,130,139,3.16
2020,CB2020,081,4,Queens,40773002003,40,30,10,2.63
2020,CB2020,081,4,Queens,40773002004,39,27,12,3.08
2020,CB2020,081,4,Queens,40773003000,0,0,0,1.53
2020,CB2020,081,4,Queens,40773003001,0,0,0,0.36
2020,CB2020,081,4,Queens,40773003002,0,0,0,0.81
2020,CB2020,081,4,Queens,40773003003,0,0,0,7.58
2020,CB2020,081,4,Queens,40773003004,613,282,331,18.47
2020,CB2020,081,4,Queens,40773003005,0,0,0,0.91
2020,CB2020,081,4,Queens,40773003006,0,0,0,5.79
2020,CB2020,081,4,Queens,40775001000,84,45,39,2.42
2020,CB2020,081,4,Queens,40775001001,165,81,84,4.21
2020,CB2020,081,4,Queens,40775001002,558,290,268,6.46
2020,CB2020,081,4,Queens,40775002000,52,5,47,2.1
2020,CB2020,081,4,Queens,40775002001,69,25,44,4.2
2020,CB2020,081,4,Queens,40775002002,55,36,19,3.63
2020,CB2020,081,4,Queens,40775002003,205,125,80,5.89
2020,CB2020,081,4,Queens,40775002004,86,38,48,2.59
2020,CB2020,081,4,Queens,40775002005,128,67,61,1.87
2020,CB2020,081,4,Queens,40775002006,40,20,20,2.67
2020,CB2020,081,4,Queens,40775002007,40,9,31,2.4
2020,CB2020,081,4,Queens,40775002008,67,22,45,0.96
2020,CB2020,081,4,Queens,40775002009,0,0,0,0.53
2020,CB2020,081,4,Queens,40775003000,103,62,41,4.34
2020,CB2020,081,4,Queens,40775003001,187,87,100,3.85
2020,CB2020,081,4,Queens,40775003002,89,47,42,4.36
2020,CB2020,081,4,Queens,40775003003,313,136,177,4.23
2020,CB2020,081,4,Queens,40779021000,176,105,71,2.69
2020,CB2020,081,4,Queens,40779021001,203,108,95,3.01
2020,CB2020,081,4,Queens,40779021002,174,75,99,3.58
2020,CB2020,081,4,Queens,40779021003,211,89,122,3.53
2020,CB2020,081,4,Queens,40779021004,127,73,54,3.91
2020,CB2020,081,4,Queens,40779022000,181,101,80,5.63
2020,CB2020,081,4,Queens,40779022001,103,47,56,2.04
2020,CB2020,081,4,Queens,40779022002,145,71,74,3.92
2020,CB2020,081,4,Queens,40779022003,79,32,47,3.59
2020,CB2020,081,4,Queens,40779022004,72,28,44,3.22
2020,CB2020,081,4,Queens,40779022005,200,114,86,5.67
2020,CB2020,081,4,Queens,40779022006,87,29,58,4.32
2020,CB2020,081,4,Queens,40779022007,188,118,70,5.4
2020,CB2020,081,4,Queens,40779022008,491,245,246,12.31
2020,CB2020,081,4,Queens,40779022009,0,0,0,1.39
2020,CB2020,081,4,Queens,40779022010,14,8,6,1.23
2020,CB2020,081,4,Queens,40779023000,183,96,87,4.8
2020,CB2020,081,4,Queens,40779023001,280,152,128,6.52
2020,CB2020,081,4,Queens,40779023002,227,128,99,5.39
2020,CB2020,081,4,Queens,40779023003,263,120,143,9.34
2020,CB2020,081,4,Queens,40779023004,223,132,91,7.44
2020,CB2020,081,4,Queens,40779023005,209,91,118,8.27
2020,CB2020,081,4,Queens,40779024000,689,312,377,15.28
2020,CB2020,081,4,Queens,40779025000,379,169,210,6.4
2020,CB2020,081,4,Queens,40779025001,167,88,79,3.59
2020,CB2020,081,4,Queens,40779025002,345,185,160,5.69
2020,CB2020,081,4,Queens,40779031000,51,36,15,1.56
2020,CB2020,081,4,Queens,40779031001,20,13,7,2.41
2020,CB2020,081,4,Queens,40779031002,248,98,150,3.57
2020,CB2020,081,4,Queens,40779031003,440,201,239,3.88
2020,CB2020,081,4,Queens,40779032000,433,202,231,3.82
2020,CB2020,081,4,Queens,40779032001,0,0,0,5.12
2020,CB2020,081,4,Queens,40779032002,96,33,63,3.98
2020,CB2020,081,4,Queens,40779032003,80,43,37,3.7
2020,CB2020,081,4,Queens,40779032004,431,192,239,5.47
2020,CB2020,081,4,Queens,40779033000,141,96,45,2.97
2020,CB2020,081,4,Queens,40779033001,324,145,179,6.32
2020,CB2020,081,4,Queens,40779033002,414,185,229,10.14
2020,CB2020,081,4,Queens,40779033003,163,61,102,5.45
2020,CB2020,081,4,Queens,40779033004,0,0,0,1.04
2020,CB2020,081,4,Queens,40779033005,55,26,29,3
2020,CB2020,081,4,Queens,40779033006,41,25,16,2.76
2020,CB2020,081,4,Queens,40779041000,322,182,140,3.61
2020,CB2020,081,4,Queens,40779041001,194,103,91,4
2020,CB2020,081,4,Queens,40779041002,233,111,122,4.01
2020,CB2020,081,4,Queens,40779041003,171,68,103,3.48
2020,CB2020,081,4,Queens,40779041004,247,110,137,4
2020,CB2020,081,4,Queens,40779042000,195,85,110,3.35
2020,CB2020,081,4,Queens,40779042001,222,105,117,3.99
2020,CB2020,081,4,Queens,40779042002,370,170,200,4
2020,CB2020,081,4,Queens,40779042003,303,165,138,3.21
2020,CB2020,081,4,Queens,40779042004,628,283,345,4.12
2020,CB2020,081,4,Queens,40779042005,166,64,102,2.6
2020,CB2020,081,4,Queens,40779042006,147,90,57,2.34
2020,CB2020,081,4,Queens,40779042007,42,18,24,1.59
2020,CB2020,081,4,Queens,40779042008,0,0,0,0.83
2020,CB2020,081,4,Queens,40779043000,220,123,97,4.03
2020,CB2020,081,4,Queens,40779043001,449,222,227,4.02
2020,CB2020,081,4,Queens,40779043002,150,61,89,2.63
2020,CB2020,081,4,Queens,40779043003,290,146,144,3.82
2020,CB2020,081,4,Queens,40779043004,186,68,118,2.77
2020,CB2020,081,4,Queens,40779043005,271,112,159,3.64
2020,CB2020,081,4,Queens,40779043006,317,158,159,3.64
2020,CB2020,081,4,Queens,40779043007,0,0,0,0.34
2020,CB2020,081,4,Queens,40779043008,0,0,0,2.36
2020,CB2020,081,4,Queens,40779044000,290,154,136,4.04
2020,CB2020,081,4,Queens,40779044001,219,110,109,4.02
2020,CB2020,081,4,Queens,40779044002,184,94,90,4.04
2020,CB2020,081,4,Queens,40779044003,198,83,115,3.61
2020,CB2020,081,4,Queens,40779044004,155,74,81,3.61
2020,CB2020,081,4,Queens,40779044005,155,79,76,3.62
2020,CB2020,081,4,Queens,40779051000,407,169,238,8.61
2020,CB2020,081,4,Queens,40779051001,172,63,109,5.84
2020,CB2020,081,4,Queens,40779051002,269,144,125,7.49
2020,CB2020,081,4,Queens,40779051003,32,18,14,2.26
2020,CB2020,081,4,Queens,40779051004,181,91,90,3.19
2020,CB2020,081,4,Queens,40779051005,0,0,0,0.55
2020,CB2020,081,4,Queens,40779051006,61,33,28,4.31
2020,CB2020,081,4,Queens,40779051007,0,0,0,2.35
2020,CB2020,081,4,Queens,40779051008,45,20,25,2.05
2020,CB2020,081,4,Queens,40779051009,0,0,0,1.29
2020,CB2020,081,4,Queens,40779051010,140,86,54,5.91
2020,CB2020,081,4,Queens,40779051011,0,0,0,2.77
2020,CB2020,081,4,Queens,40779051012,488,236,252,9.91
2020,CB2020,081,4,Queens,40779052000,791,355,436,11.45
2020,CB2020,081,4,Queens,40779061000,677,309,368,15.41
2020,CB2020,081,4,Queens,40779061001,12,6,6,5.69
2020,CB2020,081,4,Queens,40779061002,1451,688,763,10.98
2020,CB2020,081,4,Queens,40779061003,7,1,6,0.88
2020,CB2020,081,4,Queens,40779062000,96,44,52,4.17
2020,CB2020,081,4,Queens,40779062001,162,99,63,3.52
2020,CB2020,081,4,Queens,40779062002,189,94,95,3.39
2020,CB2020,081,4,Queens,40779062003,119,55,64,3.74
2020,CB2020,081,4,Queens,40779062004,269,136,133,4.43
2020,CB2020,081,4,Queens,40779062005,256,112,144,3.92
2020,CB2020,081,4,Queens,40779062006,110,60,50,1.8
2020,CB2020,081,4,Queens,40779062007,52,36,16,1.26
2020,CB2020,081,4,Queens,40779062008,78,27,51,2.35
2020,CB2020,081,4,Queens,40779062009,0,0,0,0.44
2020,CB2020,081,4,Queens,40779062010,186,76,110,2.3
2020,CB2020,081,4,Queens,40779062011,261,125,136,4.02
2020,CB2020,081,4,Queens,40779062012,43,16,27,2.67
2020,CB2020,081,4,Queens,40779062013,0,0,0,0.46
2020,CB2020,081,4,Queens,40779071000,280,131,149,3.92
2020,CB2020,081,4,Queens,40779071001,279,110,169,4.05
2020,CB2020,081,4,Queens,40779071002,263,125,138,4
2020,CB2020,081,4,Queens,40779071003,172,54,118,2.71
2020,CB2020,081,4,Queens,40779071004,0,0,0,0.75
2020,CB2020,081,4,Queens,40779071005,0,0,0,0.26
2020,CB2020,081,4,Queens,40779071006,0,0,0,0.59
2020,CB2020,081,4,Queens,40779071007,196,78,118,3.04
2020,CB2020,081,4,Queens,40779071008,182,98,84,3.65
2020,CB2020,081,4,Queens,40779071009,153,70,83,3.7
2020,CB2020,081,4,Queens,40779071010,213,93,120,4.04
2020,CB2020,081,4,Queens,40779072000,278,133,145,4.03
2020,CB2020,081,4,Queens,40779072001,340,171,169,4.02
2020,CB2020,081,4,Queens,40779072002,202,89,113,3.57
2020,CB2020,081,4,Queens,40779072003,206,105,101,3.63
2020,CB2020,081,4,Queens,40779072004,208,102,106,2.94
2020,CB2020,081,4,Queens,40779072005,196,182,14,1.07
2020,CB2020,081,4,Queens,40779072006,181,91,90,3.6
2020,CB2020,081,4,Queens,40779081000,1269,623,646,12.68
2020,CB2020,081,4,Queens,40779081001,21,11,10,1.31
2020,CB2020,081,4,Queens,40779081002,372,163,209,3.97
2020,CB2020,081,4,Queens,40779081003,0,0,0,3.97
2020,CB2020,081,4,Queens,40779081004,129,121,8,4.06
2020,CB2020,081,4,Queens,40779081005,204,114,90,3.78
2020,CB2020,081,4,Queens,40779082000,369,163,206,4.06
2020,CB2020,081,4,Queens,40779082001,385,207,178,4.07
2020,CB2020,081,4,Queens,40779082002,372,164,208,3.98
2020,CB2020,081,4,Queens,40779082003,410,209,201,3.99
2020,CB2020,081,4,Queens,40779082004,307,155,152,3.68
2020,CB2020,081,4,Queens,40788001000,32,16,16,3.82
2020,CB2020,081,4,Queens,40788001001,170,78,92,3.63
2020,CB2020,081,4,Queens,40788001002,165,92,73,3.75
2020,CB2020,081,4,Queens,40788001003,188,106,82,3.52
2020,CB2020,081,4,Queens,40788001004,182,73,109,3.15
2020,CB2020,081,4,Queens,40788001005,168,63,105,3.16
2020,CB2020,081,4,Queens,40788001006,119,51,68,3.16
2020,CB2020,081,4,Queens,40788001007,134,71,63,3.39
2020,CB2020,081,4,Queens,40788002000,174,89,85,3.41
2020,CB2020,081,4,Queens,40788002001,139,64,75,3.23
2020,CB2020,081,4,Queens,40788002002,166,64,102,3.29
2020,CB2020,081,4,Queens,40788002003,132,73,59,3.29
2020,CB2020,081,4,Queens,40788002004,130,77,53,3.3
2020,CB2020,081,4,Queens,40788002005,103,43,60,3.48
2020,CB2020,081,4,Queens,40790001000,187,83,104,3.65
2020,CB2020,081,4,Queens,40790001001,221,88,133,3.64
2020,CB2020,081,4,Queens,40790001002,113,60,53,2.99
2020,CB2020,081,4,Queens,40790001003,154,80,74,3.26
2020,CB2020,081,4,Queens,40790001004,238,115,123,5.04
2020,CB2020,081,4,Queens,40790001005,187,91,96,3.74
2020,CB2020,081,4,Queens,40790001006,184,81,103,3.16
2020,CB2020,081,4,Queens,40790001007,119,60,59,1.9
2020,CB2020,081,4,Queens,40790002000,74,32,42,4.73
2020,CB2020,081,4,Queens,40790002001,160,83,77,3.55
2020,CB2020,081,4,Queens,40790002002,123,67,56,2.89
2020,CB2020,081,4,Queens,40790002003,0,0,0,2.84
2020,CB2020,081,4,Queens,40790002004,0,0,0,1.37
2020,CB2020,081,4,Queens,40790002005,123,78,45,2.59
2020,CB2020,081,4,Queens,40790002006,160,62,98,3.44
2020,CB2020,081,4,Queens,40790002007,165,77,88,3.51
2020,CB2020,081,4,Queens,40790002008,283,110,173,4.91
2020,CB2020,081,4,Queens,40790002009,198,85,113,3.7
2020,CB2020,081,4,Queens,40790002010,186,97,89,3.49
2020,CB2020,081,4,Queens,40792001000,173,80,93,3.31
2020,CB2020,081,4,Queens,40792001001,119,61,58,3.39
2020,CB2020,081,4,Queens,40792001002,114,34,80,3.45
2020,CB2020,081,4,Queens,40792001003,64,39,25,3.31
2020,CB2020,081,4,Queens,40792001004,106,30,76,3.09
2020,CB2020,081,4,Queens,40792001005,69,32,37,3.96
2020,CB2020,081,4,Queens,40792001006,92,44,48,2.6
2020,CB2020,081,4,Queens,40792001007,93,49,44,3.2
2020,CB2020,081,4,Queens,40792001008,172,85,87,3.37
2020,CB2020,081,4,Queens,40792001009,0,0,0,8.41
2020,CB2020,081,4,Queens,40792001010,0,0,0,0.38
2020,CB2020,081,4,Queens,40792002000,164,69,95,4.36
2020,CB2020,081,4,Queens,40792002001,387,176,211,7.73
2020,CB2020,081,4,Queens,40792002002,323,158,165,8.12
2020,CB2020,081,4,Queens,40792002003,0,0,0,2
2020,CB2020,081,4,Queens,40792002004,0,0,0,1.04
2020,CB2020,081,4,Queens,40792002005,0,0,0,1.07
2020,CB2020,081,4,Queens,40792002006,254,27,227,11.06
2020,CB2020,081,4,Queens,40792002007,134,67,67,3.56
2020,CB2020,081,4,Queens,40792002008,150,58,92,3.69
2020,CB2020,081,4,Queens,40792002009,40,24,16,2.29
2020,CB2020,081,4,Queens,40792002010,263,128,135,6.52
2020,CB2020,081,4,Queens,40793001000,1,1,0,215.99
2020,CB2020,081,4,Queens,40797011000,1216,538,678,6.6
2020,CB2020,081,4,Queens,40797012000,3309,1636,1673,4.76
2020,CB2020,081,4,Queens,40797013000,14,7,7,3.59
2020,CB2020,081,4,Queens,40797014000,2372,1103,1269,6.28
2020,CB2020,081,4,Queens,40797014001,340,158,182,3.14
2020,CB2020,081,4,Queens,40797014002,369,166,203,3.14
2020,CB2020,081,4,Queens,40797021000,1283,608,675,5.11
2020,CB2020,081,4,Queens,40797021001,377,190,187,4.42
2020,CB2020,081,4,Queens,40797021002,357,166,191,3.67
2020,CB2020,081,4,Queens,40797022000,1297,601,696,5.15
2020,CB2020,081,4,Queens,40797023000,19,8,11,39.17
2020,CB2020,081,4,Queens,40797024000,663,339,324,4.53
2020,CB2020,081,4,Queens,40797024001,737,353,384,5.66
2020,CB2020,081,4,Queens,40797024002,220,99,121,2.33
2020,CB2020,081,4,Queens,40797024003,49,31,18,0.5
2020,CB2020,081,4,Queens,40799001000,111,55,56,2.53
2020,CB2020,081,4,Queens,40799001001,229,129,100,3.04
2020,CB2020,081,4,Queens,40799001002,251,126,125,3.31
2020,CB2020,081,4,Queens,40799001003,129,61,68,3.73
2020,CB2020,081,4,Queens,40799001004,18,16,2,7.66
2020,CB2020,081,4,Queens,40799001005,240,127,113,4.08
2020,CB2020,081,4,Queens,40799001006,121,51,70,2.5
2020,CB2020,081,4,Queens,40799001007,18,9,9,3.23
2020,CB2020,081,4,Queens,40799001008,51,33,18,1.29
2020,CB2020,081,4,Queens,40799001009,106,61,45,2.05
2020,CB2020,081,4,Queens,40799001010,153,51,102,2.44
2020,CB2020,081,4,Queens,40799001011,145,70,75,3.02
2020,CB2020,081,4,Queens,40799002000,451,218,233,5.66
2020,CB2020,081,4,Queens,40799002001,232,115,117,3.91
2020,CB2020,081,4,Queens,40799002002,230,103,127,2.61
2020,CB2020,081,4,Queens,40799002003,180,80,100,2.81
2020,CB2020,081,4,Queens,40799002004,309,150,159,3.73
2020,CB2020,081,4,Queens,40799002005,243,112,131,3.35
2020,CB2020,081,4,Queens,40799002006,226,104,122,3.35
2020,CB2020,081,4,Queens,40799002007,183,105,78,3.34
2020,CB2020,081,4,Queens,40799002008,245,130,115,3.31
2020,CB2020,081,4,Queens,40803011000,69,25,44,1.12
2020,CB2020,081,4,Queens,40803011001,172,81,91,3.05
2020,CB2020,081,4,Queens,40803011002,224,105,119,2.54
2020,CB2020,081,4,Queens,40803011003,201,92,109,3.33
2020,CB2020,081,4,Queens,40803011004,274,159,115,3.35
2020,CB2020,081,4,Queens,40803011005,228,117,111,2.65
2020,CB2020,081,4,Queens,40803011006,334,165,169,3.03
2020,CB2020,081,4,Queens,40803011007,213,110,103,3.31
2020,CB2020,081,4,Queens,40803012000,450,221,229,6.48
2020,CB2020,081,4,Queens,40803012001,269,114,155,3.32
2020,CB2020,081,4,Queens,40803012002,213,92,121,3.47
2020,CB2020,081,4,Queens,40803012003,455,251,204,6.42
2020,CB2020,081,4,Queens,40803012004,247,137,110,4.13
2020,CB2020,081,4,Queens,40803012005,211,106,105,2.33
2020,CB2020,081,4,Queens,40803012006,0,0,0,2.72
2020,CB2020,081,4,Queens,40803013000,95,40,55,2.1
2020,CB2020,081,4,Queens,40803013001,203,108,95,2.81
2020,CB2020,081,4,Queens,40803013002,285,143,142,3.25
2020,CB2020,081,4,Queens,40803013003,81,57,24,3.31
2020,CB2020,081,4,Queens,40803013004,208,119,89,3.2
2020,CB2020,081,4,Queens,40803013005,186,84,102,3.16
2020,CB2020,081,4,Queens,40803013006,0,0,0,1.3
2020,CB2020,081,4,Queens,40803013007,0,0,0,0.51
2020,CB2020,081,4,Queens,40803013008,106,32,74,2.28
2020,CB2020,081,4,Queens,40803013009,104,26,78,2.03
2020,CB2020,081,4,Queens,40803013010,0,0,0,2.87
2020,CB2020,081,4,Queens,40803021000,0,0,0,1.18
2020,CB2020,081,4,Queens,40803021001,0,0,0,1.38
2020,CB2020,081,4,Queens,40803021002,0,0,0,2.53
2020,CB2020,081,4,Queens,40803021003,0,0,0,0.61
2020,CB2020,081,4,Queens,40803021004,31,24,7,0.58
2020,CB2020,081,4,Queens,40803021005,23,7,16,0.75
2020,CB2020,081,4,Queens,40803021006,38,32,6,0.85
2020,CB2020,081,4,Queens,40803021007,88,52,36,1.21
2020,CB2020,081,4,Queens,40803021008,0,0,0,4.42
2020,CB2020,081,4,Queens,40803021009,92,59,33,1.95
2020,CB2020,081,4,Queens,40803021010,168,63,105,4.41
2020,CB2020,081,4,Queens,40803021011,144,62,82,3.2
2020,CB2020,081,4,Queens,40803021012,88,58,30,1.95
2020,CB2020,081,4,Queens,40803021013,111,42,69,1.83
2020,CB2020,081,4,Queens,40803021014,156,72,84,3.22
2020,CB2020,081,4,Queens,40803021015,187,82,105,4.79
2020,CB2020,081,4,Queens,40803022000,210,101,109,5.25
2020,CB2020,081,4,Queens,40803022001,198,120,78,3.21
2020,CB2020,081,4,Queens,40803022002,57,30,27,1.73
2020,CB2020,081,4,Queens,40803022003,40,13,27,1.62
2020,CB2020,081,4,Queens,40803022004,111,57,54,3
2020,CB2020,081,4,Queens,40803022005,80,38,42,2.64
2020,CB2020,081,4,Queens,40803022006,153,96,57,3.99
2020,CB2020,081,4,Queens,40803022007,288,118,170,9.16
2020,CB2020,081,4,Queens,40803022008,102,43,59,3.57
2020,CB2020,081,4,Queens,40803022009,103,43,60,2.71
2020,CB2020,081,4,Queens,40803023000,0,0,0,0.95
2020,CB2020,081,4,Queens,40803023001,0,0,0,1.57
2020,CB2020,081,4,Queens,40803023002,0,0,0,4.13
2020,CB2020,081,4,Queens,40803023003,175,87,88,2.55
2020,CB2020,081,4,Queens,40803023004,72,41,31,1.44
2020,CB2020,081,4,Queens,40803023005,132,64,68,2.1
2020,CB2020,081,4,Queens,40803023006,117,48,69,1.89
2020,CB2020,081,4,Queens,40803023007,117,61,56,2.68
2020,CB2020,081,4,Queens,40803023008,108,46,62,1.57
2020,CB2020,081,4,Queens,40803023009,87,59,28,2.01
2020,CB2020,081,4,Queens,40803023010,129,63,66,2.24
2020,CB2020,081,4,Queens,40803023011,134,59,75,2.45
2020,CB2020,081,4,Queens,40803023012,274,138,136,3.41
2020,CB2020,081,4,Queens,40803023013,160,77,83,2.37
2020,CB2020,081,4,Queens,40803023014,0,0,0,2.01
2020,CB2020,081,4,Queens,40803023015,0,0,0,1.84
2020,CB2020,081,4,Queens,40803023016,0,0,0,1.46
2020,CB2020,081,4,Queens,40809001000,551,244,307,11.11
2020,CB2020,081,4,Queens,40809001001,603,278,325,11.64
2020,CB2020,081,4,Queens,40809001002,448,205,243,10.22
2020,CB2020,081,4,Queens,40809002000,163,65,98,3.32
2020,CB2020,081,4,Queens,40809002001,691,315,376,10.73
2020,CB2020,081,4,Queens,40809003000,134,51,83,4.87
2020,CB2020,081,4,Queens,40809003001,188,115,73,3.48
2020,CB2020,081,4,Queens,40809003002,228,99,129,3.41
2020,CB2020,081,4,Queens,40809003003,179,91,88,3.5
2020,CB2020,081,4,Queens,40809004000,241,127,114,4.97
2020,CB2020,081,4,Queens,40809004001,0,0,0,0.27
2020,CB2020,081,4,Queens,40809004002,8,2,6,0.26
2020,CB2020,081,4,Queens,40809004003,143,61,82,4.24
2020,CB2020,081,4,Queens,40809004004,191,85,106,3.83
2020,CB2020,081,4,Queens,40809004005,176,106,70,3.31
2020,CB2020,081,4,Queens,40809004006,236,121,115,3.55
2020,CB2020,081,4,Queens,40809004007,228,102,126,3.67
2020,CB2020,081,4,Queens,40809005000,436,189,247,9.44
2020,CB2020,081,4,Queens,40809005001,53,21,32,2.29
2020,CB2020,081,4,Queens,40809005002,57,30,27,2.3
2020,CB2020,081,4,Queens,40809005003,98,55,43,2.6
2020,CB2020,081,4,Queens,40809005004,127,69,58,3.99
2020,CB2020,081,4,Queens,40809006000,671,301,370,12.03
2020,CB2020,081,4,Queens,40809006001,575,250,325,13.06
2020,CB2020,081,4,Queens,40809007000,16,2,14,56.12
2020,CB2020,081,4,Queens,40809007001,453,175,278,2.64
2020,CB2020,081,4,Queens,40809007002,0,0,0,23.07
2020,CB2020,081,4,Queens,40809007003,24,18,6,22.05
2020,CB2020,081,4,Queens,40809007004,0,0,0,1.43
2020,CB2020,081,4,Queens,40809007005,28,14,14,0.34
2020,CB2020,081,4,Queens,40809007006,645,297,348,7.34
2020,CB2020,081,4,Queens,40809007007,0,0,0,1.74
2020,CB2020,081,4,Queens,40809007008,0,0,0,0.61
2020,CB2020,081,4,Queens,40814001000,8,2,6,4.91
2020,CB2020,081,4,Queens,40814001001,213,95,118,2.69
2020,CB2020,081,4,Queens,40814001002,231,133,98,4.58
2020,CB2020,081,4,Queens,40814001003,108,57,51,1.66
2020,CB2020,081,4,Queens,40814001004,134,80,54,2.55
2020,CB2020,081,4,Queens,40814001005,163,75,88,3.94
2020,CB2020,081,4,Queens,40814001006,207,94,113,4.77
2020,CB2020,081,4,Queens,40814001007,168,81,87,3.16
2020,CB2020,081,4,Queens,40814001008,155,71,84,2.88
2020,CB2020,081,4,Queens,40814001009,0,0,0,5.79
2020,CB2020,081,4,Queens,40814001010,116,43,73,2.39
2020,CB2020,081,4,Queens,40814001011,85,31,54,1.54
2020,CB2020,081,4,Queens,40814002000,248,133,115,4.84
2020,CB2020,081,4,Queens,40814002001,223,110,113,5
2020,CB2020,081,4,Queens,40814002002,349,172,177,5.71
2020,CB2020,081,4,Queens,40814002003,163,74,89,3.45
2020,CB2020,081,4,Queens,40814002004,206,92,114,3.79
2020,CB2020,081,4,Queens,40814002005,173,104,69,3.79
2020,CB2020,081,4,Queens,40814003000,164,67,97,3.68
2020,CB2020,081,4,Queens,40814003001,196,99,97,3.87
2020,CB2020,081,4,Queens,40814003002,131,70,61,3.15
2020,CB2020,081,4,Queens,40814003003,171,103,68,3.24
2020,CB2020,081,4,Queens,40814003004,172,85,87,3.75
2020,CB2020,081,4,Queens,40814003005,90,45,45,2.2
2020,CB2020,081,4,Queens,40814003006,130,68,62,2.28
2020,CB2020,081,4,Queens,40814003007,84,50,34,1.68
2020,CB2020,081,4,Queens,40818001000,304,142,162,6.37
2020,CB2020,081,4,Queens,40818001001,295,142,153,6.72
2020,CB2020,081,4,Queens,40818001002,217,111,106,4.12
2020,CB2020,081,4,Queens,40818001003,168,92,76,3.67
2020,CB2020,081,4,Queens,40818001004,169,81,88,3.49
2020,CB2020,081,4,Queens,40818001005,219,115,104,4.79
2020,CB2020,081,4,Queens,40818002000,204,104,100,3.28
2020,CB2020,081,4,Queens,40818002001,106,51,55,3.08
2020,CB2020,081,4,Queens,40818002002,167,92,75,3.41
2020,CB2020,081,4,Queens,40818002003,68,17,51,3.07
2020,CB2020,081,4,Queens,40818002004,128,69,59,3.59
2020,CB2020,081,4,Queens,40818002005,171,88,83,3.87
2020,CB2020,081,4,Queens,40818002006,191,89,102,3.88
2020,CB2020,081,4,Queens,40818002007,77,43,34,1.36
2020,CB2020,081,4,Queens,40818002008,25,16,9,6.42
2020,CB2020,081,4,Queens,40818003000,67,32,35,2.6
2020,CB2020,081,4,Queens,40818003001,143,65,78,2.95
2020,CB2020,081,4,Queens,40818003002,87,48,39,2.82
2020,CB2020,081,4,Queens,40818003003,148,70,78,2.59
2020,CB2020,081,4,Queens,40818003004,214,119,95,4.09
2020,CB2020,081,4,Queens,40818003005,219,111,108,4.52
2020,CB2020,081,4,Queens,40818003006,180,68,112,3.91
2020,CB2020,081,4,Queens,40818003007,186,85,101,4.03
2020,CB2020,081,4,Queens,40818003008,120,69,51,4.07
2020,CB2020,081,4,Queens,40837001000,185,107,78,3.24
2020,CB2020,081,4,Queens,40837001001,167,67,100,3.21
2020,CB2020,081,4,Queens,40837001002,87,38,49,3.66
2020,CB2020,081,4,Queens,40837001003,167,74,93,3.54
2020,CB2020,081,4,Queens,40837001004,224,126,98,3.5
2020,CB2020,081,4,Queens,40837001005,230,127,103,3.43
2020,CB2020,081,4,Queens,40837001006,194,117,77,3.26
2020,CB2020,081,4,Queens,40837001007,131,55,76,3.3
2020,CB2020,081,4,Queens,40837001008,113,58,55,2.45
2020,CB2020,081,4,Queens,40837001009,113,50,63,0.91
2020,CB2020,081,4,Queens,40837001010,0,0,0,1.96
2020,CB2020,081,4,Queens,40837001011,50,21,29,1.18
2020,CB2020,081,4,Queens,40837001012,138,35,103,2.18
2020,CB2020,081,4,Queens,40837001013,116,49,67,1.94
2020,CB2020,081,4,Queens,40837001014,169,89,80,3.64
2020,CB2020,081,4,Queens,40837001015,0,0,0,1.35
2020,CB2020,081,4,Queens,40837001016,119,62,57,1.93
2020,CB2020,081,4,Queens,40837002000,235,112,123,2.89
2020,CB2020,081,4,Queens,40837002001,139,79,60,3.22
2020,CB2020,081,4,Queens,40837002002,188,87,101,4.21
2020,CB2020,081,4,Queens,40837002003,130,69,61,3.79
2020,CB2020,081,4,Queens,40837002004,193,91,102,3.29
2020,CB2020,081,4,Queens,40837002005,169,72,97,3.14
2020,CB2020,081,4,Queens,40837003000,145,66,79,3.1
2020,CB2020,081,4,Queens,40837003001,238,130,108,3.76
2020,CB2020,081,4,Queens,40837003002,241,109,132,3.55
2020,CB2020,081,4,Queens,40837003003,162,55,107,3.49
2020,CB2020,081,4,Queens,40837003004,105,44,61,2.01
2020,CB2020,081,4,Queens,40837003005,92,45,47,1.72
2020,CB2020,081,4,Queens,40837003006,148,89,59,1.71
2020,CB2020,081,4,Queens,40837003007,120,68,52,1.98
2020,CB2020,081,4,Queens,40837003008,0,0,0,2.51
2020,CB2020,081,4,Queens,40837004000,1,1,0,42.23
2020,CB2020,081,4,Queens,40837005000,160,87,73,38.01
2020,CB2020,081,4,Queens,40837005001,245,130,115,2.58
2020,CB2020,081,4,Queens,40837005002,180,99,81,2.45
2020,CB2020,081,4,Queens,40837005003,13,5,8,2.03
2020,CB2020,081,4,Queens,40837005004,197,106,91,2.46
2020,CB2020,081,4,Queens,40837005005,280,108,172,4.35
2020,CB2020,081,4,Queens,40837005006,248,116,132,3.94
2020,CB2020,081,4,Queens,40837005007,202,99,103,2.83
2020,CB2020,081,4,Queens,40837005008,195,113,82,3.02
2020,CB2020,081,4,Queens,40838001000,194,100,94,4.05
2020,CB2020,081,4,Queens,40838001001,139,49,90,4.04
2020,CB2020,081,4,Queens,40838001002,183,106,77,4.06
2020,CB2020,081,4,Queens,40838001003,172,87,85,4.06
2020,CB2020,081,4,Queens,40838001004,220,122,98,4.05
2020,CB2020,081,4,Queens,40838001005,217,102,115,4.08
2020,CB2020,081,4,Queens,40838001006,204,88,116,4.07
2020,CB2020,081,4,Queens,40838001007,211,94,117,4.06
2020,CB2020,081,4,Queens,40838002000,160,90,70,4.05
2020,CB2020,081,4,Queens,40838002001,165,99,66,4.06
2020,CB2020,081,4,Queens,40838002002,137,77,60,4.06
2020,CB2020,081,4,Queens,40838002003,170,68,102,4.06
2020,CB2020,081,4,Queens,40838002004,156,79,77,4.06
2020,CB2020,081,4,Queens,40838002005,108,56,52,4.3
2020,CB2020,081,4,Queens,40838002006,179,65,114,4.07
2020,CB2020,081,4,Queens,40838002007,191,82,109,4.07
2020,CB2020,081,4,Queens,40838003000,193,103,90,5.19
2020,CB2020,081,4,Queens,40838003001,141,58,83,3.09
2020,CB2020,081,4,Queens,40838003002,147,81,66,4.22
2020,CB2020,081,4,Queens,40838003003,184,97,87,4.05
2020,CB2020,081,4,Queens,40838003004,189,84,105,4.06
2020,CB2020,081,4,Queens,40838003005,179,84,95,4.07
2020,CB2020,081,4,Queens,40838003006,184,100,84,4.05
2020,CB2020,081,4,Queens,40838003007,123,43,80,4.14
2020,CB2020,081,4,Queens,40838004000,145,61,84,4.05
2020,CB2020,081,4,Queens,40838004001,188,66,122,4.06
2020,CB2020,081,4,Queens,40838004002,237,147,90,4.06
2020,CB2020,081,4,Queens,40838004003,132,67,65,4.06
2020,CB2020,081,4,Queens,40838004004,187,81,106,4.06
2020,CB2020,081,4,Queens,40838004005,159,90,69,4.06
2020,CB2020,081,4,Queens,40840001000,180,103,77,5.85
2020,CB2020,081,4,Queens,40840001001,238,89,149,5.32
2020,CB2020,081,4,Queens,40840001002,260,122,138,5.35
2020,CB2020,081,4,Queens,40840001003,264,98,166,5.16
2020,CB2020,081,4,Queens,40840001004,156,96,60,4.06
2020,CB2020,081,4,Queens,40840001005,197,91,106,4.06
2020,CB2020,081,4,Queens,40840001006,187,106,81,4.07
2020,CB2020,081,4,Queens,40840001007,219,105,114,4.07
2020,CB2020,081,4,Queens,40840002000,249,116,133,4.99
2020,CB2020,081,4,Queens,40840002001,203,93,110,4.78
2020,CB2020,081,4,Queens,40840002002,224,92,132,9.09
2020,CB2020,081,4,Queens,40840002003,238,121,117,4.45
2020,CB2020,081,4,Queens,40840002004,225,100,125,4.52
2020,CB2020,081,4,Queens,40840002005,213,122,91,4.53
2020,CB2020,081,4,Queens,40840003000,245,125,120,4.27
2020,CB2020,081,4,Queens,40840003001,182,90,92,4.28
2020,CB2020,081,4,Queens,40840003002,260,134,126,4.24
2020,CB2020,081,4,Queens,40840003003,237,113,124,4.22
2020,CB2020,081,4,Queens,40840003004,276,120,156,4.17
2020,CB2020,081,4,Queens,40840004000,198,93,105,4.05
2020,CB2020,081,4,Queens,40840004001,221,90,131,4.06
2020,CB2020,081,4,Queens,40840004002,165,79,86,4.05
2020,CB2020,081,4,Queens,40840004003,247,112,135,4.06
2020,CB2020,081,4,Queens,40840004004,222,149,73,4.06
2020,CB2020,081,4,Queens,40840005000,174,83,91,4.07
2020,CB2020,081,4,Queens,40840005001,179,77,102,4.05
2020,CB2020,081,4,Queens,40840005002,206,95,111,4.06
2020,CB2020,081,4,Queens,40840005003,202,101,101,4.08
2020,CB2020,081,4,Queens,40840005004,174,92,82,3.31
2020,CB2020,081,4,Queens,40840005005,182,109,73,4.22
2020,CB2020,081,4,Queens,40840005006,181,78,103,4.24
2020,CB2020,081,4,Queens,40840005007,40,23,17,0.69
2020,CB2020,081,4,Queens,40845001000,2104,917,1187,9.06
2020,CB2020,081,4,Queens,40845002000,1886,904,982,7.58
2020,CB2020,081,4,Queens,40845003000,260,108,152,6.68
2020,CB2020,081,4,Queens,40845003001,199,97,102,3.6
2020,CB2020,081,4,Queens,40845003002,242,119,123,5.03
2020,CB2020,081,4,Queens,40845003003,280,153,127,4.41
2020,CB2020,081,4,Queens,40845003004,238,152,86,3.72
2020,CB2020,081,4,Queens,40845003005,129,72,57,3.03
2020,CB2020,081,4,Queens,40845003006,102,49,53,2.07
2020,CB2020,081,4,Queens,40845003007,76,36,40,1.43
2020,CB2020,081,4,Queens,40846011000,36,15,21,0.91
2020,CB2020,081,4,Queens,40846011001,38,20,18,1.92
2020,CB2020,081,4,Queens,40846011002,108,63,45,3.21
2020,CB2020,081,4,Queens,40846011003,192,114,78,4.03
2020,CB2020,081,4,Queens,40846011004,193,94,99,4.05
2020,CB2020,081,4,Queens,40846011005,157,69,88,4.06
2020,CB2020,081,4,Queens,40846011006,120,46,74,4.06
2020,CB2020,081,4,Queens,40846011007,167,90,77,4.06
2020,CB2020,081,4,Queens,40846011008,141,63,78,4.33
2020,CB2020,081,4,Queens,40846011009,52,27,25,1.87
2020,CB2020,081,4,Queens,40846011010,82,53,29,1.91
2020,CB2020,081,4,Queens,40846011011,71,37,34,2.02
2020,CB2020,081,4,Queens,40846011012,71,34,37,1.88
2020,CB2020,081,4,Queens,40846011013,61,28,33,1.39
2020,CB2020,081,4,Queens,40846011014,0,0,0,0.47
2020,CB2020,081,4,Queens,40846012000,138,60,78,4.1
2020,CB2020,081,4,Queens,40846012001,123,78,45,4.06
2020,CB2020,081,4,Queens,40846012002,182,70,112,4.06
2020,CB2020,081,4,Queens,40846012003,177,96,81,4.05
2020,CB2020,081,4,Queens,40846012004,150,67,83,4.06
2020,CB2020,081,4,Queens,40846012005,141,71,70,4.07
2020,CB2020,081,4,Queens,40846012006,150,65,85,3.84
2020,CB2020,081,4,Queens,40846012007,150,92,58,3.42
2020,CB2020,081,4,Queens,40846012008,121,42,79,3.05
2020,CB2020,081,4,Queens,40846012009,108,66,42,2.67
2020,CB2020,081,4,Queens,40846012010,49,35,14,2.28
2020,CB2020,081,4,Queens,40846012011,67,41,26,1.52
2020,CB2020,081,4,Queens,40846012012,0,0,0,0.46
2020,CB2020,081,4,Queens,40846021000,0,0,0,7.95
2020,CB2020,081,4,Queens,40846021001,0,0,0,14.74
2020,CB2020,081,4,Queens,40846021002,0,0,0,0.23
2020,CB2020,081,4,Queens,40846021003,0,0,0,3.58
2020,CB2020,081,4,Queens,40846021004,0,0,0,2.41
2020,CB2020,081,4,Queens,40846021005,16,8,8,5.62
2020,CB2020,081,4,Queens,40846021006,0,0,0,6.87
2020,CB2020,081,4,Queens,40846021007,0,0,0,3.13
2020,CB2020,081,4,Queens,40846021008,0,0,0,7.71
2020,CB2020,081,4,Queens,40846021009,52,22,30,2.41
2020,CB2020,081,4,Queens,40846021010,94,38,56,2.67
2020,CB2020,081,4,Queens,40846021011,60,36,24,2.06
2020,CB2020,081,4,Queens,40846021012,21,14,7,1.14
2020,CB2020,081,4,Queens,40846021013,47,22,25,1.23
2020,CB2020,081,4,Queens,40846021014,179,159,20,3.06
2020,CB2020,081,4,Queens,40846021015,390,181,209,8.14
2020,CB2020,081,4,Queens,40846021016,0,0,0,9.26
2020,CB2020,081,4,Queens,40846021017,80,56,24,1.9
2020,CB2020,081,4,Queens,40846021018,0,0,0,0.8
2020,CB2020,081,4,Queens,40846021019,0,0,0,3.35
2020,CB2020,081,4,Queens,40846021020,0,0,0,0.49
2020,CB2020,081,4,Queens,40846021021,34,9,25,24.81
2020,CB2020,081,4,Queens,40846021022,57,29,28,1.98
2020,CB2020,081,4,Queens,40846021023,96,50,46,3.63
2020,CB2020,081,4,Queens,40846021024,83,39,44,1.59
2020,CB2020,081,4,Queens,40846021025,51,16,35,1.62
2020,CB2020,081,4,Queens,40846021026,0,0,0,5
2020,CB2020,081,4,Queens,40846021027,0,0,0,8.62
2020,CB2020,081,4,Queens,40846021028,0,0,0,2.94
2020,CB2020,081,4,Queens,40846021029,32,18,14,21.33
2020,CB2020,081,4,Queens,40846021030,0,0,0,2.79
2020,CB2020,081,4,Queens,40846021031,0,0,0,7.41
2020,CB2020,081,4,Queens,40846021032,58,39,19,2.12
2020,CB2020,081,4,Queens,40846021033,91,50,41,2.27
2020,CB2020,081,4,Queens,40846021034,55,25,30,2.03
2020,CB2020,081,4,Queens,40846021035,0,0,0,0.24
2020,CB2020,081,4,Queens,40849011000,1930,958,972,7.11
2020,CB2020,081,4,Queens,40849011001,683,332,351,4.32
2020,CB2020,081,4,Queens,40849012000,47,37,10,22.57
2020,CB2020,081,4,Queens,40849012001,19,11,8,1.38
2020,CB2020,081,4,Queens,40849012002,12,4,8,1.84
2020,CB2020,081,4,Queens,40849012003,48,16,32,2.24
2020,CB2020,081,4,Queens,40849012004,123,72,51,2.54
2020,CB2020,081,4,Queens,40849012005,151,75,76,3.44
2020,CB2020,081,4,Queens,40849012006,0,0,0,4.97
2020,CB2020,081,4,Queens,40849021000,785,363,422,8.6
2020,CB2020,081,4,Queens,40849021001,1456,718,738,5.16
2020,CB2020,081,4,Queens,40849022000,1008,454,554,4.91
2020,CB2020,081,4,Queens,40849022001,1217,582,635,5.92
2020,CB2020,081,4,Queens,40853001000,31,15,16,6.84
2020,CB2020,081,4,Queens,40853001001,342,149,193,3.45
2020,CB2020,081,4,Queens,40853001002,676,311,365,6.81
2020,CB2020,081,4,Queens,40853001003,707,292,415,5.54
2020,CB2020,081,4,Queens,40853002000,240,113,127,4.02
2020,CB2020,081,4,Queens,40853002001,907,376,531,6.55
2020,CB2020,081,4,Queens,40853003000,1223,571,652,8.5
2020,CB2020,081,4,Queens,40853004000,1289,638,651,6.54
2020,CB2020,081,4,Queens,40855001000,789,381,408,4.14
2020,CB2020,081,4,Queens,40855001001,570,249,321,3.65
2020,CB2020,081,4,Queens,40855002000,865,373,492,2.59
2020,CB2020,081,4,Queens,40855002001,1489,686,803,5.27
2020,CB2020,081,4,Queens,40855003000,1634,767,867,5.36
2020,CB2020,081,4,Queens,40855004000,495,217,278,2.39
2020,CB2020,081,4,Queens,40855004001,1047,492,555,4.44
2020,CB2020,081,4,Queens,40855004002,0,0,0,4.4
2020,CB2020,081,4,Queens,40857001000,1923,896,1027,8.15
2020,CB2020,081,4,Queens,40857002000,477,235,242,5.75
2020,CB2020,081,4,Queens,40857002001,1101,512,589,6.99
2020,CB2020,081,4,Queens,40857003000,247,135,112,5.33
2020,CB2020,081,4,Queens,40857003001,1488,717,771,4.74
2020,CB2020,081,4,Queens,40857003002,534,262,272,1.8
2020,CB2020,081,4,Queens,40859001000,103,59,44,1.48
2020,CB2020,081,4,Queens,40859001001,96,30,66,1.64
2020,CB2020,081,4,Queens,40859001002,73,26,47,1.28
2020,CB2020,081,4,Queens,40859001003,1697,805,892,5.09
2020,CB2020,081,4,Queens,40859002000,112,45,67,2.72
2020,CB2020,081,4,Queens,40859002001,265,130,135,2.13
2020,CB2020,081,4,Queens,40859002002,1309,639,670,5.15
2020,CB2020,081,4,Queens,40859002003,210,110,100,4.62
2020,CB2020,081,4,Queens,40859003000,1193,559,634,4.63
2020,CB2020,081,4,Queens,40859003001,1104,508,596,7.39
2020,CB2020,081,4,Queens,40861001000,1441,669,772,11.76
2020,CB2020,081,4,Queens,40861002000,134,70,64,3.1
2020,CB2020,081,4,Queens,40861002001,144,66,78,2.43
2020,CB2020,081,4,Queens,40861002002,85,47,38,2.33
2020,CB2020,081,4,Queens,40861002003,14,5,9,5.89
2020,CB2020,081,4,Queens,40861002004,60,29,31,1.46
2020,CB2020,081,4,Queens,40861002005,0,0,0,0.51
2020,CB2020,081,4,Queens,40861002006,164,81,83,4.65
2020,CB2020,081,4,Queens,40861002007,408,196,212,4.65
2020,CB2020,081,4,Queens,40863001000,1621,784,837,6.37
2020,CB2020,081,4,Queens,40863002000,566,249,317,3.93
2020,CB2020,081,4,Queens,40863002001,804,348,456,5.79
2020,CB2020,081,4,Queens,40863003000,1554,711,843,4.13
2020,CB2020,081,4,Queens,40863004000,1806,833,973,7.69
2020,CB2020,081,4,Queens,40863004001,767,362,405,7.71
2020,CB2020,081,4,Queens,40864001000,367,215,152,216.93
2020,CB2020,081,4,Queens,40864001001,288,117,171,13.85
2020,CB2020,081,4,Queens,40864001002,342,175,167,3.53
2020,CB2020,081,4,Queens,40864001003,219,83,136,2.3
2020,CB2020,081,4,Queens,40864001004,430,235,195,4.24
2020,CB2020,081,4,Queens,40864001005,167,94,73,3.23
2020,CB2020,081,4,Queens,40864002000,142,100,42,2.92
2020,CB2020,081,4,Queens,40864002001,29,20,9,12.15
2020,CB2020,081,4,Queens,40864002002,396,155,241,6.59
2020,CB2020,081,4,Queens,40864002003,138,69,69,3.99
2020,CB2020,081,4,Queens,40864002004,67,31,36,1.1
2020,CB2020,081,4,Queens,40864002005,148,57,91,3.73
2020,CB2020,081,4,Queens,40864002006,134,83,51,2.37
2020,CB2020,081,4,Queens,40865001000,464,196,268,7.09
2020,CB2020,081,4,Queens,40865001001,1046,487,559,5.34
2020,CB2020,081,4,Queens,40865001002,962,439,523,6.92
2020,CB2020,081,4,Queens,40865002000,493,231,262,4.66
2020,CB2020,081,4,Queens,40865002001,1227,516,711,6.48
2020,CB2020,081,4,Queens,40865003000,0,0,0,0.94
2020,CB2020,081,4,Queens,40865003001,1032,493,539,7.66
2020,CB2020,081,4,Queens,40869001000,316,153,163,2.63
2020,CB2020,081,4,Queens,40869001001,401,180,221,2.13
2020,CB2020,081,4,Queens,40869001002,45,10,35,2.45
2020,CB2020,081,4,Queens,40869001003,54,37,17,3.24
2020,CB2020,081,4,Queens,40869001004,180,90,90,5.29
2020,CB2020,081,4,Queens,40869001005,21,12,9,3.69
2020,CB2020,081,4,Queens,40869001006,0,0,0,1.44
2020,CB2020,081,4,Queens,40869001007,0,0,0,0.61
2020,CB2020,081,4,Queens,40869001008,0,0,0,0.81
2020,CB2020,081,4,Queens,40869001009,0,0,0,0.71
2020,CB2020,081,4,Queens,40869001010,0,0,0,2.58
2020,CB2020,081,4,Queens,40869001011,604,262,342,12.72
2020,CB2020,081,4,Queens,40869001012,149,60,89,5.77
2020,CB2020,081,4,Queens,40869001013,0,0,0,0.47
2020,CB2020,081,4,Queens,40869001014,0,0,0,0.98
2020,CB2020,081,4,Queens,40869001015,0,0,0,1.04
2020,CB2020,081,4,Queens,40869001016,0,0,0,0.66
2020,CB2020,081,4,Queens,40869001017,17,12,5,2.5
2020,CB2020,081,4,Queens,40869001018,0,0,0,1.8
2020,CB2020,081,4,Queens,40869001019,170,83,87,3.9
2020,CB2020,081,4,Queens,40869002000,0,0,0,3.61
2020,CB2020,081,4,Queens,40869002001,0,0,0,19.47
2020,CB2020,081,4,Queens,40869002002,0,0,0,2.8
2020,CB2020,081,4,Queens,40869002003,0,0,0,4.61
2020,CB2020,081,4,Queens,40869002004,0,0,0,0.94
2020,CB2020,081,4,Queens,40869002005,0,0,0,2.22
2020,CB2020,081,4,Queens,40869002006,0,0,0,0.71
2020,CB2020,081,4,Queens,40869002007,0,0,0,0.33
2020,CB2020,081,4,Queens,40869002008,0,0,0,6.73
2020,CB2020,081,4,Queens,40869002009,0,0,0,4.85
2020,CB2020,081,4,Queens,40869002010,143,83,60,13.11
2020,CB2020,081,4,Queens,40869002011,0,0,0,2.52
2020,CB2020,081,4,Queens,40869002012,66,44,22,4.41
2020,CB2020,081,4,Queens,40869002013,28,13,15,8.44
2020,CB2020,081,4,Queens,40869002014,16,6,10,2.26
2020,CB2020,081,4,Queens,40869002015,133,60,73,6.62
2020,CB2020,081,4,Queens,40869002016,0,0,0,3.05
2020,CB2020,081,4,Queens,40869002017,0,0,0,4.99
2020,CB2020,081,4,Queens,40871001000,0,0,0,1.14
2020,CB2020,081,4,Queens,40871001001,2536,1264,1272,21.91
2020,CB2020,081,4,Queens,40871001002,0,0,0,0
2020,CB2020,081,4,Queens,40871002000,536,238,298,7.63
2020,CB2020,081,4,Queens,40871002001,14,7,7,2.62
2020,CB2020,081,4,Queens,40871002002,176,72,104,3.64
2020,CB2020,081,4,Queens,40871002003,26,9,17,5.87
2020,CB2020,081,4,Queens,40871002004,23,20,3,2.16
2020,CB2020,081,4,Queens,40871002005,1,0,1,2.75
2020,CB2020,081,4,Queens,40871002006,481,266,215,6.59
2020,CB2020,081,4,Queens,40871002007,20,2,18,19.83
2020,CB2020,081,4,Queens,40871002008,0,0,0,0.35
2020,CB2020,081,4,Queens,40871002009,0,0,0,0
2020,CB2020,081,4,Queens,40871002010,54,30,24,4.63
2020,CB2020,081,4,Queens,40871002011,22,21,1,3.45
2020,CB2020,081,4,Queens,40871002012,114,63,51,2.82
2020,CB2020,081,4,Queens,40871002013,923,397,526,9.62
2020,CB2020,081,4,Queens,40871002014,675,340,335,2.29
2020,CB2020,081,4,Queens,40871002015,735,324,411,3.19
2020,CB2020,081,4,Queens,40871002016,37,12,25,1.4
2020,CB2020,081,4,Queens,40884000001,0,0,0,0
2020,CB2020,081,4,Queens,40884000002,0,0,0,0
2020,CB2020,081,4,Queens,40884000003,0,0,0,0
2020,CB2020,081,4,Queens,40884001000,0,0,0,2.79
2020,CB2020,081,4,Queens,40884001001,0,0,0,8.61
2020,CB2020,081,4,Queens,40884001002,0,0,0,2.36
2020,CB2020,081,4,Queens,40884001003,0,0,0,1.1
2020,CB2020,081,4,Queens,40884001004,0,0,0,1.03
2020,CB2020,081,4,Queens,40884001005,0,0,0,0.87
2020,CB2020,081,4,Queens,40884001006,14,7,7,7.89
2020,CB2020,081,4,Queens,40884001007,0,0,0,0.87
2020,CB2020,081,4,Queens,40884001008,178,94,84,16.63
2020,CB2020,081,4,Queens,40884001009,0,0,0,3.53
2020,CB2020,081,4,Queens,40884001010,0,0,0,1.87
2020,CB2020,081,4,Queens,40884001011,0,0,0,0.59
2020,CB2020,081,4,Queens,40884001012,0,0,0,4.02
2020,CB2020,081,4,Queens,40884001013,166,81,85,4.03
2020,CB2020,081,4,Queens,40884001014,146,61,85,3.99
2020,CB2020,081,4,Queens,40884001015,172,87,85,4.04
2020,CB2020,081,4,Queens,40884001016,192,104,88,4.03
2020,CB2020,081,4,Queens,40884001017,84,29,55,2.92
2020,CB2020,081,4,Queens,40884001018,105,37,68,3.68
2020,CB2020,081,4,Queens,40884001019,89,32,57,2.9
2020,CB2020,081,4,Queens,40884001020,52,13,39,2.02
2020,CB2020,081,4,Queens,40884001021,0,0,0,0.49
2020,CB2020,081,4,Queens,40884002000,37,20,17,1.27
2020,CB2020,081,4,Queens,40884002001,78,15,63,2.58
2020,CB2020,081,4,Queens,40884002002,87,49,38,3.01
2020,CB2020,081,4,Queens,40884002003,44,23,21,7.19
2020,CB2020,081,4,Queens,40884002004,0,0,0,0.76
2020,CB2020,081,4,Queens,40884002005,0,0,0,0.74
2020,CB2020,081,4,Queens,40884002006,39,19,20,3.63
2020,CB2020,081,4,Queens,40884002007,63,33,30,3.13
2020,CB2020,081,4,Queens,40884002008,106,61,45,3.72
2020,CB2020,081,4,Queens,40884002009,128,48,80,3.71
2020,CB2020,081,4,Queens,40884002010,0,0,0,0.32
2020,CB2020,081,4,Queens,40884002011,20,9,11,0
2020,CB2020,081,4,Queens,40884003000,79,38,41,3.68
2020,CB2020,081,4,Queens,40884003001,83,47,36,3.71
2020,CB2020,081,4,Queens,40884003002,115,31,84,3.7
2020,CB2020,081,4,Queens,40884003003,62,39,23,1.85
2020,CB2020,081,4,Queens,40884003004,0,0,0,0
2020,CB2020,081,4,Queens,40884003005,45,34,11,2.08
2020,CB2020,081,4,Queens,40884003006,82,31,51,3.71
2020,CB2020,081,4,Queens,40884003007,103,43,60,3.7
2020,CB2020,081,4,Queens,40884003008,113,62,51,3.69
2020,CB2020,081,4,Queens,40884003009,83,31,52,3.71
2020,CB2020,081,4,Queens,40884003010,117,58,59,3.69
2020,CB2020,081,4,Queens,40884003011,93,57,36,3.71
2020,CB2020,081,4,Queens,40884003012,31,7,24,2.35
2020,CB2020,081,4,Queens,40884004000,0,0,0,0
2020,CB2020,081,4,Queens,40884004001,51,43,8,1.74
2020,CB2020,081,4,Queens,40884004002,76,31,45,3.7
2020,CB2020,081,4,Queens,40884004003,93,49,44,3.71
2020,CB2020,081,4,Queens,40884004004,81,42,39,3.67
2020,CB2020,081,4,Queens,40884004005,76,23,53,3.7
2020,CB2020,081,4,Queens,40884004006,95,50,45,4.48
2020,CB2020,081,4,Queens,40884004007,0,0,0,0
2020,CB2020,081,4,Queens,40884004008,78,48,30,3.71
2020,CB2020,081,4,Queens,40884004009,99,64,35,3.68
2020,CB2020,081,4,Queens,40884004010,112,38,74,3.71
2020,CB2020,081,4,Queens,40884004011,84,29,55,3.7
2020,CB2020,081,4,Queens,40884004012,59,32,27,1.85
2020,CB2020,081,4,Queens,40884005000,77,45,32,1.92
2020,CB2020,081,4,Queens,40884005001,75,17,58,3.7
2020,CB2020,081,4,Queens,40884005002,110,75,35,3.69
2020,CB2020,081,4,Queens,40884005003,105,48,57,3.69
2020,CB2020,081,4,Queens,40884005004,89,37,52,3.7
2020,CB2020,081,4,Queens,40884005005,56,29,27,2.08
2020,CB2020,081,4,Queens,40884005006,93,60,33,2.1
2020,CB2020,081,4,Queens,40884005007,120,66,54,3.67
2020,CB2020,081,4,Queens,40884005008,137,47,90,3.71
2020,CB2020,081,4,Queens,40884005009,114,47,67,3.69
2020,CB2020,081,4,Queens,40884005010,121,60,61,3.71
2020,CB2020,081,4,Queens,40884005011,56,11,45,2.04
2020,CB2020,081,4,Queens,40884005012,0,0,0,17.15
2020,CB2020,081,4,Queens,40884006000,265,132,133,25.75
2020,CB2020,081,4,Queens,40884006001,99,30,69,3.9
2020,CB2020,081,4,Queens,40884006002,0,0,0,0.57
2020,CB2020,081,4,Queens,40884006003,97,59,38,3.34
2020,CB2020,081,4,Queens,40884006004,157,64,93,4.12
2020,CB2020,081,4,Queens,40884006005,106,67,39,3.97
2020,CB2020,081,4,Queens,40884006006,79,44,35,3.82
2020,CB2020,081,4,Queens,40884006007,62,38,24,11.58
2020,CB2020,081,4,Queens,40884006008,177,101,76,13.3
2020,CB2020,081,4,Queens,40884006009,69,30,39,3.62
2020,CB2020,081,4,Queens,40884006010,220,108,112,3.55
2020,CB2020,081,4,Queens,40884006011,0,0,0,4.13
2020,CB2020,081,4,Queens,40884007000,98,35,63,3.71
2020,CB2020,081,4,Queens,40884007001,72,48,24,3.7
2020,CB2020,081,4,Queens,40884007002,105,38,67,3.71
2020,CB2020,081,4,Queens,40884007003,92,46,46,3.7
2020,CB2020,081,4,Queens,40884007004,96,43,53,3.7
2020,CB2020,081,4,Queens,40884007005,42,20,22,2.01
2020,CB2020,081,4,Queens,40884007006,20,16,4,0.65
2020,CB2020,081,4,Queens,40884007007,21,6,15,0.68
2020,CB2020,081,4,Queens,40884007008,0,0,0,0
2020,CB2020,081,4,Queens,40884008000,67,28,39,4.87
2020,CB2020,081,4,Queens,40884008001,90,23,67,3.03
2020,CB2020,081,4,Queens,40884008002,100,47,53,3.74
2020,CB2020,081,4,Queens,40884008003,92,29,63,3.68
2020,CB2020,081,4,Queens,40884008004,108,50,58,3.71
2020,CB2020,081,4,Queens,40884008005,113,70,43,3.66
2020,CB2020,081,4,Queens,40884008006,24,16,8,3.7
2020,CB2020,081,4,Queens,40884008007,81,56,25,3.7
2020,CB2020,081,4,Queens,40884008008,4,2,2,3.69
2020,CB2020,081,4,Queens,40884008009,119,62,57,3.72
2020,CB2020,081,4,Queens,40884008010,40,20,20,1.55
2020,CB2020,081,4,Queens,40889021000,0,0,0,0.93
2020,CB2020,081,4,Queens,40889021001,595,289,306,8.36
2020,CB2020,081,4,Queens,40889021002,658,330,328,4.38
2020,CB2020,081,4,Queens,40889021003,365,167,198,3.84
2020,CB2020,081,4,Queens,40889022000,0,0,0,4.26
2020,CB2020,081,4,Queens,40889022001,615,278,337,4.84
2020,CB2020,081,4,Queens,40889022002,569,263,306,4.94
2020,CB2020,081,4,Queens,40889022003,254,124,130,3.5
2020,CB2020,081,4,Queens,40889022004,484,228,256,4.78
2020,CB2020,081,4,Queens,40889023000,14,6,8,9.5
2020,CB2020,081,4,Queens,40889023001,453,219,234,3.2
2020,CB2020,081,4,Queens,40889023002,1076,479,597,6.49
2020,CB2020,081,4,Queens,40889023003,311,135,176,3.24
2020,CB2020,081,4,Queens,40889024000,510,223,287,3.33
2020,CB2020,081,4,Queens,40889024001,516,260,256,2.67
2020,CB2020,081,4,Queens,40889024002,595,257,338,2.98
2020,CB2020,081,4,Queens,40889031000,319,142,177,5.74
2020,CB2020,081,4,Queens,40889031001,0,0,0,1.57
2020,CB2020,081,4,Queens,40889031002,0,0,0,1.48
2020,CB2020,081,4,Queens,40889031003,0,0,0,3.65
2020,CB2020,081,4,Queens,40889031004,0,0,0,2.6
2020,CB2020,081,4,Queens,40889031005,72,33,39,1.39
2020,CB2020,081,4,Queens,40889031006,200,106,94,4.99
2020,CB2020,081,4,Queens,40889031007,164,89,75,3.82
2020,CB2020,081,4,Queens,40889031008,93,44,49,1.8
2020,CB2020,081,4,Queens,40889031009,79,41,38,1.74
2020,CB2020,081,4,Queens,40889031010,37,8,29,3.24
2020,CB2020,081,4,Queens,40889031011,103,37,66,1.56
2020,CB2020,081,4,Queens,40889031012,41,19,22,1.18
2020,CB2020,081,4,Queens,40889031013,300,162,138,4.67
2020,CB2020,081,4,Queens,40889031014,120,49,71,3.39
2020,CB2020,081,4,Queens,40889032000,1063,461,602,12.65
2020,CB2020,081,4,Queens,40889032001,0,0,0,1.13
2020,CB2020,081,4,Queens,40889032002,0,0,0,1.2
2020,CB2020,081,4,Queens,40889032003,0,0,0,1.32
2020,CB2020,081,4,Queens,40889032004,0,0,0,2.02
2020,CB2020,081,4,Queens,40889032005,576,285,291,8.01
2020,CB2020,081,4,Queens,40889033000,903,409,494,13.82
2020,CB2020,081,4,Queens,40889033001,417,202,215,5.76
2020,CB2020,081,4,Queens,40889033002,0,0,0,1.15
2020,CB2020,081,4,Queens,40889033003,0,0,0,1.31
2020,CB2020,081,4,Queens,40892011000,55,35,20,3.4
2020,CB2020,081,4,Queens,40892011001,52,24,28,2.77
2020,CB2020,081,4,Queens,40892011002,0,0,0,2.97
2020,CB2020,081,4,Queens,40892011003,0,0,0,3.78
2020,CB2020,081,4,Queens,40892011004,64,26,38,3.68
2020,CB2020,081,4,Queens,40892011005,66,28,38,3.72
2020,CB2020,081,4,Queens,40892011006,66,37,29,3.83
2020,CB2020,081,4,Queens,40892011007,53,27,26,3.85
2020,CB2020,081,4,Queens,40892011008,64,26,38,3.67
2020,CB2020,081,4,Queens,40892011009,74,40,34,3.69
2020,CB2020,081,4,Queens,40892011010,62,31,31,3.85
2020,CB2020,081,4,Queens,40892011011,66,39,27,3.84
2020,CB2020,081,4,Queens,40892011012,74,29,45,3.72
2020,CB2020,081,4,Queens,40892011013,57,25,32,3.68
2020,CB2020,081,4,Queens,40892012000,93,43,50,16.48
2020,CB2020,081,4,Queens,40892012001,53,28,25,3.71
2020,CB2020,081,4,Queens,40892012002,0,0,0,3.55
2020,CB2020,081,4,Queens,40892012003,30,17,13,3.53
2020,CB2020,081,4,Queens,40892012004,73,35,38,3.7
2020,CB2020,081,4,Queens,40892012005,73,44,29,3.7
2020,CB2020,081,4,Queens,40892012006,67,32,35,3.71
2020,CB2020,081,4,Queens,40892012007,45,8,37,3.69
2020,CB2020,081,4,Queens,40892012008,48,14,34,3.65
2020,CB2020,081,4,Queens,40892012009,69,33,36,3.58
2020,CB2020,081,4,Queens,40892012010,78,35,43,3.72
2020,CB2020,081,4,Queens,40892012011,85,39,46,3.7
2020,CB2020,081,4,Queens,40892012012,57,31,26,3.71
2020,CB2020,081,4,Queens,40892012013,66,45,21,3.71
2020,CB2020,081,4,Queens,40892012014,80,28,52,3.7
2020,CB2020,081,4,Queens,40892012015,69,32,37,3.71
2020,CB2020,081,4,Queens,40892012016,52,32,20,3.53
2020,CB2020,081,4,Queens,40892012017,0,0,0,1.62
2020,CB2020,081,4,Queens,40892012018,5,4,1,3.63
2020,CB2020,081,4,Queens,40892012019,79,33,46,3.72
2020,CB2020,081,4,Queens,40892012020,59,39,20,3.69
2020,CB2020,081,4,Queens,40892013000,79,35,44,3.69
2020,CB2020,081,4,Queens,40892013001,67,22,45,3.7
2020,CB2020,081,4,Queens,40892013002,66,33,33,3.84
2020,CB2020,081,4,Queens,40892013003,74,47,27,3.84
2020,CB2020,081,4,Queens,40892013004,78,21,57,3.7
2020,CB2020,081,4,Queens,40892013005,104,36,68,3.66
2020,CB2020,081,4,Queens,40892013006,68,42,26,3.84
2020,CB2020,081,4,Queens,40892013007,85,44,41,3.84
2020,CB2020,081,4,Queens,40892013008,79,30,49,3.7
2020,CB2020,081,4,Queens,40892013009,62,23,39,3.69
2020,CB2020,081,4,Queens,40892013010,69,24,45,3.71
2020,CB2020,081,4,Queens,40892013011,76,46,30,3.71
2020,CB2020,081,4,Queens,40892013012,72,56,16,3.85
2020,CB2020,081,4,Queens,40892013013,77,37,40,3.86
2020,CB2020,081,4,Queens,40892014000,22,19,3,3.51
2020,CB2020,081,4,Queens,40892014001,104,58,46,3.7
2020,CB2020,081,4,Queens,40892014002,72,45,27,3.7
2020,CB2020,081,4,Queens,40892014003,80,24,56,3.71
2020,CB2020,081,4,Queens,40892014004,6,2,4,3.68
2020,CB2020,081,4,Queens,40892014005,94,38,56,3.7
2020,CB2020,081,4,Queens,40892014006,97,40,57,3.71
2020,CB2020,081,4,Queens,40892014007,98,46,52,3.7
2020,CB2020,081,4,Queens,40892014008,79,21,58,3.71
2020,CB2020,081,4,Queens,40892014009,93,52,41,3.71
2020,CB2020,081,4,Queens,40892014010,71,47,24,3.7
2020,CB2020,081,4,Queens,40892014011,0,0,0,3.79
2020,CB2020,081,4,Queens,40892014012,0,0,0,4.3
2020,CB2020,081,4,Queens,40892014013,15,8,7,4.02
2020,CB2020,081,4,Queens,40892014014,74,31,43,3.69
2020,CB2020,081,4,Queens,40892014015,70,45,25,3.7
2020,CB2020,081,4,Queens,40892014016,86,36,50,3.71
2020,CB2020,081,4,Queens,40892014017,61,27,34,3.69
2020,CB2020,081,4,Queens,40892014018,86,43,43,3.71
2020,CB2020,081,4,Queens,40892015000,78,33,45,2.97
2020,CB2020,081,4,Queens,40892015001,70,33,37,2.98
2020,CB2020,081,4,Queens,40892015002,60,30,30,3.08
2020,CB2020,081,4,Queens,40892015003,54,26,28,3.09
2020,CB2020,081,4,Queens,40892015004,75,34,41,4.58
2020,CB2020,081,4,Queens,40892015005,81,51,30,4.58
2020,CB2020,081,4,Queens,40892015006,100,61,39,4.43
2020,CB2020,081,4,Queens,40892015007,99,27,72,4.43
2020,CB2020,081,4,Queens,40892016000,0,0,0,2.45
2020,CB2020,081,4,Queens,40892016001,0,0,0,3.95
2020,CB2020,081,4,Queens,40892016002,63,28,35,3.37
2020,CB2020,081,4,Queens,40892016003,73,31,42,3.12
2020,CB2020,081,4,Queens,40892016004,65,44,21,3
2020,CB2020,081,4,Queens,40892016005,66,46,20,2.95
2020,CB2020,081,4,Queens,40892016006,71,13,58,2.97
2020,CB2020,081,4,Queens,40892016007,117,52,65,4.44
2020,CB2020,081,4,Queens,40892016008,107,56,51,4.41
2020,CB2020,081,4,Queens,40892016009,94,52,42,4.43
2020,CB2020,081,4,Queens,40892016010,77,32,45,4.3
2020,CB2020,081,4,Queens,40892016011,76,39,37,4.02
2020,CB2020,081,4,Queens,40892016012,9,1,8,4.05
2020,CB2020,081,4,Queens,40892016013,8,2,6,2.17
2020,CB2020,081,4,Queens,40892017000,0,0,0,2.27
2020,CB2020,081,4,Queens,40892017001,56,19,37,4.15
2020,CB2020,081,4,Queens,40892017002,69,48,21,3.78
2020,CB2020,081,4,Queens,40892017003,77,29,48,3.75
2020,CB2020,081,4,Queens,40892017004,87,42,45,3.78
2020,CB2020,081,4,Queens,40892017005,99,56,43,3.76
2020,CB2020,081,4,Queens,40892017006,85,30,55,3.78
2020,CB2020,081,4,Queens,40892017007,58,29,29,3.69
2020,CB2020,081,4,Queens,40892017008,68,46,22,3.58
2020,CB2020,081,4,Queens,40892017009,71,27,44,3.84
2020,CB2020,081,4,Queens,40892017010,61,25,36,3.74
2020,CB2020,081,4,Queens,40892018000,0,0,0,2.81
2020,CB2020,081,4,Queens,40892018001,58,13,45,3.63
2020,CB2020,081,4,Queens,40892018002,61,35,26,2.54
2020,CB2020,081,4,Queens,40892018003,19,5,14,1.33
2020,CB2020,081,4,Queens,40892018004,60,32,28,3.99
2020,CB2020,081,4,Queens,40892018005,61,34,27,3.98
2020,CB2020,081,4,Queens,40892018006,68,46,22,3.98
2020,CB2020,081,4,Queens,40892018007,85,35,50,4.03
2020,CB2020,081,4,Queens,40892018008,88,41,47,3.99
2020,CB2020,081,4,Queens,40892018009,81,58,23,3.66
2020,CB2020,081,4,Queens,40892018010,50,29,21,3.74
2020,CB2020,081,4,Queens,40892018011,0,0,0,0.29
2020,CB2020,081,4,Queens,40892018012,100,32,68,4.67
2020,CB2020,081,4,Queens,40892018013,62,30,32,3.1
2020,CB2020,081,4,Queens,40892018014,59,32,27,3.41
2020,CB2020,081,4,Queens,40892018015,80,21,59,3.88
2020,CB2020,081,4,Queens,40892018016,100,49,51,3.94
2020,CB2020,081,4,Queens,40892021000,0,0,0,7.99
2020,CB2020,081,4,Queens,40892021001,0,0,0,256.69
2020,CB2020,081,4,Queens,40892021002,0,0,0,0.06
2020,CB2020,081,4,Queens,40892021003,0,0,0,0.35
2020,CB2020,081,4,Queens,40892021004,0,0,0,0
2020,CB2020,081,4,Queens,40892021005,0,0,0,0.43
2020,CB2020,081,4,Queens,40892021006,0,0,0,1.4
2020,CB2020,081,4,Queens,40892021007,0,0,0,0
2020,CB2020,081,4,Queens,40892021008,0,0,0,0
2020,CB2020,081,4,Queens,40892021009,0,0,0,4.55
2020,CB2020,081,4,Queens,40907000001,0,0,0,0
2020,CB2020,081,4,Queens,40907000002,0,0,0,0
2020,CB2020,081,4,Queens,40907001000,0,0,0,0.96
2020,CB2020,081,4,Queens,40907001001,0,0,0,177.61
2020,CB2020,081,4,Queens,40907001002,0,0,0,0.75
2020,CB2020,081,4,Queens,40907001003,92,41,51,6.43
2020,CB2020,081,4,Queens,40907001004,250,134,116,4.21
2020,CB2020,081,4,Queens,40907001005,187,104,83,4.48
2020,CB2020,081,4,Queens,40907001006,161,70,91,4.31
2020,CB2020,081,4,Queens,40907001007,109,57,52,4.28
2020,CB2020,081,4,Queens,40907001008,101,57,44,4.25
2020,CB2020,081,4,Queens,40907001009,87,43,44,2.04
2020,CB2020,081,4,Queens,40907001010,82,44,38,2.07
2020,CB2020,081,4,Queens,40907001011,64,19,45,9.84
2020,CB2020,081,4,Queens,40907001012,32,27,5,7.48
2020,CB2020,081,4,Queens,40907001013,0,0,0,43.33
2020,CB2020,081,4,Queens,40907001014,0,0,0,5.48
2020,CB2020,081,4,Queens,40907001015,29,20,9,9.55
2020,CB2020,081,4,Queens,40907001016,107,64,43,2.62
2020,CB2020,081,4,Queens,40907001017,121,50,71,2.6
2020,CB2020,081,4,Queens,40907001018,12,5,7,89.84
2020,CB2020,081,4,Queens,40907001019,0,0,0,7.46
2020,CB2020,081,4,Queens,40907001020,30,8,22,64.53
2020,CB2020,081,4,Queens,40907001021,0,0,0,2.57
2020,CB2020,081,4,Queens,40907001022,0,0,0,2.02
2020,CB2020,081,4,Queens,40907001023,0,0,0,4.58
2020,CB2020,081,4,Queens,40907001024,0,0,0,4.17
2020,CB2020,081,4,Queens,40907001025,0,0,0,2.7
2020,CB2020,081,4,Queens,40907001026,0,0,0,11.97
2020,CB2020,081,4,Queens,40907001027,0,0,0,3.59
2020,CB2020,081,4,Queens,40907001028,20,10,10,2.53
2020,CB2020,081,4,Queens,40907001029,0,0,0,3.99
2020,CB2020,081,4,Queens,40907001030,100,98,2,7.42
2020,CB2020,081,4,Queens,40916020001,0,0,0,0
2020,CB2020,081,4,Queens,40916020002,0,0,0,0
2020,CB2020,081,4,Queens,40916020003,0,0,0,0
2020,CB2020,081,4,Queens,40916021000,0,0,0,5.45
2020,CB2020,081,4,Queens,40916021001,0,0,0,11.29
2020,CB2020,081,4,Queens,40916021002,0,0,0,4.28
2020,CB2020,081,4,Queens,40916021003,0,0,0,66.3
2020,CB2020,081,4,Queens,40916021004,0,0,0,22.53
2020,CB2020,081,4,Queens,40916021005,0,0,0,20.54
2020,CB2020,081,4,Queens,40916021006,12,4,8,9.43
2020,CB2020,081,4,Queens,40916021007,0,0,0,32.86
2020,CB2020,081,4,Queens,40916021008,0,0,0,63.03
2020,CB2020,081,4,Queens,40916021009,0,0,0,79.99
2020,CB2020,081,4,Queens,40916030001,0,0,0,0
2020,CB2020,081,4,Queens,40916030002,0,0,0,0
2020,CB2020,081,4,Queens,40916031000,0,0,0,29.95
2020,CB2020,081,4,Queens,40916031001,0,0,0,0
2020,CB2020,081,4,Queens,40916032000,223,93,130,42.83
2020,CB2020,081,4,Queens,40916032001,6,3,3,0.8
2020,CB2020,081,4,Queens,40916032002,0,0,0,1.06
2020,CB2020,081,4,Queens,40916032003,7,2,5,0.54
2020,CB2020,081,4,Queens,40916032004,47,26,21,2.82
2020,CB2020,081,4,Queens,40916032005,7,7,0,0.48
2020,CB2020,081,4,Queens,40916032006,43,22,21,3.54
2020,CB2020,081,4,Queens,40916032007,68,37,31,3.01
2020,CB2020,081,4,Queens,40916032008,22,19,3,0.83
2020,CB2020,081,4,Queens,40916032009,30,24,6,0.6
2020,CB2020,081,4,Queens,40916032010,26,3,23,2.58
2020,CB2020,081,4,Queens,40916032011,67,26,41,2.89
2020,CB2020,081,4,Queens,40916032012,80,36,44,1.58
2020,CB2020,081,4,Queens,40916032013,27,20,7,1.09
2020,CB2020,081,4,Queens,40916032014,8,2,6,1.25
2020,CB2020,081,4,Queens,40916033000,0,0,0,56.29
2020,CB2020,081,4,Queens,40916034000,0,0,0,3.14
2020,CB2020,081,4,Queens,40916034001,20,18,2,1.03
2020,CB2020,081,4,Queens,40916034002,0,0,0,4.08
2020,CB2020,081,4,Queens,40916034003,39,25,14,3.06
2020,CB2020,081,4,Queens,40916034004,268,118,150,12.71
2020,CB2020,081,4,Queens,40916034005,143,90,53,8.54
2020,CB2020,081,4,Queens,40916034006,42,33,9,6.77
2020,CB2020,081,4,Queens,40916034007,54,20,34,3.28
2020,CB2020,081,4,Queens,40916034008,182,90,92,7.94
2020,CB2020,081,4,Queens,40916034009,41,16,25,1.46
2020,CB2020,081,4,Queens,40916034010,38,10,28,1.23
2020,CB2020,081,4,Queens,40916034011,137,58,79,9.78
2020,CB2020,081,4,Queens,40916034012,69,21,48,3.96
2020,CB2020,081,4,Queens,40916034013,76,37,39,3.67
2020,CB2020,081,4,Queens,40916034014,29,12,17,3.28
2020,CB2020,081,4,Queens,40916034015,39,18,21,2.31
2020,CB2020,081,4,Queens,40916034016,23,16,7,1.54
2020,CB2020,081,4,Queens,40916034017,13,0,13,1.85
2020,CB2020,081,4,Queens,40916034018,42,20,22,2.31
2020,CB2020,081,4,Queens,40916034019,32,8,24,1.91
2020,CB2020,081,4,Queens,40916034020,44,22,22,4.31
2020,CB2020,081,4,Queens,40916034021,104,44,60,9.72
2020,CB2020,081,4,Queens,40916034022,53,15,38,4.69
2020,CB2020,081,4,Queens,40916034023,82,29,53,5.51
2020,CB2020,081,4,Queens,40916034024,45,32,13,5.29
2020,CB2020,081,4,Queens,40916034025,32,19,13,6.34
2020,CB2020,081,4,Queens,40916034026,42,18,24,11.91
2020,CB2020,081,4,Queens,40916034027,15,7,8,2.48
2020,CB2020,081,4,Queens,40916034028,8,4,4,0.65
2020,CB2020,081,4,Queens,40916034029,182,88,94,9.89
2020,CB2020,081,4,Queens,40916034030,0,0,0,0.45
2020,CB2020,081,4,Queens,40916034031,15,9,6,3.59
2020,CB2020,081,4,Queens,40916034032,29,11,18,1.43
2020,CB2020,081,4,Queens,40916035000,9,9,0,0.45
2020,CB2020,081,4,Queens,40916035001,6,4,2,0.67
2020,CB2020,081,4,Queens,40916035002,3,0,3,0.82
2020,CB2020,081,4,Queens,40916035003,39,15,24,3.3
2020,CB2020,081,4,Queens,40916035004,25,19,6,1.71
2020,CB2020,081,4,Queens,40916035005,23,10,13,1.69
2020,CB2020,081,4,Queens,40916035006,33,14,19,1.84
2020,CB2020,081,4,Queens,40916035007,40,23,17,2.01
2020,CB2020,081,4,Queens,40916035008,50,44,6,2.24
2020,CB2020,081,4,Queens,40916035009,57,13,44,2.31
2020,CB2020,081,4,Queens,40916035010,32,19,13,2.55
2020,CB2020,081,4,Queens,40916035011,40,1,39,2.6
2020,CB2020,081,4,Queens,40916035012,15,6,9,1.26
2020,CB2020,081,4,Queens,40916035013,14,10,4,1.25
2020,CB2020,081,4,Queens,40916035014,4,4,0,1.24
2020,CB2020,081,4,Queens,40916035015,16,11,5,1.22
2020,CB2020,081,4,Queens,40916035016,17,7,10,1.21
2020,CB2020,081,4,Queens,40916035017,28,9,19,1.21
2020,CB2020,081,4,Queens,40916035018,35,28,7,2.99
2020,CB2020,081,4,Queens,40916035019,29,17,12,2.15
2020,CB2020,081,4,Queens,40916035020,56,25,31,4.13
2020,CB2020,081,4,Queens,40916035021,63,24,39,5.63
2020,CB2020,081,4,Queens,40916035022,51,18,33,3.59
2020,CB2020,081,4,Queens,40916035023,32,10,22,3
2020,CB2020,081,4,Queens,40916035024,63,23,40,4.01
2020,CB2020,081,4,Queens,40916035025,10,8,2,1.66
2020,CB2020,081,4,Queens,40916035026,24,19,5,1.59
2020,CB2020,081,4,Queens,40916035027,20,8,12,1.47
2020,CB2020,081,4,Queens,40916036000,127,67,60,21.7
2020,CB2020,081,4,Queens,40916036001,0,0,0,3.71
2020,CB2020,081,4,Queens,40916036002,10,10,0,1.04
2020,CB2020,081,4,Queens,40916036003,9,1,8,0.89
2020,CB2020,081,4,Queens,40916036004,16,13,3,0.74
2020,CB2020,081,4,Queens,40916036005,18,15,3,1.16
2020,CB2020,081,4,Queens,40916036006,21,15,6,1
2020,CB2020,081,4,Queens,40916036007,22,10,12,2.01
2020,CB2020,081,4,Queens,40916036008,19,10,9,2.05
2020,CB2020,081,4,Queens,40916036009,38,17,21,2.92
2020,CB2020,081,4,Queens,40916036010,50,35,15,2.74
2020,CB2020,081,4,Queens,40916036011,17,2,15,0.89
2020,CB2020,081,4,Queens,40916036012,0,0,0,0.91
2020,CB2020,081,4,Queens,40916036013,10,4,6,0.94
2020,CB2020,081,4,Queens,40916036014,0,0,0,1.99
2020,CB2020,081,4,Queens,40916036015,86,39,47,6.58
2020,CB2020,081,4,Queens,40916036016,33,12,21,3.41
2020,CB2020,081,4,Queens,40916036017,42,11,31,3.64
2020,CB2020,081,4,Queens,40916036018,44,18,26,3.28
2020,CB2020,081,4,Queens,40916036019,45,7,38,3.31
2020,CB2020,081,4,Queens,40916036020,51,37,14,3.38
2020,CB2020,081,4,Queens,40916036021,38,4,34,3.4
2020,CB2020,081,4,Queens,40916036022,48,22,26,3.72
2020,CB2020,081,4,Queens,40916036023,41,19,22,4.38
2020,CB2020,081,4,Queens,40916036024,37,30,7,2.75
2020,CB2020,081,4,Queens,40916036025,29,12,17,2.56
2020,CB2020,081,4,Queens,40916036026,29,2,27,2.54
2020,CB2020,081,4,Queens,40916036027,25,14,11,2.55
2020,CB2020,081,4,Queens,40916036028,17,4,13,5.12
2020,CB2020,081,4,Queens,40916036029,0,0,0,0.61
2020,CB2020,081,4,Queens,40916036030,36,19,17,2.81
2020,CB2020,081,4,Queens,40916036031,35,20,15,2.5
2020,CB2020,081,4,Queens,40916036032,30,17,13,2.36
2020,CB2020,081,4,Queens,40916036033,0,0,0,0.58
2020,CB2020,081,4,Queens,40916040001,0,0,0,0
2020,CB2020,081,4,Queens,40916040002,0,0,0,0
2020,CB2020,081,4,Queens,40916040003,0,0,0,0
2020,CB2020,081,4,Queens,40916040004,0,0,0,0
2020,CB2020,081,4,Queens,40916040005,0,0,0,0
2020,CB2020,081,4,Queens,40916040006,0,0,0,0
2020,CB2020,081,4,Queens,40916041000,0,0,0,568.66
2020,CB2020,081,4,Queens,40916041001,0,0,0,30.92
2020,CB2020,081,4,Queens,40916041002,0,0,0,12.52
2020,CB2020,081,4,Queens,40916041003,0,0,0,2.55
2020,CB2020,081,4,Queens,40918000001,0,0,0,0
2020,CB2020,081,4,Queens,40918000002,0,0,0,0
2020,CB2020,081,4,Queens,40918000003,0,0,0,0
2020,CB2020,081,4,Queens,40918000004,0,0,0,0
2020,CB2020,081,4,Queens,40918000005,0,0,0,0
2020,CB2020,081,4,Queens,40918001000,0,0,0,16.15
2020,CB2020,081,4,Queens,40918001001,0,0,0,0.65
2020,CB2020,081,4,Queens,40918001002,0,0,0,2.65
2020,CB2020,081,4,Queens,40918001003,0,0,0,4.95
2020,CB2020,081,4,Queens,40918001004,0,0,0,31.52
2020,CB2020,081,4,Queens,40918001005,0,0,0,0.53
2020,CB2020,081,4,Queens,40918001006,0,0,0,1.76
2020,CB2020,081,4,Queens,40918001007,0,0,0,2.98
2020,CB2020,081,4,Queens,40918001008,0,0,0,2.47
2020,CB2020,081,4,Queens,40918001009,0,0,0,3.09
2020,CB2020,081,4,Queens,40918001010,0,0,0,1.55
2020,CB2020,081,4,Queens,40918001011,0,0,0,86.12
2020,CB2020,081,4,Queens,40918001012,0,0,0,1.13
2020,CB2020,081,4,Queens,40918001013,0,0,0,1.93
2020,CB2020,081,4,Queens,40918001014,0,0,0,67
2020,CB2020,081,4,Queens,40918001015,12,7,5,10.21
2020,CB2020,081,4,Queens,40918001016,0,0,0,2.47
2020,CB2020,081,4,Queens,40918001017,0,0,0,41.2
2020,CB2020,081,4,Queens,40919000001,0,0,0,0
2020,CB2020,081,4,Queens,40919001000,142,49,93,2.64
2020,CB2020,081,4,Queens,40919001001,151,72,79,2.6
2020,CB2020,081,4,Queens,40919001002,150,94,56,3.43
2020,CB2020,081,4,Queens,40919001003,1165,543,622,15.64
2020,CB2020,081,4,Queens,40919001004,166,72,94,2.29
2020,CB2020,081,4,Queens,40919001005,71,31,40,2.5
2020,CB2020,081,4,Queens,40919001006,44,30,14,2.78
2020,CB2020,081,4,Queens,40919002000,13,6,7,3.22
2020,CB2020,081,4,Queens,40919002001,20,6,14,3.22
2020,CB2020,081,4,Queens,40919002002,222,99,123,3.22
2020,CB2020,081,4,Queens,40919002003,208,109,99,3.23
2020,CB2020,081,4,Queens,40919002004,262,125,137,3.23
2020,CB2020,081,4,Queens,40919002005,281,147,134,3.23
2020,CB2020,081,4,Queens,40919002006,244,141,103,3.23
2020,CB2020,081,4,Queens,40919002007,226,116,110,3.29
2020,CB2020,081,4,Queens,40919002008,135,48,87,3.29
2020,CB2020,081,4,Queens,40919002009,207,91,116,3.22
2020,CB2020,081,4,Queens,40919002010,259,123,136,3.24
2020,CB2020,081,4,Queens,40919002011,16,1,15,2.9
2020,CB2020,081,4,Queens,40919002012,146,81,65,3.26
2020,CB2020,081,4,Queens,40919003000,311,116,195,4.21
2020,CB2020,081,4,Queens,40919003001,282,160,122,4.13
2020,CB2020,081,4,Queens,40919003002,334,173,161,4.2
2020,CB2020,081,4,Queens,40919003003,183,82,101,3.56
2020,CB2020,081,4,Queens,40919003004,192,116,76,3.43
2020,CB2020,081,4,Queens,40919003005,170,88,82,6.68
2020,CB2020,081,4,Queens,40919003006,0,0,0,0.48
2020,CB2020,081,4,Queens,40919003007,85,55,30,0.54
2020,CB2020,081,4,Queens,40919003008,76,41,35,0.68
2020,CB2020,081,4,Queens,40919003009,109,55,54,2.45
2020,CB2020,081,4,Queens,40919003010,125,55,70,2.39
2020,CB2020,081,4,Queens,40919003011,153,64,89,1.48
2020,CB2020,081,4,Queens,40919003012,111,66,45,1.48
2020,CB2020,081,4,Queens,40919003013,158,73,85,2.02
2020,CB2020,081,4,Queens,40922000001,0,0,0,0
2020,CB2020,081,4,Queens,40922000002,0,0,0,0
2020,CB2020,081,4,Queens,40922001000,0,0,0,0.72
2020,CB2020,081,4,Queens,40922001001,54,26,28,3.09
2020,CB2020,081,4,Queens,40922001002,53,40,13,2.82
2020,CB2020,081,4,Queens,40922001003,69,21,48,2.55
2020,CB2020,081,4,Queens,40922001004,60,21,39,2.26
2020,CB2020,081,4,Queens,40922001005,0,0,0,1.27
2020,CB2020,081,4,Queens,40922001006,47,22,25,1.99
2020,CB2020,081,4,Queens,40922001007,62,38,24,4.74
2020,CB2020,081,4,Queens,40922001008,83,35,48,4.33
2020,CB2020,081,4,Queens,40922001009,92,51,41,4.29
2020,CB2020,081,4,Queens,40922001010,92,54,38,4.3
2020,CB2020,081,4,Queens,40922001011,92,37,55,4.31
2020,CB2020,081,4,Queens,40922001012,87,25,62,4.3
2020,CB2020,081,4,Queens,40922001013,101,57,44,4.3
2020,CB2020,081,4,Queens,40922002000,69,32,37,4.2
2020,CB2020,081,4,Queens,40922002001,72,39,33,4.23
2020,CB2020,081,4,Queens,40922002002,77,34,43,4.29
2020,CB2020,081,4,Queens,40922002003,50,7,43,3.54
2020,CB2020,081,4,Queens,40922002004,52,24,28,3.72
2020,CB2020,081,4,Queens,40922002005,43,11,32,3.95
2020,CB2020,081,4,Queens,40922002006,79,46,33,3.71
2020,CB2020,081,4,Queens,40922002007,76,36,40,3.7
2020,CB2020,081,4,Queens,40922002008,60,31,29,3.92
2020,CB2020,081,4,Queens,40922002009,18,12,6,1.83
2020,CB2020,081,4,Queens,40922002010,60,40,20,5.08
2020,CB2020,081,4,Queens,40922002011,68,35,33,4.66
2020,CB2020,081,4,Queens,40922002012,79,43,36,4.4
2020,CB2020,081,4,Queens,40922003000,24,4,20,2.21
2020,CB2020,081,4,Queens,40922003001,20,8,12,2.2
2020,CB2020,081,4,Queens,40922003002,37,18,19,2.32
2020,CB2020,081,4,Queens,40922003003,40,27,13,2.44
2020,CB2020,081,4,Queens,40922003004,27,13,14,2.69
2020,CB2020,081,4,Queens,40922003005,29,12,17,2.83
2020,CB2020,081,4,Queens,40922003006,240,128,112,36.44
2020,CB2020,081,4,Queens,40922003007,47,13,34,4.66
2020,CB2020,081,4,Queens,40922003008,27,21,6,2.78
2020,CB2020,081,4,Queens,40922003009,22,7,15,1.52
2020,CB2020,081,4,Queens,40925001000,21,12,9,0.48
2020,CB2020,081,4,Queens,40925001001,54,20,34,1.03
2020,CB2020,081,4,Queens,40925001002,61,26,35,1.48
2020,CB2020,081,4,Queens,40925001003,5,3,2,1.91
2020,CB2020,081,4,Queens,40925001004,215,90,125,2.52
2020,CB2020,081,4,Queens,40925001005,169,97,72,2.9
2020,CB2020,081,4,Queens,40925001006,234,120,114,3.32
2020,CB2020,081,4,Queens,40925001007,70,40,30,3.79
2020,CB2020,081,4,Queens,40925001008,65,32,33,2.25
2020,CB2020,081,4,Queens,40925001009,91,32,59,2.06
2020,CB2020,081,4,Queens,40925001010,71,39,32,1.94
2020,CB2020,081,4,Queens,40925001011,136,58,78,1.87
2020,CB2020,081,4,Queens,40925002000,27,6,21,3.21
2020,CB2020,081,4,Queens,40925002001,301,165,136,3.21
2020,CB2020,081,4,Queens,40925002002,244,113,131,3.21
2020,CB2020,081,4,Queens,40925002003,203,117,86,3.21
2020,CB2020,081,4,Queens,40925002004,180,89,91,3.28
2020,CB2020,081,4,Queens,40925002005,196,89,107,3.28
2020,CB2020,081,4,Queens,40925002006,244,110,134,3.21
2020,CB2020,081,4,Queens,40925002007,213,113,100,3.22
2020,CB2020,081,4,Queens,40925003000,219,98,121,3.21
2020,CB2020,081,4,Queens,40925003001,211,101,110,3.21
2020,CB2020,081,4,Queens,40925003002,178,100,78,3.22
2020,CB2020,081,4,Queens,40925003003,0,0,0,1.74
2020,CB2020,081,4,Queens,40925003004,157,87,70,1.77
2020,CB2020,081,4,Queens,40925003005,202,107,95,3.27
2020,CB2020,081,4,Queens,40925003006,187,90,97,3.21
2020,CB2020,081,4,Queens,40925003007,147,71,76,3.22
2020,CB2020,081,4,Queens,40925003008,130,38,92,1.5
2020,CB2020,081,4,Queens,40925003009,125,90,35,1.46
2020,CB2020,081,4,Queens,40928000001,0,0,0,0
2020,CB2020,081,4,Queens,40928000002,0,0,0,0
2020,CB2020,081,4,Queens,40928001000,103,40,63,4.6
2020,CB2020,081,4,Queens,40928001001,63,7,56,4.58
2020,CB2020,081,4,Queens,40928001002,110,68,42,4.58
2020,CB2020,081,4,Queens,40928001003,99,44,55,4.52
2020,CB2020,081,4,Queens,40928001004,83,48,35,4.48
2020,CB2020,081,4,Queens,40928001005,86,53,33,4.49
2020,CB2020,081,4,Queens,40928001006,66,40,26,4.49
2020,CB2020,081,4,Queens,40928001007,79,33,46,4.43
2020,CB2020,081,4,Queens,40928001008,100,44,56,4.41
2020,CB2020,081,4,Queens,40928001009,74,45,29,4.39
2020,CB2020,081,4,Queens,40928001010,62,42,20,4.4
2020,CB2020,081,4,Queens,40928001011,65,29,36,4.66
2020,CB2020,081,4,Queens,40928001012,0,0,0,7.96
2020,CB2020,081,4,Queens,40928001013,0,0,0,9.81
2020,CB2020,081,4,Queens,40928001014,0,0,0,4.44
2020,CB2020,081,4,Queens,40928002000,0,0,0,0.67
2020,CB2020,081,4,Queens,40928002001,0,0,0,0.64
2020,CB2020,081,4,Queens,40928002002,70,38,32,3.93
2020,CB2020,081,4,Queens,40928002003,100,45,55,4.22
2020,CB2020,081,4,Queens,40928002004,122,55,67,4.48
2020,CB2020,081,4,Queens,40928002005,95,43,52,4.64
2020,CB2020,081,4,Queens,40928002006,94,27,67,4.31
2020,CB2020,081,4,Queens,40928002007,84,30,54,4.3
2020,CB2020,081,4,Queens,40928002008,73,29,44,4.31
2020,CB2020,081,4,Queens,40928002009,118,66,52,4.3
2020,CB2020,081,4,Queens,40928002010,52,21,31,4.3
2020,CB2020,081,4,Queens,40928002011,72,44,28,3.65
2020,CB2020,081,4,Queens,40928002012,75,41,34,3.4
2020,CB2020,081,4,Queens,40928002013,68,36,32,4.31
2020,CB2020,081,4,Queens,40928003000,82,35,47,4.39
2020,CB2020,081,4,Queens,40928003001,104,41,63,4.53
2020,CB2020,081,4,Queens,40928003002,84,25,59,4.65
2020,CB2020,081,4,Queens,40928003003,92,61,31,4.75
2020,CB2020,081,4,Queens,40928003004,112,59,53,4.88
2020,CB2020,081,4,Queens,40928003005,112,59,53,4.99
2020,CB2020,081,4,Queens,40928003006,110,57,53,5.1
2020,CB2020,081,4,Queens,40928003007,99,54,45,5.21
2020,CB2020,081,4,Queens,40928003008,102,42,60,5.33
2020,CB2020,081,4,Queens,40928003009,105,74,31,5.44
2020,CB2020,081,4,Queens,40928003010,100,40,60,5.54
2020,CB2020,081,4,Queens,40928003011,89,32,57,5.98
2020,CB2020,081,4,Queens,40929000001,0,0,0,0
2020,CB2020,081,4,Queens,40929000002,0,0,0,0
2020,CB2020,081,4,Queens,40929001000,1017,503,514,36.98
2020,CB2020,081,4,Queens,40929001001,217,126,91,28.02
2020,CB2020,081,4,Queens,40929001002,0,0,0,1.13
2020,CB2020,081,4,Queens,40929002000,84,32,52,1.56
2020,CB2020,081,4,Queens,40929002001,110,55,55,1.44
2020,CB2020,081,4,Queens,40929002002,0,0,0,1.43
2020,CB2020,081,4,Queens,40929002003,112,59,53,1.41
2020,CB2020,081,4,Queens,40929002004,0,0,0,1.41
2020,CB2020,081,4,Queens,40929002005,52,21,31,4.54
2020,CB2020,081,4,Queens,40929002006,156,87,69,2.35
2020,CB2020,081,4,Queens,40929002007,120,69,51,2.32
2020,CB2020,081,4,Queens,40929002008,0,0,0,2.32
2020,CB2020,081,4,Queens,40929002009,108,63,45,2.32
2020,CB2020,081,4,Queens,40929002010,102,66,36,2.32
2020,CB2020,081,4,Queens,40929002011,66,37,29,6.06
2020,CB2020,081,4,Queens,40929002012,58,22,36,36.58
2020,CB2020,081,4,Queens,40929002013,217,106,111,2.88
2020,CB2020,081,4,Queens,40929002014,169,92,77,2.87
2020,CB2020,081,4,Queens,40929003000,81,46,35,2.73
2020,CB2020,081,4,Queens,40929003001,157,97,60,2.34
2020,CB2020,081,4,Queens,40929003002,157,66,91,2.29
2020,CB2020,081,4,Queens,40929003003,128,68,60,2.29
2020,CB2020,081,4,Queens,40929003004,127,64,63,2.28
2020,CB2020,081,4,Queens,40929003005,142,67,75,2.28
2020,CB2020,081,4,Queens,40929003006,204,106,98,2.74
2020,CB2020,081,4,Queens,40929003007,143,70,73,2.43
2020,CB2020,081,4,Queens,40929004000,465,234,231,8.31
2020,CB2020,081,4,Queens,40929004001,201,87,114,3.61
2020,CB2020,081,4,Queens,40929004002,383,184,199,7.05
2020,CB2020,081,4,Queens,40929005000,201,86,115,5.06
2020,CB2020,081,4,Queens,40929005001,203,83,120,4.52
2020,CB2020,081,4,Queens,40929005002,314,159,155,6.64
2020,CB2020,081,4,Queens,40929005003,226,114,112,4.82
2020,CB2020,081,4,Queens,40929005004,79,46,33,1.91
2020,CB2020,081,4,Queens,40929005005,145,65,80,3.59
2020,CB2020,081,4,Queens,40929005006,120,46,74,3.54
2020,CB2020,081,4,Queens,40929005007,105,44,61,3.67
2020,CB2020,081,4,Queens,40929005008,405,204,201,7.48
2020,CB2020,081,4,Queens,40929005009,66,36,30,1.98
2020,CB2020,081,4,Queens,40929005010,122,57,65,1.97
2020,CB2020,081,4,Queens,40929005011,101,48,53,2.48
2020,CB2020,081,4,Queens,40929005012,470,228,242,6.78
2020,CB2020,081,4,Queens,40929005013,191,106,85,2.65
2020,CB2020,081,4,Queens,40929005014,114,60,54,3.06
2020,CB2020,081,4,Queens,40934010001,0,0,0,0
2020,CB2020,081,4,Queens,40934011000,0,0,0,0.63
2020,CB2020,081,4,Queens,40934011001,57,23,34,1.76
2020,CB2020,081,4,Queens,40934011002,0,0,0,3.58
2020,CB2020,081,4,Queens,40934011003,139,71,68,4.38
2020,CB2020,081,4,Queens,40934011004,119,45,74,4.31
2020,CB2020,081,4,Queens,40934011005,102,59,43,4.38
2020,CB2020,081,4,Queens,40934011006,65,42,23,2.62
2020,CB2020,081,4,Queens,40934011007,36,9,27,3.29
2020,CB2020,081,4,Queens,40934011008,103,41,62,3.86
2020,CB2020,081,4,Queens,40934011009,166,93,73,4.37
2020,CB2020,081,4,Queens,40934011010,216,126,90,4.66
2020,CB2020,081,4,Queens,40934011011,98,40,58,4.41
2020,CB2020,081,4,Queens,40934011012,112,53,59,4.5
2020,CB2020,081,4,Queens,40934011013,160,83,77,4.47
2020,CB2020,081,4,Queens,40934011014,122,67,55,4.48
2020,CB2020,081,4,Queens,40934012000,155,79,76,3.78
2020,CB2020,081,4,Queens,40934012001,130,61,69,3.79
2020,CB2020,081,4,Queens,40934012002,187,109,78,3.92
2020,CB2020,081,4,Queens,40934012003,435,236,199,16.16
2020,CB2020,081,4,Queens,40934012004,288,150,138,5.14
2020,CB2020,081,4,Queens,40934013000,95,49,46,4.1
2020,CB2020,081,4,Queens,40934013001,91,50,41,4.22
2020,CB2020,081,4,Queens,40934013002,123,64,59,4.36
2020,CB2020,081,4,Queens,40934013003,71,39,32,4.38
2020,CB2020,081,4,Queens,40934013004,473,220,253,23.41
2020,CB2020,081,4,Queens,40934013005,189,73,116,4.96
2020,CB2020,081,4,Queens,40934020001,0,0,0,0
2020,CB2020,081,4,Queens,40934021000,429,207,222,5.01
2020,CB2020,081,4,Queens,40934021001,875,477,398,23.09
2020,CB2020,081,4,Queens,40934022000,0,0,0,0.42
2020,CB2020,081,4,Queens,40934022001,554,260,294,16.64
2020,CB2020,081,4,Queens,40934022002,303,155,148,4.19
2020,CB2020,081,4,Queens,40934023000,0,0,0,3.19
2020,CB2020,081,4,Queens,40934023001,116,60,56,3.63
2020,CB2020,081,4,Queens,40934023002,86,50,36,3.12
2020,CB2020,081,4,Queens,40934023003,103,40,63,2.57
2020,CB2020,081,4,Queens,40934023004,57,42,15,2.06
2020,CB2020,081,4,Queens,40934023005,34,23,11,1.51
2020,CB2020,081,4,Queens,40934023006,0,0,0,1.01
2020,CB2020,081,4,Queens,40934023007,85,63,22,4.19
2020,CB2020,081,4,Queens,40934023008,149,85,64,3.79
2020,CB2020,081,4,Queens,40934023009,145,75,70,3.79
2020,CB2020,081,4,Queens,40934023010,181,70,111,3.8
2020,CB2020,081,4,Queens,40934023011,155,53,102,3.31
2020,CB2020,081,4,Queens,40934023012,114,59,55,3.83
2020,CB2020,081,4,Queens,40934023013,172,81,91,3.79
2020,CB2020,081,4,Queens,40934023014,129,70,59,4.19
2020,CB2020,081,4,Queens,40934023015,17,2,15,0.43
2020,CB2020,081,4,Queens,40938000001,0,0,0,0
2020,CB2020,081,4,Queens,40938000002,0,0,0,0
2020,CB2020,081,4,Queens,40938001000,0,0,0,2.48
2020,CB2020,081,4,Queens,40938001001,0,0,0,3.71
2020,CB2020,081,4,Queens,40938001002,1314,611,703,17.86
2020,CB2020,081,4,Queens,40938002000,140,84,56,4.56
2020,CB2020,081,4,Queens,40938002001,1190,499,691,15.3
2020,CB2020,081,4,Queens,40938002002,0,0,0,18.76
2020,CB2020,081,4,Queens,40938003000,0,0,0,23.62
2020,CB2020,081,4,Queens,40938003001,0,0,0,12.08
2020,CB2020,081,4,Queens,40938003002,0,0,0,14.71
2020,CB2020,081,4,Queens,40938003003,57,23,34,18.63
2020,CB2020,081,4,Queens,40938003004,255,119,136,9.44
2020,CB2020,081,4,Queens,40938003005,1277,780,497,47.11
2020,CB2020,081,4,Queens,40938003006,101,58,43,3.59
2020,CB2020,081,4,Queens,40938003007,44,26,18,1.1
2020,CB2020,081,4,Queens,40938003008,0,0,0,4.74
2020,CB2020,081,4,Queens,40938003009,82,35,47,2.39
2020,CB2020,081,4,Queens,40939000001,0,0,0,0
2020,CB2020,081,4,Queens,40939001000,920,434,486,61.34
2020,CB2020,081,4,Queens,40939001001,186,65,121,2.25
2020,CB2020,081,4,Queens,40939001002,273,108,165,6.05
2020,CB2020,081,4,Queens,40939001003,407,196,211,6.2
2020,CB2020,081,4,Queens,40939001004,127,64,63,2.12
2020,CB2020,081,4,Queens,40939001005,270,129,141,3.23
2020,CB2020,081,4,Queens,40939001006,168,77,91,3.07
2020,CB2020,081,4,Queens,40939001007,85,37,48,2.17
2020,CB2020,081,4,Queens,40939001008,104,57,47,2.14
2020,CB2020,081,4,Queens,40939001009,81,27,54,2.16
2020,CB2020,081,4,Queens,40939001010,120,65,55,2.12
2020,CB2020,081,4,Queens,40939001011,109,83,26,1.91
2020,CB2020,081,4,Queens,40939001012,0,0,0,0.26
2020,CB2020,081,4,Queens,40939001013,301,167,134,6.46
2020,CB2020,081,4,Queens,40939001014,79,45,34,1.76
2020,CB2020,081,4,Queens,40939001015,78,34,44,1.78
2020,CB2020,081,4,Queens,40939001016,62,26,36,1.75
2020,CB2020,081,4,Queens,40939002000,102,42,60,3.06
2020,CB2020,081,4,Queens,40939002001,117,47,70,3.06
2020,CB2020,081,4,Queens,40939002002,198,68,130,3.04
2020,CB2020,081,4,Queens,40939002003,75,37,38,1.66
2020,CB2020,081,4,Queens,40939002004,197,99,98,3.02
2020,CB2020,081,4,Queens,40939002005,177,116,61,2.96
2020,CB2020,081,4,Queens,40939002006,197,138,59,3.06
2020,CB2020,081,4,Queens,40939002007,144,55,89,2.61
2020,CB2020,081,4,Queens,40939002008,89,58,31,1.34
2020,CB2020,081,4,Queens,40939002009,210,109,101,3.05
2020,CB2020,081,4,Queens,40939003000,70,44,26,1.74
2020,CB2020,081,4,Queens,40939003001,84,40,44,1.79
2020,CB2020,081,4,Queens,40939003002,71,35,36,1.76
2020,CB2020,081,4,Queens,40939003003,85,50,35,1.75
2020,CB2020,081,4,Queens,40939003004,225,116,109,4.26
2020,CB2020,081,4,Queens,40939003005,155,69,86,2.92
2020,CB2020,081,4,Queens,40939003006,150,87,63,2.98
2020,CB2020,081,4,Queens,40939003007,135,62,73,2.96
2020,CB2020,081,4,Queens,40939003008,155,71,84,3.06
2020,CB2020,081,4,Queens,40939003009,104,20,84,2.99
2020,CB2020,081,4,Queens,40939003010,158,85,73,2.31
2020,CB2020,081,4,Queens,40942010001,0,0,0,0
2020,CB2020,081,4,Queens,40942011000,326,183,143,2.02
2020,CB2020,081,4,Queens,40942011001,157,91,66,1.97
2020,CB2020,081,4,Queens,40942011002,66,22,44,1.42
2020,CB2020,081,4,Queens,40942011003,37,15,22,0.69
2020,CB2020,081,4,Queens,40942011004,256,145,111,4.58
2020,CB2020,081,4,Queens,40942011005,70,39,31,1.47
2020,CB2020,081,4,Queens,40942011006,163,67,96,3.03
2020,CB2020,081,4,Queens,40942011007,241,114,127,3.61
2020,CB2020,081,4,Queens,40942011008,126,66,60,1.74
2020,CB2020,081,4,Queens,40942011009,135,66,69,2.18
2020,CB2020,081,4,Queens,40942011010,277,109,168,4.14
2020,CB2020,081,4,Queens,40942011011,308,161,147,4.73
2020,CB2020,081,4,Queens,40942011012,0,0,0,0.56
2020,CB2020,081,4,Queens,40942011013,28,8,20,12.2
2020,CB2020,081,4,Queens,40942011014,154,77,77,3.07
2020,CB2020,081,4,Queens,40942011015,166,98,68,2.53
2020,CB2020,081,4,Queens,40942011016,38,6,32,0.55
2020,CB2020,081,4,Queens,40942011017,6,6,0,3.36
2020,CB2020,081,4,Queens,40942012000,0,0,0,0
2020,CB2020,081,4,Queens,40942012001,33,10,23,13.49
2020,CB2020,081,4,Queens,40942012002,27,15,12,2.67
2020,CB2020,081,4,Queens,40942012003,117,56,61,2.8
2020,CB2020,081,4,Queens,40942012004,27,11,16,0.94
2020,CB2020,081,4,Queens,40942012005,882,365,517,5.26
2020,CB2020,081,4,Queens,40942012006,23,9,14,0.4
2020,CB2020,081,4,Queens,40942012007,24,17,7,0.33
2020,CB2020,081,4,Queens,40942012008,42,17,25,0.6
2020,CB2020,081,4,Queens,40942012009,0,0,0,2.84
2020,CB2020,081,4,Queens,40942012010,0,0,0,2.69
2020,CB2020,081,4,Queens,40942020001,0,0,0,0
2020,CB2020,081,4,Queens,40942020002,0,0,0,0
2020,CB2020,081,4,Queens,40942020003,0,0,0,0
2020,CB2020,081,4,Queens,40942020004,0,0,0,0
2020,CB2020,081,4,Queens,40942021000,105,48,57,6.17
2020,CB2020,081,4,Queens,40942021001,75,45,30,8.5
2020,CB2020,081,4,Queens,40942021002,39,21,18,0.96
2020,CB2020,081,4,Queens,40942021003,46,28,18,1.44
2020,CB2020,081,4,Queens,40942021004,137,90,47,3.54
2020,CB2020,081,4,Queens,40942021005,100,49,51,3.92
2020,CB2020,081,4,Queens,40942021006,83,37,46,3.64
2020,CB2020,081,4,Queens,40942021007,158,66,92,3.35
2020,CB2020,081,4,Queens,40942021008,46,25,21,7.35
2020,CB2020,081,4,Queens,40942021009,17,6,11,2.75
2020,CB2020,081,4,Queens,40942021010,48,30,18,2.22
2020,CB2020,081,4,Queens,40942021011,19,13,6,2.21
2020,CB2020,081,4,Queens,40942021012,167,80,87,3.28
2020,CB2020,081,4,Queens,40942021013,144,65,79,3.32
2020,CB2020,081,4,Queens,40942021014,91,32,59,1.67
2020,CB2020,081,4,Queens,40942021015,82,55,27,1.07
2020,CB2020,081,4,Queens,40942021016,0,0,0,0.38
2020,CB2020,081,4,Queens,40942021017,75,25,50,1.68
2020,CB2020,081,4,Queens,40942021018,109,55,54,1.66
2020,CB2020,081,4,Queens,40942021019,69,33,36,2.14
2020,CB2020,081,4,Queens,40942021020,0,0,0,1.37
2020,CB2020,081,4,Queens,40942021021,58,27,31,2.73
2020,CB2020,081,4,Queens,40942022000,0,0,0,4.19
2020,CB2020,081,4,Queens,40942022001,0,0,0,1.99
2020,CB2020,081,4,Queens,40942022002,0,0,0,0.97
2020,CB2020,081,4,Queens,40942022003,0,0,0,0.48
2020,CB2020,081,4,Queens,40942022004,1795,734,1061,18.44
2020,CB2020,081,4,Queens,40942022005,336,142,194,4.07
2020,CB2020,081,4,Queens,40942023000,0,0,0,30
2020,CB2020,081,4,Queens,40942023001,0,0,0,12.23
2020,CB2020,081,4,Queens,40942023002,47,23,24,7.51
2020,CB2020,081,4,Queens,40942023003,18,8,10,0.36
2020,CB2020,081,4,Queens,40942023004,0,0,0,2.27
2020,CB2020,081,4,Queens,40942023005,0,0,0,1.27
2020,CB2020,081,4,Queens,40942023006,75,37,38,5.42
2020,CB2020,081,4,Queens,40942023007,60,18,42,1.54
2020,CB2020,081,4,Queens,40942023008,101,34,67,1.47
2020,CB2020,081,4,Queens,40942023009,46,38,8,3.65
2020,CB2020,081,4,Queens,40942023010,184,85,99,4.64
2020,CB2020,081,4,Queens,40942023011,35,6,29,0.34
2020,CB2020,081,4,Queens,40942023012,58,36,22,0.95
2020,CB2020,081,4,Queens,40942023013,41,21,20,1.15
2020,CB2020,081,4,Queens,40942023014,105,75,30,1.61
2020,CB2020,081,4,Queens,40942023015,75,35,40,1.4
2020,CB2020,081,4,Queens,40942023016,70,39,31,1.14
2020,CB2020,081,4,Queens,40942023017,31,10,21,3.32
2020,CB2020,081,4,Queens,40942023018,40,13,27,0.61
2020,CB2020,081,4,Queens,40942030001,0,0,0,0
2020,CB2020,081,4,Queens,40942031000,0,0,0,7.95
2020,CB2020,081,4,Queens,40942031001,0,0,0,10.56
2020,CB2020,081,4,Queens,40942031002,20,12,8,12.56
2020,CB2020,081,4,Queens,40942031003,0,0,0,13.83
2020,CB2020,081,4,Queens,40942031004,0,0,0,0.58
2020,CB2020,081,4,Queens,40942031005,136,69,67,2.7
2020,CB2020,081,4,Queens,40942031006,170,86,84,2.93
2020,CB2020,081,4,Queens,40942031007,130,42,88,2.66
2020,CB2020,081,4,Queens,40942031008,337,152,185,3.67
2020,CB2020,081,4,Queens,40942031009,0,0,0,3.69
2020,CB2020,081,4,Queens,40942031010,158,76,82,1.88
2020,CB2020,081,4,Queens,40942031011,97,40,57,2.61
2020,CB2020,081,4,Queens,40942031012,193,99,94,2.71
2020,CB2020,081,4,Queens,40942031013,0,0,0,0.47
2020,CB2020,081,4,Queens,40942032000,0,0,0,7.68
2020,CB2020,081,4,Queens,40942032001,1386,625,761,12.68
2020,CB2020,081,4,Queens,40942033000,1127,523,604,14.57
2020,CB2020,081,4,Queens,40942034000,951,412,539,11.33
2020,CB2020,081,4,Queens,40942035000,971,444,527,10.94
2020,CB2020,081,4,Queens,40945000001,0,0,0,0
2020,CB2020,081,4,Queens,40945000002,0,0,0,0
2020,CB2020,081,4,Queens,40945000003,0,0,0,0
2020,CB2020,081,4,Queens,40945000004,0,0,0,0
2020,CB2020,081,4,Queens,40945001000,185,82,103,27.04
2020,CB2020,081,4,Queens,40945001001,45,42,3,4.54
2020,CB2020,081,4,Queens,40945001002,45,22,23,5.67
2020,CB2020,081,4,Queens,40945001003,34,19,15,6.48
2020,CB2020,081,4,Queens,40945001004,0,0,0,0.23
2020,CB2020,081,4,Queens,40945001005,40,19,21,3.96
2020,CB2020,081,4,Queens,40945001006,52,17,35,5.83
2020,CB2020,081,4,Queens,40945001007,30,12,18,4.74
2020,CB2020,081,4,Queens,40945001008,61,24,37,7.37
2020,CB2020,081,4,Queens,40945001009,72,35,37,5.86
2020,CB2020,081,4,Queens,40945001010,150,86,64,21.85
2020,CB2020,081,4,Queens,40945001011,194,85,109,12.32
2020,CB2020,081,4,Queens,40945001012,60,36,24,1.47
2020,CB2020,081,4,Queens,40945001013,127,71,56,2.62
2020,CB2020,081,4,Queens,40945001014,114,55,59,2.15
2020,CB2020,081,4,Queens,40945001015,62,29,33,2.14
2020,CB2020,081,4,Queens,40945001016,42,8,34,2.14
2020,CB2020,081,4,Queens,40945001017,106,66,40,3.44
2020,CB2020,081,4,Queens,40945001018,82,44,38,3.84
2020,CB2020,081,4,Queens,40945001019,94,23,71,4.37
2020,CB2020,081,4,Queens,40945001020,0,0,0,3.68
2020,CB2020,081,4,Queens,40945001021,107,55,52,6.53
2020,CB2020,081,4,Queens,40945001022,55,21,34,4.02
2020,CB2020,081,4,Queens,40945001023,68,38,30,4.52
2020,CB2020,081,4,Queens,40945001024,13,6,7,10.16
2020,CB2020,081,4,Queens,40945001025,197,96,101,2.98
2020,CB2020,081,4,Queens,40945001026,163,73,90,2.89
2020,CB2020,081,4,Queens,40945001027,0,0,0,2.97
2020,CB2020,081,4,Queens,40945001028,134,71,63,2.99
2020,CB2020,081,4,Queens,40945001029,31,23,8,2.85
2020,CB2020,081,4,Queens,40945001030,70,34,36,5.49
2020,CB2020,081,4,Queens,40945002000,0,0,0,1.92
2020,CB2020,081,4,Queens,40945002001,0,0,0,1.16
2020,CB2020,081,4,Queens,40945002002,0,0,0,2.07
2020,CB2020,081,4,Queens,40945002003,0,0,0,3.75
2020,CB2020,081,4,Queens,40945002004,13,9,4,4.06
2020,CB2020,081,4,Queens,40945002005,0,0,0,1.25
2020,CB2020,081,4,Queens,40945002006,33,10,23,3.68
2020,CB2020,081,4,Queens,40945002007,68,38,30,6.27
2020,CB2020,081,4,Queens,40945002008,93,45,48,7.07
2020,CB2020,081,4,Queens,40945002009,60,26,34,4.46
2020,CB2020,081,4,Queens,40945002010,62,24,38,2.58
2020,CB2020,081,4,Queens,40945002011,58,27,31,2.63
2020,CB2020,081,4,Queens,40945002012,88,23,65,4.97
2020,CB2020,081,4,Queens,40945002013,51,11,40,2.66
2020,CB2020,081,4,Queens,40945002014,36,19,17,2.26
2020,CB2020,081,4,Queens,40945002015,87,54,33,3.34
2020,CB2020,081,4,Queens,40945002016,71,29,42,3.93
2020,CB2020,081,4,Queens,40945002017,120,55,65,4.41
2020,CB2020,081,4,Queens,40945002018,82,42,40,4.18
2020,CB2020,081,4,Queens,40945002019,70,39,31,17.8
2020,CB2020,081,4,Queens,40945002020,172,88,84,81.59
2020,CB2020,081,4,Queens,40945002021,56,34,22,2.72
2020,CB2020,081,4,Queens,40945002022,240,125,115,4.43
2020,CB2020,081,4,Queens,40945002023,142,80,62,3.79
2020,CB2020,081,4,Queens,40945002024,149,84,65,2.61
2020,CB2020,081,4,Queens,40945002025,0,0,0,3.07
2020,CB2020,081,4,Queens,40945002026,0,0,0,8.33
2020,CB2020,081,4,Queens,40945002027,0,0,0,3.31
2020,CB2020,081,4,Queens,40945002028,30,15,15,1.13
2020,CB2020,081,4,Queens,40945002029,61,28,33,2.59
2020,CB2020,081,4,Queens,40945002030,52,19,33,2.39
2020,CB2020,081,4,Queens,40947001000,291,139,152,4.44
2020,CB2020,081,4,Queens,40947001001,322,140,182,5
2020,CB2020,081,4,Queens,40947001002,421,208,213,5.6
2020,CB2020,081,4,Queens,40947001003,85,44,41,7.48
2020,CB2020,081,4,Queens,40947001004,13,7,6,4.74
2020,CB2020,081,4,Queens,40947001005,22,13,9,2.06
2020,CB2020,081,4,Queens,40947001006,0,0,0,3.07
2020,CB2020,081,4,Queens,40947001007,114,60,54,3.22
2020,CB2020,081,4,Queens,40947001008,131,65,66,3.21
2020,CB2020,081,4,Queens,40947002000,334,145,189,5.74
2020,CB2020,081,4,Queens,40947002001,163,80,83,2.55
2020,CB2020,081,4,Queens,40947002002,201,118,83,2.5
2020,CB2020,081,4,Queens,40947002003,123,54,69,2.44
2020,CB2020,081,4,Queens,40947002004,170,92,78,2.59
2020,CB2020,081,4,Queens,40947002005,0,0,0,0.36
2020,CB2020,081,4,Queens,40947002006,181,72,109,3.06
2020,CB2020,081,4,Queens,40947002007,172,97,75,2.99
2020,CB2020,081,4,Queens,40947002008,80,34,46,2.92
2020,CB2020,081,4,Queens,40947002009,29,16,13,0.33
2020,CB2020,081,4,Queens,40947002010,183,101,82,3.08
2020,CB2020,081,4,Queens,40954000001,0,0,0,0
2020,CB2020,081,4,Queens,40954000002,0,0,0,0
2020,CB2020,081,4,Queens,40954000003,0,0,0,0
2020,CB2020,081,4,Queens,40954001000,47,14,33,1.49
2020,CB2020,081,4,Queens,40954001001,47,27,20,2.15
2020,CB2020,081,4,Queens,40954001002,178,80,98,4.83
2020,CB2020,081,4,Queens,40954001003,210,94,116,4.72
2020,CB2020,081,4,Queens,40954001004,234,89,145,3.95
2020,CB2020,081,4,Queens,40954001005,19,4,15,10.45
2020,CB2020,081,4,Queens,40954001006,79,28,51,3.09
2020,CB2020,081,4,Queens,40954001007,129,45,84,4.82
2020,CB2020,081,4,Queens,40954001008,38,24,14,1.53
2020,CB2020,081,4,Queens,40954001009,159,76,83,4.04
2020,CB2020,081,4,Queens,40954001010,163,94,69,4.02
2020,CB2020,081,4,Queens,40954001011,182,86,96,4.03
2020,CB2020,081,4,Queens,40954001012,238,129,109,4
2020,CB2020,081,4,Queens,40954001013,288,135,153,3.97
2020,CB2020,081,4,Queens,40954001014,28,13,15,3.92
2020,CB2020,081,4,Queens,40954001015,157,58,99,3.7
2020,CB2020,081,4,Queens,40954001016,79,40,39,3.68
2020,CB2020,081,4,Queens,40954002000,340,161,179,4.92
2020,CB2020,081,4,Queens,40954002001,266,148,118,4.72
2020,CB2020,081,4,Queens,40954002002,173,95,78,4.04
2020,CB2020,081,4,Queens,40954002003,220,88,132,4.01
2020,CB2020,081,4,Queens,40954002004,218,83,135,4.3
2020,CB2020,081,4,Queens,40954002005,167,93,74,4.09
2020,CB2020,081,4,Queens,40954002006,188,76,112,4.21
2020,CB2020,081,4,Queens,40954002007,0,0,0,2.24
2020,CB2020,081,4,Queens,40954002008,0,0,0,2.22
2020,CB2020,081,4,Queens,40954003000,165,60,105,8.74
2020,CB2020,081,4,Queens,40954003001,31,29,2,8.53
2020,CB2020,081,4,Queens,40954003002,73,20,53,3.46
2020,CB2020,081,4,Queens,40954003003,24,11,13,3.11
2020,CB2020,081,4,Queens,40954003004,0,0,0,1.54
2020,CB2020,081,4,Queens,40954003005,490,208,282,6.94
2020,CB2020,081,4,Queens,40954003006,212,101,111,4.29
2020,CB2020,081,4,Queens,40954003007,0,0,0,7.71
2020,CB2020,081,4,Queens,40954003008,66,55,11,1.49
2020,CB2020,081,4,Queens,40954003009,92,47,45,1.77
2020,CB2020,081,4,Queens,40954003010,45,24,21,1.28
2020,CB2020,081,4,Queens,40954003011,0,0,0,0.62
2020,CB2020,081,4,Queens,40954003012,311,146,165,10.44
2020,CB2020,081,4,Queens,40954003013,169,97,72,3.66
2020,CB2020,081,4,Queens,40954003014,17,15,2,0.82
2020,CB2020,081,4,Queens,40954003015,62,24,38,1.48
2020,CB2020,081,4,Queens,40954003016,92,35,57,1.95
2020,CB2020,081,4,Queens,40954003017,64,17,47,1.6
2020,CB2020,081,4,Queens,40954003018,63,26,37,1.27
2020,CB2020,081,4,Queens,40954003019,73,34,39,2.31
2020,CB2020,081,4,Queens,40954003020,74,25,49,1.95
2020,CB2020,081,4,Queens,40954003021,39,27,12,0.85
2020,CB2020,081,4,Queens,40954003022,78,38,40,1.78
2020,CB2020,081,4,Queens,40954003023,21,9,12,0.95
2020,CB2020,081,4,Queens,40954003024,0,0,0,0.34
2020,CB2020,081,4,Queens,40954003025,0,0,0,0.67
2020,CB2020,081,4,Queens,40954003026,0,0,0,14.43
2020,CB2020,081,4,Queens,40954003027,0,0,0,2.75
2020,CB2020,081,4,Queens,40964000001,0,0,0,0
2020,CB2020,081,4,Queens,40964001000,0,0,0,0
2020,CB2020,081,4,Queens,40964001001,57,23,34,32.68
2020,CB2020,081,4,Queens,40964001002,158,66,92,2.97
2020,CB2020,081,4,Queens,40964001003,70,16,54,6.75
2020,CB2020,081,4,Queens,40964001004,270,108,162,5.08
2020,CB2020,081,4,Queens,40964001005,244,144,100,4.5
2020,CB2020,081,4,Queens,40964001006,199,72,127,4.47
2020,CB2020,081,4,Queens,40964001007,135,52,83,2.97
2020,CB2020,081,4,Queens,40964001008,141,66,75,3.03
2020,CB2020,081,4,Queens,40964001009,141,71,70,3.04
2020,CB2020,081,4,Queens,40964001010,173,85,88,3.19
2020,CB2020,081,4,Queens,40964001011,236,107,129,4.81
2020,CB2020,081,4,Queens,40964001012,217,105,112,4.6
2020,CB2020,081,4,Queens,40964001013,48,16,32,4.75
2020,CB2020,081,4,Queens,40964001014,222,99,123,4.49
2020,CB2020,081,4,Queens,40964001015,270,124,146,4.6
2020,CB2020,081,4,Queens,40964001016,92,41,51,4.3
2020,CB2020,081,4,Queens,40964001017,0,0,0,2.59
2020,CB2020,081,4,Queens,40964001018,0,0,0,0
2020,CB2020,081,4,Queens,40964001019,22,16,6,8.08
2020,CB2020,081,4,Queens,40964001020,0,0,0,2.95
2020,CB2020,081,4,Queens,40964001021,0,0,0,4.15
2020,CB2020,081,4,Queens,40964001022,50,27,23,2.2
2020,CB2020,081,4,Queens,40964001023,174,114,60,4.92
2020,CB2020,081,4,Queens,40964002000,0,0,0,1.84
2020,CB2020,081,4,Queens,40964002001,104,36,68,2.28
2020,CB2020,081,4,Queens,40964002002,157,54,103,2.33
2020,CB2020,081,4,Queens,40964002003,174,96,78,2.4
2020,CB2020,081,4,Queens,40964002004,0,0,0,2.19
2020,CB2020,081,4,Queens,40964002005,589,296,293,5.79
2020,CB2020,081,4,Queens,40964002006,294,152,142,3.73
2020,CB2020,081,4,Queens,40964002007,141,53,88,4.16
2020,CB2020,081,4,Queens,40964002008,173,91,82,4.84
2020,CB2020,081,4,Queens,40964002009,60,33,27,3.29
2020,CB2020,081,4,Queens,40964002010,63,34,29,2.45
2020,CB2020,081,4,Queens,40964002011,29,14,15,2.76
2020,CB2020,081,4,Queens,40964002012,94,62,32,2.44
2020,CB2020,081,4,Queens,40964002013,272,111,161,6.02
2020,CB2020,081,4,Queens,40964002014,185,110,75,1.62
2020,CB2020,081,4,Queens,40964002015,0,0,0,0.53
2020,CB2020,081,4,Queens,40964002016,250,107,143,4.47
2020,CB2020,081,4,Queens,40964002017,258,130,128,4.11
2020,CB2020,081,4,Queens,40964002018,139,83,56,3.18
2020,CB2020,081,4,Queens,40964002019,0,0,0,1.13
2020,CB2020,081,4,Queens,40964002020,25,6,19,19.34
2020,CB2020,081,4,Queens,40964002021,91,36,55,4.78
2020,CB2020,081,4,Queens,40964002022,150,74,76,2.72
2020,CB2020,081,4,Queens,40964002023,186,71,115,3.66
2020,CB2020,081,4,Queens,40972020001,0,0,0,0
2020,CB2020,081,4,Queens,40972021000,132,74,58,114.72
2020,CB2020,081,4,Queens,40972021001,9,3,6,1.14
2020,CB2020,081,4,Queens,40972021002,0,0,0,0.4
2020,CB2020,081,4,Queens,40972021003,0,0,0,0.98
2020,CB2020,081,4,Queens,40972021004,0,0,0,2.42
2020,CB2020,081,4,Queens,40972021005,0,0,0,2.77
2020,CB2020,081,4,Queens,40972021006,0,0,0,0.4
2020,CB2020,081,4,Queens,40972021007,0,0,0,0.41
2020,CB2020,081,4,Queens,40972021008,3319,1338,1981,17.47
2020,CB2020,081,4,Queens,40972021009,0,0,0,1.78
2020,CB2020,081,4,Queens,40972041000,186,84,102,4.08
2020,CB2020,081,4,Queens,40972041001,149,71,78,4.43
2020,CB2020,081,4,Queens,40972041002,97,58,39,2.52
2020,CB2020,081,4,Queens,40972041003,93,55,38,3.9
2020,CB2020,081,4,Queens,40972041004,191,107,84,3.92
2020,CB2020,081,4,Queens,40972041005,210,65,145,3.93
2020,CB2020,081,4,Queens,40972041006,178,108,70,4.4
2020,CB2020,081,4,Queens,40972041007,0,0,0,4.89
2020,CB2020,081,4,Queens,40972041008,0,0,0,13.93
2020,CB2020,081,4,Queens,40972041009,558,274,284,5.52
2020,CB2020,081,4,Queens,40972041010,0,0,0,9.29
2020,CB2020,081,4,Queens,40972041011,393,186,207,4
2020,CB2020,081,4,Queens,40972041012,94,43,51,1.37
2020,CB2020,081,4,Queens,40972041013,191,88,103,2.76
2020,CB2020,081,4,Queens,40972041014,22,14,8,1.23
2020,CB2020,081,4,Queens,40972042000,914,360,554,10.34
2020,CB2020,081,4,Queens,40972043000,0,0,0,5.61
2020,CB2020,081,4,Queens,40972043001,719,280,439,7.55
2020,CB2020,081,4,Queens,40972043002,83,46,37,3.16
2020,CB2020,081,4,Queens,40972051000,2475,1043,1432,22.62
2020,CB2020,081,4,Queens,40972051001,0,0,0,4.46
2020,CB2020,081,4,Queens,40972052000,1311,565,746,11.63
2020,CB2020,081,4,Queens,40972052001,482,203,279,4.8
2020,CB2020,081,4,Queens,40972061000,1826,741,1085,28.55
2020,CB2020,081,4,Queens,40972062000,287,133,154,15.5
2020,CB2020,081,4,Queens,40972062001,119,54,65,4.46
2020,CB2020,081,4,Queens,40972062002,69,40,29,1.95
2020,CB2020,081,4,Queens,40972062003,170,72,98,5.44
2020,CB2020,081,4,Queens,40972062004,31,18,13,4.08
2020,CB2020,081,4,Queens,40972062005,146,58,88,4.4
2020,CB2020,081,4,Queens,40972062006,208,98,110,3.46
2020,CB2020,081,4,Queens,40972062007,36,14,22,2.9
2020,CB2020,081,4,Queens,40972062008,18,7,11,5.07
2020,CB2020,081,4,Queens,40972070001,0,0,0,0
2020,CB2020,081,4,Queens,40972070002,0,0,0,0
2020,CB2020,081,4,Queens,40972071000,12,7,5,199.96
2020,CB2020,081,4,Queens,40972071001,0,0,0,2.7
2020,CB2020,081,4,Queens,40972071002,0,0,0,2.93
2020,CB2020,081,4,Queens,40973000001,0,0,0,0
2020,CB2020,081,4,Queens,40973000002,0,0,0,0
2020,CB2020,081,4,Queens,40973001000,65,45,20,4.61
2020,CB2020,081,4,Queens,40973001001,60,34,26,3.64
2020,CB2020,081,4,Queens,40973001002,51,36,15,3.27
2020,CB2020,081,4,Queens,40973001003,0,0,0,11.6
2020,CB2020,081,4,Queens,40973001004,0,0,0,0.83
2020,CB2020,081,4,Queens,40973001005,0,0,0,0.96
2020,CB2020,081,4,Queens,40973001006,0,0,0,7.47
2020,CB2020,081,4,Queens,40973001007,90,33,57,3.88
2020,CB2020,081,4,Queens,40973001008,78,23,55,3.86
2020,CB2020,081,4,Queens,40973001009,51,18,33,3.94
2020,CB2020,081,4,Queens,40973001010,67,49,18,4.28
2020,CB2020,081,4,Queens,40973001011,54,11,43,3.64
2020,CB2020,081,4,Queens,40973001012,114,34,80,3.85
2020,CB2020,081,4,Queens,40973001013,120,75,45,5.63
2020,CB2020,081,4,Queens,40973001014,0,0,0,2.36
2020,CB2020,081,4,Queens,40973001015,0,0,0,1.05
2020,CB2020,081,4,Queens,40973002000,62,36,26,3.38
2020,CB2020,081,4,Queens,40973002001,58,34,24,3.89
2020,CB2020,081,4,Queens,40973002002,101,44,57,4.14
2020,CB2020,081,4,Queens,40973002003,37,6,31,1.41
2020,CB2020,081,4,Queens,40973002004,60,35,25,3.05
2020,CB2020,081,4,Queens,40973002005,55,37,18,2.56
2020,CB2020,081,4,Queens,40973002006,107,45,62,4.67
2020,CB2020,081,4,Queens,40973002007,74,27,47,2.18
2020,CB2020,081,4,Queens,40973003000,108,59,49,5.9
2020,CB2020,081,4,Queens,40973003001,86,66,20,6.89
2020,CB2020,081,4,Queens,40973003002,108,45,63,6.39
2020,CB2020,081,4,Queens,40973003003,87,21,66,4.15
2020,CB2020,081,4,Queens,40973003004,58,27,31,4.55
2020,CB2020,081,4,Queens,40973003005,68,39,29,3.95
2020,CB2020,081,4,Queens,40973003006,52,20,32,2.89
2020,CB2020,081,4,Queens,40973003007,43,23,20,2.4
2020,CB2020,081,4,Queens,40973003008,93,53,40,3.39
2020,CB2020,081,4,Queens,40981000001,0,0,0,0
2020,CB2020,081,4,Queens,40981001000,241,111,130,35.57
2020,CB2020,081,4,Queens,40981001001,100,49,51,6.17
2020,CB2020,081,4,Queens,40981001002,93,66,27,5.26
2020,CB2020,081,4,Queens,40981001003,155,78,77,12.42
2020,CB2020,081,4,Queens,40981001004,70,32,38,3.99
2020,CB2020,081,4,Queens,40981001005,78,45,33,3.55
2020,CB2020,081,4,Queens,40981001006,59,18,41,3.3
2020,CB2020,081,4,Queens,40981001007,121,72,49,7.82
2020,CB2020,081,4,Queens,40981001008,61,18,43,3.92
2020,CB2020,081,4,Queens,40981001009,105,59,46,4.92
2020,CB2020,081,4,Queens,40981001010,70,29,41,4.18
2020,CB2020,081,4,Queens,40981001011,65,29,36,3.53
2020,CB2020,081,4,Queens,40981001012,0,0,0,3.29
2020,CB2020,081,4,Queens,40981002000,104,50,54,4.7
2020,CB2020,081,4,Queens,40981002001,28,19,9,1.9
2020,CB2020,081,4,Queens,40981002002,41,30,11,2.17
2020,CB2020,081,4,Queens,40981002003,91,54,37,3.4
2020,CB2020,081,4,Queens,40981002004,97,45,52,3.94
2020,CB2020,081,4,Queens,40981002005,76,29,47,5.52
2020,CB2020,081,4,Queens,40981002006,70,15,55,4.77
2020,CB2020,081,4,Queens,40981002007,99,45,54,3.82
2020,CB2020,081,4,Queens,40981002008,91,51,40,4.32
2020,CB2020,081,4,Queens,40981002009,69,39,30,5.46
2020,CB2020,081,4,Queens,40981002010,135,89,46,5.11
2020,CB2020,081,4,Queens,40981002011,129,57,72,5.51
2020,CB2020,081,4,Queens,40981002012,38,23,15,5.45
2020,CB2020,081,4,Queens,40981002013,67,28,39,4.51
2020,CB2020,081,4,Queens,40981002014,0,0,0,1.45
2020,CB2020,081,4,Queens,40981002015,0,0,0,0.8
2020,CB2020,081,4,Queens,40987000001,0,0,0,0
2020,CB2020,081,4,Queens,40987001000,248,134,114,41.92
2020,CB2020,081,4,Queens,40987001001,122,29,93,6.53
2020,CB2020,081,4,Queens,40987001002,0,0,0,1.2
2020,CB2020,081,4,Queens,40987001003,90,47,43,5.31
2020,CB2020,081,4,Queens,40987001004,202,94,108,7.26
2020,CB2020,081,4,Queens,40987001005,161,91,70,6.08
2020,CB2020,081,4,Queens,40987001006,91,34,57,4.9
2020,CB2020,081,4,Queens,40987001007,59,24,35,2.53
2020,CB2020,081,4,Queens,40987001008,70,55,15,2.65
2020,CB2020,081,4,Queens,40987001009,75,48,27,3.36
2020,CB2020,081,4,Queens,40987001010,55,38,17,2.58
2020,CB2020,081,4,Queens,40987001011,120,60,60,4.59
2020,CB2020,081,4,Queens,40987001012,123,56,67,4.59
2020,CB2020,081,4,Queens,40987002000,132,50,82,4.73
2020,CB2020,081,4,Queens,40987002001,35,21,14,5.23
2020,CB2020,081,4,Queens,40987002002,180,95,85,4.17
2020,CB2020,081,4,Queens,40987002003,163,91,72,4.71
2020,CB2020,081,4,Queens,40987002004,114,51,63,5.37
2020,CB2020,081,4,Queens,40987002005,135,55,80,8.21
2020,CB2020,081,4,Queens,40987002006,58,30,28,3.98
2020,CB2020,081,4,Queens,40987002007,18,13,5,2.59
2020,CB2020,081,4,Queens,40987002008,109,58,51,6.79
2020,CB2020,081,4,Queens,40987002009,29,16,13,3.38
2020,CB2020,081,4,Queens,40987002010,154,76,78,15.13
2020,CB2020,081,4,Queens,40987002011,0,0,0,2.44
2020,CB2020,081,4,Queens,40987002012,0,0,0,2.6
2020,CB2020,081,4,Queens,40987002013,0,0,0,0.96
2020,CB2020,081,4,Queens,40987002014,0,0,0,1.1
2020,CB2020,081,4,Queens,40991000001,0,0,0,0
2020,CB2020,081,4,Queens,40991001000,938,387,551,20.62
2020,CB2020,081,4,Queens,40991001001,602,241,361,11.67
2020,CB2020,081,4,Queens,40991001002,162,85,77,3.4
2020,CB2020,081,4,Queens,40991001003,101,52,49,2.73
2020,CB2020,081,4,Queens,40991001004,60,21,39,2.57
2020,CB2020,081,4,Queens,40991002000,405,184,221,4.4
2020,CB2020,081,4,Queens,40991002001,426,180,246,5.03
2020,CB2020,081,4,Queens,40991002002,700,305,395,10.2
2020,CB2020,081,4,Queens,40991003000,0,0,0,12.46
2020,CB2020,081,4,Queens,40991003001,28,16,12,0.82
2020,CB2020,081,4,Queens,40991003002,45,12,33,2.69
2020,CB2020,081,4,Queens,40991003003,45,24,21,2.57
2020,CB2020,081,4,Queens,40991003004,35,20,15,2.57
2020,CB2020,081,4,Queens,40991003005,80,49,31,4.3
2020,CB2020,081,4,Queens,40991003006,84,31,53,4.72
2020,CB2020,081,4,Queens,40991003007,47,26,21,3.15
2020,CB2020,081,4,Queens,40991003008,35,18,17,1.92
2020,CB2020,081,4,Queens,40991003009,41,15,26,2.15
2020,CB2020,081,4,Queens,40991003010,45,39,6,3.14
2020,CB2020,081,4,Queens,40991003011,0,0,0,1.02
2020,CB2020,081,4,Queens,40991003012,0,0,0,0.94
2020,CB2020,081,4,Queens,40991003013,0,0,0,0.41
2020,CB2020,081,4,Queens,40991003014,0,0,0,3.68
2020,CB2020,081,4,Queens,40991003015,54,30,24,2.14
2020,CB2020,081,4,Queens,40991003016,64,24,40,3.28
2020,CB2020,081,4,Queens,40991003017,44,30,14,3.24
2020,CB2020,081,4,Queens,40991003018,32,14,18,2.08
2020,CB2020,081,4,Queens,40991003019,26,9,17,2.38
2020,CB2020,081,4,Queens,40991004000,75,38,37,5.47
2020,CB2020,081,4,Queens,40991004001,33,12,21,2.12
2020,CB2020,081,4,Queens,40991004002,41,17,24,2.81
2020,CB2020,081,4,Queens,40991004003,38,23,15,3.25
2020,CB2020,081,4,Queens,40991004004,79,49,30,3.57
2020,CB2020,081,4,Queens,40991004005,63,34,29,3.94
2020,CB2020,081,4,Queens,40991004006,94,47,47,4.28
2020,CB2020,081,4,Queens,40991004007,113,57,56,4.59
2020,CB2020,081,4,Queens,40991004008,78,45,33,5.22
2020,CB2020,081,4,Queens,40991004009,34,21,13,1.57
2020,CB2020,081,4,Queens,40991004010,43,13,30,1.29
2020,CB2020,081,4,Queens,40991004011,77,41,36,3.38
2020,CB2020,081,4,Queens,40991004012,41,34,7,2.28
2020,CB2020,081,4,Queens,40991004013,50,19,31,2.53
2020,CB2020,081,4,Queens,40991004014,34,7,27,2.91
2020,CB2020,081,4,Queens,40991004015,77,25,52,4.15
2020,CB2020,081,4,Queens,40991004016,54,18,36,4.56
2020,CB2020,081,4,Queens,40991004017,31,14,17,2.63
2020,CB2020,081,4,Queens,40991004018,16,9,7,2.05
2020,CB2020,081,4,Queens,40991004019,18,2,16,2.19
2020,CB2020,081,4,Queens,40991004020,33,14,19,2.36
2020,CB2020,081,4,Queens,40991004021,0,0,0,3.92
2020,CB2020,081,4,Queens,40991004022,0,0,0,2.02
2020,CB2020,081,4,Queens,40991004023,0,0,0,1.65
2020,CB2020,081,4,Queens,40991004024,0,0,0,2.9
2020,CB2020,081,4,Queens,40991004025,0,0,0,1.15
2020,CB2020,081,4,Queens,40991005000,86,36,50,4.26
2020,CB2020,081,4,Queens,40991005001,154,71,83,6.45
2020,CB2020,081,4,Queens,40991005002,117,53,64,4.55
2020,CB2020,081,4,Queens,40991005003,41,23,18,2.96
2020,CB2020,081,4,Queens,40991005004,34,16,18,2.95
2020,CB2020,081,4,Queens,40991005005,84,34,50,4.54
2020,CB2020,081,4,Queens,40991005006,114,47,67,4.54
2020,CB2020,081,4,Queens,40991005007,37,25,12,2.94
2020,CB2020,081,4,Queens,40991005008,61,50,11,2.9
2020,CB2020,081,4,Queens,40991005009,83,21,62,4.53
2020,CB2020,081,4,Queens,40991005010,110,61,49,4.49
2020,CB2020,081,4,Queens,40991005011,116,63,53,4.59
2020,CB2020,081,4,Queens,40991005012,94,51,43,4.55
2020,CB2020,081,4,Queens,40991005013,45,27,18,2.89
2020,CB2020,081,4,Queens,40991005014,48,17,31,2.82
2020,CB2020,081,4,Queens,40991005015,70,37,33,4.53
2020,CB2020,081,4,Queens,40991005016,127,51,76,4.58
2020,CB2020,081,4,Queens,40992000001,0,0,0,0
2020,CB2020,081,4,Queens,40992001000,473,216,257,4.46
2020,CB2020,081,4,Queens,40992001001,183,99,84,5.2
2020,CB2020,081,4,Queens,40992001002,1086,499,587,10.65
2020,CB2020,081,4,Queens,40992001003,15,10,5,3.36
2020,CB2020,081,4,Queens,40992001004,101,38,63,3.8
2020,CB2020,081,4,Queens,40992001005,297,139,158,4.54
2020,CB2020,081,4,Queens,40992001006,562,261,301,4.79
2020,CB2020,081,4,Queens,40992001007,335,180,155,2.28
2020,CB2020,081,4,Queens,40992001008,141,57,84,2.48
2020,CB2020,081,4,Queens,40992002000,154,81,73,4.04
2020,CB2020,081,4,Queens,40992002001,157,87,70,4.9
2020,CB2020,081,4,Queens,40992002002,158,62,96,4.68
2020,CB2020,081,4,Queens,40992002003,17,11,6,2.69
2020,CB2020,081,4,Queens,40992002004,70,40,30,5.37
2020,CB2020,081,4,Queens,40992002005,0,0,0,0.53
2020,CB2020,081,4,Queens,40992002006,0,0,0,0.37
2020,CB2020,081,4,Queens,40992002007,0,0,0,1.74
2020,CB2020,081,4,Queens,40992002008,0,0,0,1.04
2020,CB2020,081,4,Queens,40992002009,0,0,0,0.44
2020,CB2020,081,4,Queens,40992002010,0,0,0,6.29
2020,CB2020,081,4,Queens,40992002011,0,0,0,6.19
2020,CB2020,081,4,Queens,40992002012,39,20,19,7.74
2020,CB2020,081,4,Queens,40992002013,0,0,0,6.54
2020,CB2020,081,4,Queens,40992002014,0,0,0,1.72
2020,CB2020,081,4,Queens,40992002015,0,0,0,0.46
2020,CB2020,081,4,Queens,40992002016,0,0,0,1.11
2020,CB2020,081,4,Queens,40992002017,175,71,104,2.94
2020,CB2020,081,4,Queens,40992002018,66,21,45,3.02
2020,CB2020,081,4,Queens,40992002019,120,56,64,2.79
2020,CB2020,081,4,Queens,40992002020,140,44,96,3.71
2020,CB2020,081,4,Queens,40992002021,0,0,0,6.01
2020,CB2020,081,4,Queens,40992002022,0,0,0,4.34
2020,CB2020,081,4,Queens,40992002023,0,0,0,19.92
2020,CB2020,081,4,Queens,40992002024,43,19,24,1.31
2020,CB2020,081,4,Queens,40992002025,16,8,8,1.49
2020,CB2020,081,4,Queens,40992002026,0,0,0,0.76
2020,CB2020,081,4,Queens,40997011000,0,0,0,1.81
2020,CB2020,081,4,Queens,40997011001,59,45,14,121.34
2020,CB2020,081,4,Queens,40997011002,0,0,0,3.41
2020,CB2020,081,4,Queens,40997011003,34,5,29,13.3
2020,CB2020,081,4,Queens,40997011004,59,35,24,2.03
2020,CB2020,081,4,Queens,40997011005,146,74,72,2.05
2020,CB2020,081,4,Queens,40997011006,59,33,26,2.23
2020,CB2020,081,4,Queens,40997011007,90,27,63,2.45
2020,CB2020,081,4,Queens,40997011008,68,25,43,1.68
2020,CB2020,081,4,Queens,40997011009,82,47,35,2.79
2020,CB2020,081,4,Queens,40997011010,105,45,60,2.97
2020,CB2020,081,4,Queens,40997011011,64,23,41,1.28
2020,CB2020,081,4,Queens,40997011012,153,75,78,3.93
2020,CB2020,081,4,Queens,40997011013,74,26,48,3.45
2020,CB2020,081,4,Queens,40997011014,114,81,33,3.42
2020,CB2020,081,4,Queens,40997012000,125,72,53,5.5
2020,CB2020,081,4,Queens,40997012001,95,39,56,5.39
2020,CB2020,081,4,Queens,40997012002,83,52,31,5.01
2020,CB2020,081,4,Queens,40997012003,108,57,51,4.66
2020,CB2020,081,4,Queens,40997012004,52,32,20,1.99
2020,CB2020,081,4,Queens,40997012005,33,13,20,1.25
2020,CB2020,081,4,Queens,40997012006,88,47,41,3.7
2020,CB2020,081,4,Queens,40997012007,68,35,33,3.61
2020,CB2020,081,4,Queens,40997012008,117,51,66,3.84
2020,CB2020,081,4,Queens,40997012009,28,13,15,2.04
2020,CB2020,081,4,Queens,40997012010,49,17,32,1.98
2020,CB2020,081,4,Queens,40997012011,66,35,31,1.24
2020,CB2020,081,4,Queens,40997012012,51,21,30,1.64
2020,CB2020,081,4,Queens,40997012013,49,13,36,1.35
2020,CB2020,081,4,Queens,40997013000,100,48,52,2.68
2020,CB2020,081,4,Queens,40997013001,164,75,89,5.6
2020,CB2020,081,4,Queens,40997013002,230,113,117,8.06
2020,CB2020,081,4,Queens,40997013003,95,30,65,2.79
2020,CB2020,081,4,Queens,40997013004,285,118,167,7.85
2020,CB2020,081,4,Queens,40997013005,82,55,27,2.62
2020,CB2020,081,4,Queens,40997031000,0,0,0,1.85
2020,CB2020,081,4,Queens,40997031001,0,0,0,1.51
2020,CB2020,081,4,Queens,40997031002,152,57,95,8.94
2020,CB2020,081,4,Queens,40997031003,261,137,124,5.82
2020,CB2020,081,4,Queens,40997031004,244,93,151,4.61
2020,CB2020,081,4,Queens,40997031005,203,103,100,3.84
2020,CB2020,081,4,Queens,40997031006,163,71,92,3.7
2020,CB2020,081,4,Queens,40997031007,274,128,146,4.94
2020,CB2020,081,4,Queens,40997031008,130,54,76,2.98
2020,CB2020,081,4,Queens,40997032000,0,0,0,5.15
2020,CB2020,081,4,Queens,40997032001,0,0,0,2.69
2020,CB2020,081,4,Queens,40997032002,1150,470,680,25.47
2020,CB2020,081,4,Queens,40997032003,60,24,36,3.18
2020,CB2020,081,4,Queens,40997033000,0,0,0,3.89
2020,CB2020,081,4,Queens,40997033001,0,0,0,1.73
2020,CB2020,081,4,Queens,40997033002,155,74,81,20.09
2020,CB2020,081,4,Queens,40997033003,752,331,421,17.18
2020,CB2020,081,4,Queens,40997033004,135,61,74,3.07
2020,CB2020,081,4,Queens,40997033005,58,28,30,4.06
2020,CB2020,081,4,Queens,40997033006,60,45,15,4.71
2020,CB2020,081,4,Queens,40997033007,47,32,15,4.55
2020,CB2020,081,4,Queens,40997033008,30,10,20,3.7
2020,CB2020,081,4,Queens,40997033009,64,20,44,4.82
2020,CB2020,081,4,Queens,40997041000,852,362,490,24.32
2020,CB2020,081,4,Queens,40997041001,654,278,376,23.18
2020,CB2020,081,4,Queens,40997041002,0,0,0,0.27
2020,CB2020,081,4,Queens,40997042000,1021,467,554,18.73
2020,CB2020,081,4,Queens,40997042001,624,266,358,16.11
2020,CB2020,081,4,Queens,40997043000,1112,479,633,18.3
2020,CB2020,081,4,Queens,40997043001,550,215,335,12.61
2020,CB2020,081,4,Queens,40997043002,0,0,0,1.08
2020,CB2020,081,4,Queens,40997043003,0,0,0,1.49
2020,CB2020,081,4,Queens,40997043004,0,0,0,1.38
2020,CB2020,081,4,Queens,40997044000,394,186,208,33.13
2020,CB2020,081,4,Queens,40997045000,960,422,538,5.38
2020,CB2020,081,4,Queens,40997045001,1113,473,640,11.04
2020,CB2020,081,4,Queens,40997050001,0,0,0,0
2020,CB2020,081,4,Queens,40997050002,0,0,0,0
2020,CB2020,081,4,Queens,40997051000,0,0,0,28.83
2020,CB2020,081,4,Queens,40997051001,0,0,0,0.75
2020,CB2020,081,4,Queens,40997051002,0,0,0,0.88
2020,CB2020,081,4,Queens,40997051003,0,0,0,0.37
2020,CB2020,081,4,Queens,40997051004,0,0,0,1.51
2020,CB2020,081,4,Queens,40997051005,0,0,0,8.32
2020,CB2020,081,4,Queens,40997051006,0,0,0,0.43
2020,CB2020,081,4,Queens,40997051007,1043,502,541,28.24
2020,CB2020,081,4,Queens,40997051008,191,88,103,2.54
2020,CB2020,081,4,Queens,40997051009,56,21,35,1.59
2020,CB2020,081,4,Queens,40997051010,121,66,55,5.15
2020,CB2020,081,4,Queens,40997051011,498,196,302,9.56
2020,CB2020,081,4,Queens,40997051012,95,56,39,1.92
2020,CB2020,081,4,Queens,40997051013,0,0,0,0.67
2020,CB2020,081,4,Queens,40997051014,296,171,125,5.02
2020,CB2020,081,4,Queens,40997051015,102,62,40,1.31
2020,CB2020,081,4,Queens,40997051016,47,15,32,3.42
2020,CB2020,081,4,Queens,40997051017,238,105,133,4.86
2020,CB2020,081,4,Queens,40997051018,0,0,0,3.35
2020,CB2020,081,4,Queens,40998011000,199,102,97,3.67
2020,CB2020,081,4,Queens,40998011001,212,102,110,2.51
2020,CB2020,081,4,Queens,40998011002,0,0,0,0.82
2020,CB2020,081,4,Queens,40998011003,79,29,50,1.86
2020,CB2020,081,4,Queens,40998011004,68,27,41,4.75
2020,CB2020,081,4,Queens,40998011005,145,71,74,2.82
2020,CB2020,081,4,Queens,40998011006,79,41,38,2.12
2020,CB2020,081,4,Queens,40998011007,67,29,38,2.29
2020,CB2020,081,4,Queens,40998011008,152,82,70,2.75
2020,CB2020,081,4,Queens,40998011009,207,66,141,1.78
2020,CB2020,081,4,Queens,40998011010,71,48,23,1.39
2020,CB2020,081,4,Queens,40998011011,72,21,51,0.62
2020,CB2020,081,4,Queens,40998011012,66,45,21,1.71
2020,CB2020,081,4,Queens,40998012000,959,493,466,5.93
2020,CB2020,081,4,Queens,40998012001,1014,486,528,5.45
2020,CB2020,081,4,Queens,40998013000,1102,521,581,11.03
2020,CB2020,081,4,Queens,40998013001,0,0,0,6.14
2020,CB2020,081,4,Queens,40998013002,228,129,99,5.2
2020,CB2020,081,4,Queens,40998013003,163,75,88,3.59
2020,CB2020,081,4,Queens,40998013004,151,60,91,4.12
2020,CB2020,081,4,Queens,40998014000,1156,548,608,12.84
2020,CB2020,081,4,Queens,40998014001,510,233,277,4.21
2020,CB2020,081,4,Queens,40998014002,0,0,0,0.38
2020,CB2020,081,4,Queens,40998015000,142,45,97,1.9
2020,CB2020,081,4,Queens,40998015001,52,15,37,1.01
2020,CB2020,081,4,Queens,40998015002,104,58,46,2.13
2020,CB2020,081,4,Queens,40998015003,167,71,96,3.28
2020,CB2020,081,4,Queens,40998015004,101,51,50,2.53
2020,CB2020,081,4,Queens,40998015005,108,67,41,2.33
2020,CB2020,081,4,Queens,40998015006,112,46,66,2.29
2020,CB2020,081,4,Queens,40998015007,59,29,30,1.44
2020,CB2020,081,4,Queens,40998015008,140,67,73,3.05
2020,CB2020,081,4,Queens,40998015009,136,73,63,2.84
2020,CB2020,081,4,Queens,40998015010,32,8,24,2.07
2020,CB2020,081,4,Queens,40998020001,0,0,0,0
2020,CB2020,081,4,Queens,40998020002,0,0,0,0
2020,CB2020,081,4,Queens,40998021000,0,0,0,0.36
2020,CB2020,081,4,Queens,40998021001,88,50,38,1.6
2020,CB2020,081,4,Queens,40998021002,61,22,39,1.45
2020,CB2020,081,4,Queens,40998021003,53,21,32,2.39
2020,CB2020,081,4,Queens,40998021004,336,150,186,2.47
2020,CB2020,081,4,Queens,40998021005,142,56,86,2.52
2020,CB2020,081,4,Queens,40998021006,429,188,241,3.76
2020,CB2020,081,4,Queens,40998021007,173,70,103,12.2
2020,CB2020,081,4,Queens,40998021008,548,257,291,5.55
2020,CB2020,081,4,Queens,40998021009,402,168,234,5.74
2020,CB2020,081,4,Queens,40998021010,98,65,33,3.29
2020,CB2020,081,4,Queens,40998021011,0,0,0,23.08
2020,CB2020,081,4,Queens,40998021012,266,153,113,12.69
2020,CB2020,081,4,Queens,40998022000,822,387,435,10.17
2020,CB2020,081,4,Queens,40998022001,1038,472,566,12.56
2020,CB2020,081,4,Queens,40998023000,1366,506,860,7.58
2020,CB2020,081,4,Queens,40999001000,0,0,0,93.97
2020,CB2020,081,4,Queens,40999001001,0,0,0,3.49
2020,CB2020,081,4,Queens,40999001002,0,0,0,0.44
2020,CB2020,081,4,Queens,40999001003,0,0,0,1.84
2020,CB2020,081,4,Queens,40999001004,0,0,0,0.57
2020,CB2020,081,4,Queens,40999001005,0,0,0,4.13
2020,CB2020,081,4,Queens,40999001006,0,0,0,2.45
2020,CB2020,081,4,Queens,40999001007,0,0,0,3.28
2020,CB2020,081,4,Queens,40999001008,0,0,0,4.96
2020,CB2020,081,4,Queens,40999001009,0,0,0,2.28
2020,CB2020,081,4,Queens,40999001010,0,0,0,5.17
2020,CB2020,081,4,Queens,40999001011,0,0,0,4.54
2020,CB2020,081,4,Queens,40999001012,0,0,0,3.25
2020,CB2020,081,4,Queens,40999001013,0,0,0,1.27
2020,CB2020,081,4,Queens,40999001014,0,0,0,3.02
2020,CB2020,081,4,Queens,40999001015,0,0,0,3.28
2020,CB2020,081,4,Queens,40999001016,0,0,0,1.67
2020,CB2020,081,4,Queens,40999001017,0,0,0,3.38
2020,CB2020,081,4,Queens,40999001018,0,0,0,0.51
2020,CB2020,081,4,Queens,40999001019,0,0,0,2.22
2020,CB2020,081,4,Queens,40999001020,0,0,0,1.16
2020,CB2020,081,4,Queens,40999001021,0,0,0,3.85
2020,CB2020,081,4,Queens,40999001022,0,0,0,7.06
2020,CB2020,081,4,Queens,40999001023,0,0,0,0.92
2020,CB2020,081,4,Queens,40999001024,0,0,0,0.93
2020,CB2020,081,4,Queens,40999001025,0,0,0,0.57
2020,CB2020,081,4,Queens,41008010001,0,0,0,0
2020,CB2020,081,4,Queens,41008010002,0,0,0,0
2020,CB2020,081,4,Queens,41008011000,213,104,109,12.52
2020,CB2020,081,4,Queens,41008011001,203,99,104,6.93
2020,CB2020,081,4,Queens,41008011002,202,106,96,9.72
2020,CB2020,081,4,Queens,41008011003,70,37,33,4.39
2020,CB2020,081,4,Queens,41008011004,0,0,0,4.31
2020,CB2020,081,4,Queens,41008011005,110,50,60,3.97
2020,CB2020,081,4,Queens,41008011006,83,27,56,3.32
2020,CB2020,081,4,Queens,41008011007,95,46,49,4.31
2020,CB2020,081,4,Queens,41008012000,0,0,0,0
2020,CB2020,081,4,Queens,41008012001,140,66,74,33.46
2020,CB2020,081,4,Queens,41008012002,170,95,75,7.25
2020,CB2020,081,4,Queens,41008012003,90,24,66,2.66
2020,CB2020,081,4,Queens,41008012004,373,194,179,19.78
2020,CB2020,081,4,Queens,41008012005,85,22,63,3.9
2020,CB2020,081,4,Queens,41008012006,243,155,88,30.2
2020,CB2020,081,4,Queens,41008012007,70,42,28,0.82
2020,CB2020,081,4,Queens,41008012008,192,95,97,6.73
2020,CB2020,081,4,Queens,41008012009,157,83,74,5.09
2020,CB2020,081,4,Queens,41008031000,274,110,164,8.13
2020,CB2020,081,4,Queens,41008031001,0,0,0,0.5
2020,CB2020,081,4,Queens,41008031002,218,115,103,4.44
2020,CB2020,081,4,Queens,41008031003,210,104,106,3.72
2020,CB2020,081,4,Queens,41008031004,90,35,55,2.13
2020,CB2020,081,4,Queens,41008031005,50,27,23,0.85
2020,CB2020,081,4,Queens,41008031006,379,118,261,5.81
2020,CB2020,081,4,Queens,41008031007,80,32,48,3.89
2020,CB2020,081,4,Queens,41008031008,242,106,136,5.98
2020,CB2020,081,4,Queens,41008031009,578,253,325,5.74
2020,CB2020,081,4,Queens,41008031010,86,44,42,1.83
2020,CB2020,081,4,Queens,41008031011,406,187,219,3.25
2020,CB2020,081,4,Queens,41008032000,811,389,422,10.84
2020,CB2020,081,4,Queens,41008032001,194,91,103,3.9
2020,CB2020,081,4,Queens,41008032002,304,137,167,9.27
2020,CB2020,081,4,Queens,41008032003,45,10,35,1.29
2020,CB2020,081,4,Queens,41008032004,0,0,0,0.73
2020,CB2020,081,4,Queens,41008032005,0,0,0,0.33
2020,CB2020,081,4,Queens,41008032006,113,52,61,2.09
2020,CB2020,081,4,Queens,41008032007,453,215,238,2.64
2020,CB2020,081,4,Queens,41008032008,102,66,36,3.26
2020,CB2020,081,4,Queens,41008032009,0,0,0,0.34
2020,CB2020,081,4,Queens,41008032010,0,0,0,1.47
2020,CB2020,081,4,Queens,41008032011,182,68,114,3.39
2020,CB2020,081,4,Queens,41008040001,0,0,0,0
2020,CB2020,081,4,Queens,41008041000,136,75,61,7.27
2020,CB2020,081,4,Queens,41008041001,136,65,71,7.87
2020,CB2020,081,4,Queens,41008041002,161,75,86,7.82
2020,CB2020,081,4,Queens,41008041003,151,93,58,4.89
2020,CB2020,081,4,Queens,41008041004,0,0,0,8.81
2020,CB2020,081,4,Queens,41008041005,168,73,95,5.05
2020,CB2020,081,4,Queens,41008041006,197,71,126,2.72
2020,CB2020,081,4,Queens,41008041007,297,122,175,4.19
2020,CB2020,081,4,Queens,41008041008,282,145,137,3.96
2020,CB2020,081,4,Queens,41008041009,212,118,94,4.68
2020,CB2020,081,4,Queens,41008041010,174,80,94,2.8
2020,CB2020,081,4,Queens,41008041011,168,63,105,3.13
2020,CB2020,081,4,Queens,41008041012,349,191,158,3.91
2020,CB2020,081,4,Queens,41008042000,95,57,38,5.29
2020,CB2020,081,4,Queens,41008042001,183,92,91,6.32
2020,CB2020,081,4,Queens,41008042002,208,86,122,12.31
2020,CB2020,081,4,Queens,41008042003,166,100,66,5.49
2020,CB2020,081,4,Queens,41008042004,147,76,71,7.06
2020,CB2020,081,4,Queens,41008042005,138,86,52,4.91
2020,CB2020,081,4,Queens,41008042006,119,41,78,8.01
2020,CB2020,081,4,Queens,41008042007,235,90,145,6.63
2020,CB2020,081,4,Queens,41008042008,92,32,60,0.62
2020,CB2020,081,4,Queens,41008042009,79,27,52,3.45
2020,CB2020,081,4,Queens,41008042010,94,67,27,3.41
2020,CB2020,081,4,Queens,41008042011,328,186,142,40.25
2020,CB2020,081,4,Queens,41010020001,0,0,0,0
2020,CB2020,081,4,Queens,41010021000,524,255,269,20.28
2020,CB2020,081,4,Queens,41010021001,113,49,64,3.19
2020,CB2020,081,4,Queens,41010021002,153,94,59,3.06
2020,CB2020,081,4,Queens,41010021003,77,39,38,3.89
2020,CB2020,081,4,Queens,41010021004,35,12,23,2.07
2020,CB2020,081,4,Queens,41010021005,62,31,31,2.93
2020,CB2020,081,4,Queens,41010021006,256,112,144,10.45
2020,CB2020,081,4,Queens,41010021007,234,134,100,8.13
2020,CB2020,081,4,Queens,41010021008,93,45,48,2.89
2020,CB2020,081,4,Queens,41010021009,31,11,20,3.47
2020,CB2020,081,4,Queens,41010021010,1,1,0,0.72
2020,CB2020,081,4,Queens,41010021011,9,2,7,0.84
2020,CB2020,081,4,Queens,41010021012,208,144,64,3.78
2020,CB2020,081,4,Queens,41010021013,128,50,78,2.74
2020,CB2020,081,4,Queens,41010021014,85,36,49,2.74
2020,CB2020,081,4,Queens,41010021015,160,88,72,3.94
2020,CB2020,081,4,Queens,41010021016,44,16,28,3.58
2020,CB2020,081,4,Queens,41010021017,64,38,26,4.41
2020,CB2020,081,4,Queens,41010021018,29,9,20,3.83
2020,CB2020,081,4,Queens,41010021019,418,210,208,13.91
2020,CB2020,081,4,Queens,41010022000,97,43,54,13.5
2020,CB2020,081,4,Queens,41010022001,0,0,0,0
2020,CB2020,081,4,Queens,41010022002,1704,775,929,16.83
2020,CB2020,081,4,Queens,41010022003,71,33,38,0.95
2020,CB2020,081,4,Queens,41010031000,383,171,212,5.87
2020,CB2020,081,4,Queens,41010031001,288,137,151,2.73
2020,CB2020,081,4,Queens,41010031002,158,74,84,2.24
2020,CB2020,081,4,Queens,41010031003,119,51,68,1.56
2020,CB2020,081,4,Queens,41010031004,734,305,429,7.86
2020,CB2020,081,4,Queens,41010031005,32,15,17,4.1
2020,CB2020,081,4,Queens,41010031006,84,52,32,4.7
2020,CB2020,081,4,Queens,41010032000,866,448,418,8.43
2020,CB2020,081,4,Queens,41010033000,105,59,46,7.08
2020,CB2020,081,4,Queens,41010033001,168,86,82,4.77
2020,CB2020,081,4,Queens,41010033002,485,284,201,3.65
2020,CB2020,081,4,Queens,41010033003,521,248,273,4.95
2020,CB2020,081,4,Queens,41010040001,0,0,0,0
2020,CB2020,081,4,Queens,41010041000,202,102,100,3.67
2020,CB2020,081,4,Queens,41010041001,306,165,141,5.76
2020,CB2020,081,4,Queens,41010041002,166,82,84,12.79
2020,CB2020,081,4,Queens,41010041003,901,439,462,12.52
2020,CB2020,081,4,Queens,41010042000,420,209,211,10.77
2020,CB2020,081,4,Queens,41010042001,306,158,148,4.75
2020,CB2020,081,4,Queens,41010042002,393,242,151,6.65
2020,CB2020,081,4,Queens,41010042003,165,97,68,2.73
2020,CB2020,081,4,Queens,41010042004,113,43,70,2.44
2020,CB2020,081,4,Queens,41010042005,516,216,300,6.16
2020,CB2020,081,4,Queens,41010042006,176,111,65,1.16
2020,CB2020,081,4,Queens,41010043000,155,86,69,2.18
2020,CB2020,081,4,Queens,41010043001,223,96,127,2.42
2020,CB2020,081,4,Queens,41010043002,94,36,58,2.62
2020,CB2020,081,4,Queens,41010043003,310,153,157,4.05
2020,CB2020,081,4,Queens,41010043004,321,164,157,4.01
2020,CB2020,081,4,Queens,41010043005,459,227,232,4.88
2020,CB2020,081,4,Queens,41010043006,104,55,49,1.95
2020,CB2020,081,4,Queens,41010043007,0,0,0,1.68
2020,CB2020,081,4,Queens,41010043008,16,5,11,0.55
2020,CB2020,081,4,Queens,41010043009,0,0,0,0.92
2020,CB2020,081,4,Queens,41010044000,21,12,9,30.43
2020,CB2020,081,4,Queens,41010045000,1245,517,728,15.88
2020,CB2020,081,4,Queens,41017001000,0,0,0,1.25
2020,CB2020,081,4,Queens,41017001001,83,38,45,1.25
2020,CB2020,081,4,Queens,41017001002,84,45,39,2.99
2020,CB2020,081,4,Queens,41017001003,92,53,39,4.65
2020,CB2020,081,4,Queens,41017001004,117,56,61,4.6
2020,CB2020,081,4,Queens,41017001005,90,52,38,4.39
2020,CB2020,081,4,Queens,41017001006,93,42,51,2.44
2020,CB2020,081,4,Queens,41017001007,74,16,58,2.87
2020,CB2020,081,4,Queens,41017001008,112,51,61,4.15
2020,CB2020,081,4,Queens,41017001009,131,60,71,4.4
2020,CB2020,081,4,Queens,41017001010,79,39,40,3.07
2020,CB2020,081,4,Queens,41017002000,69,27,42,3.55
2020,CB2020,081,4,Queens,41017002001,112,50,62,4.65
2020,CB2020,081,4,Queens,41017002002,110,65,45,4.65
2020,CB2020,081,4,Queens,41017002003,85,35,50,3.9
2020,CB2020,081,4,Queens,41017002004,83,39,44,4.31
2020,CB2020,081,4,Queens,41017002005,152,88,64,4.46
2020,CB2020,081,4,Queens,41017002006,18,4,14,2.21
2020,CB2020,081,4,Queens,41017002007,70,40,30,1.48
2020,CB2020,081,4,Queens,41017002008,110,43,67,3.05
2020,CB2020,081,4,Queens,41017002009,32,11,21,2.27
2020,CB2020,081,4,Queens,41017003000,116,51,65,4.65
2020,CB2020,081,4,Queens,41017003001,48,15,33,2.79
2020,CB2020,081,4,Queens,41017003002,46,29,17,3.31
2020,CB2020,081,4,Queens,41017003003,0,0,0,0.54
2020,CB2020,081,4,Queens,41017003004,0,0,0,0.84
2020,CB2020,081,4,Queens,41017003005,46,14,32,2.28
2020,CB2020,081,4,Queens,41017003006,24,20,4,2.37
2020,CB2020,081,4,Queens,41017003007,116,52,64,4.66
2020,CB2020,081,4,Queens,41017003008,109,49,60,4.66
2020,CB2020,081,4,Queens,41017003009,36,19,17,1.3
2020,CB2020,081,4,Queens,41017003010,72,32,40,3.02
2020,CB2020,081,4,Queens,41017003011,0,0,0,4.27
2020,CB2020,081,4,Queens,41017004000,183,94,89,4.85
2020,CB2020,081,4,Queens,41017004001,559,241,318,15.93
2020,CB2020,081,4,Queens,41017004002,479,235,244,13.9
2020,CB2020,081,4,Queens,41017005000,177,90,87,4.19
2020,CB2020,081,4,Queens,41017005001,0,0,0,0.38
2020,CB2020,081,4,Queens,41017005002,69,20,49,2.96
2020,CB2020,081,4,Queens,41017005003,0,0,0,0.34
2020,CB2020,081,4,Queens,41017005004,130,51,79,4.94
2020,CB2020,081,4,Queens,41017005005,121,62,59,3.63
2020,CB2020,081,4,Queens,41017005006,0,0,0,0.78
2020,CB2020,081,4,Queens,41017005007,25,12,13,2.05
2020,CB2020,081,4,Queens,41017005008,82,40,42,4.66
2020,CB2020,081,4,Queens,41017005009,108,72,36,4.65
2020,CB2020,081,4,Queens,41017005010,66,11,55,3.39
2020,CB2020,081,4,Queens,41017005011,24,12,12,1.44
2020,CB2020,081,4,Queens,41017005012,35,23,12,2.6
2020,CB2020,081,4,Queens,41017006000,28,4,24,6.38
2020,CB2020,081,4,Queens,41017006001,53,17,36,3.31
2020,CB2020,081,4,Queens,41017006002,59,18,41,2.53
2020,CB2020,081,4,Queens,41017006003,115,70,45,3.5
2020,CB2020,081,4,Queens,41017006004,95,56,39,4.54
2020,CB2020,081,4,Queens,41017006005,11,5,6,0.47
2020,CB2020,081,4,Queens,41017006006,0,0,0,3.85
2020,CB2020,081,4,Queens,41017006007,116,68,48,4.27
2020,CB2020,081,4,Queens,41017006008,125,44,81,4.68
2020,CB2020,081,4,Queens,41017006009,112,57,55,3.17
2020,CB2020,081,4,Queens,41017007000,273,122,151,7
2020,CB2020,081,4,Queens,41017007001,342,162,180,8.65
2020,CB2020,081,4,Queens,41017007002,456,181,275,13.55
2020,CB2020,081,4,Queens,41017007003,55,31,24,1.88
2020,CB2020,081,4,Queens,41017007004,0,0,0,0.29
2020,CB2020,081,4,Queens,41029001000,0,0,0,1.34
2020,CB2020,081,4,Queens,41029001001,132,50,82,12.42
2020,CB2020,081,4,Queens,41029001002,0,0,0,1.63
2020,CB2020,081,4,Queens,41029001003,84,48,36,2.35
2020,CB2020,081,4,Queens,41029001004,72,47,25,1.73
2020,CB2020,081,4,Queens,41029001005,471,238,233,10.71
2020,CB2020,081,4,Queens,41029001006,173,89,84,9.6
2020,CB2020,081,4,Queens,41029001007,0,0,0,1.36
2020,CB2020,081,4,Queens,41029001008,109,49,60,2.52
2020,CB2020,081,4,Queens,41029001009,147,59,88,4.06
2020,CB2020,081,4,Queens,41029001010,30,7,23,1.14
2020,CB2020,081,4,Queens,41029001011,190,86,104,5.45
2020,CB2020,081,4,Queens,41029001012,390,207,183,9.87
2020,CB2020,081,4,Queens,41029001013,60,31,29,1.39
2020,CB2020,081,4,Queens,41029001014,298,126,172,8.02
2020,CB2020,081,4,Queens,41029001015,44,26,18,1.45
2020,CB2020,081,4,Queens,41029001016,59,22,37,2.08
2020,CB2020,081,4,Queens,41029001017,60,29,31,4.7
2020,CB2020,081,4,Queens,41029001018,81,39,42,2.6
2020,CB2020,081,4,Queens,41029001019,142,75,67,3.23
2020,CB2020,081,4,Queens,41029002000,19,6,13,1.67
2020,CB2020,081,4,Queens,41029002001,872,406,466,20.11
2020,CB2020,081,4,Queens,41029002002,17,8,9,0.95
2020,CB2020,081,4,Queens,41029002003,70,28,42,1.91
2020,CB2020,081,4,Queens,41029002004,109,55,54,2.93
2020,CB2020,081,4,Queens,41029002005,0,0,0,0.74
2020,CB2020,081,4,Queens,41029002006,120,55,65,4.66
2020,CB2020,081,4,Queens,41029002007,37,15,22,0.6
2020,CB2020,081,4,Queens,41032011000,0,0,0,0
2020,CB2020,081,4,Queens,41032011001,190,89,101,3.94
2020,CB2020,081,4,Queens,41032011002,131,44,87,2.37
2020,CB2020,081,4,Queens,41032011003,126,54,72,2.48
2020,CB2020,081,4,Queens,41032011004,708,341,367,9.46
2020,CB2020,081,4,Queens,41032011005,731,335,396,7.77
2020,CB2020,081,4,Queens,41032011006,616,287,329,8.54
2020,CB2020,081,4,Queens,41032012000,96,60,36,4.45
2020,CB2020,081,4,Queens,41032012001,107,38,69,3.56
2020,CB2020,081,4,Queens,41032012002,172,94,78,2.51
2020,CB2020,081,4,Queens,41032012003,197,94,103,1.86
2020,CB2020,081,4,Queens,41032012004,127,58,69,2.26
2020,CB2020,081,4,Queens,41032012005,1264,626,638,10.08
2020,CB2020,081,4,Queens,41032012006,96,31,65,2.31
2020,CB2020,081,4,Queens,41032012007,167,85,82,2.04
2020,CB2020,081,4,Queens,41032013000,74,28,46,1.24
2020,CB2020,081,4,Queens,41032013001,120,53,67,1.45
2020,CB2020,081,4,Queens,41032013002,1676,742,934,20.48
2020,CB2020,081,4,Queens,41032013003,82,29,53,2.95
2020,CB2020,081,4,Queens,41032013004,127,69,58,3.74
2020,CB2020,081,4,Queens,41032013005,85,36,49,2.56
2020,CB2020,081,4,Queens,41032013006,94,50,44,2.66
2020,CB2020,081,4,Queens,41032021000,45,24,21,9.72
2020,CB2020,081,4,Queens,41032021001,99,35,64,9.94
2020,CB2020,081,4,Queens,41032021002,16,11,5,3.88
2020,CB2020,081,4,Queens,41032021003,111,35,76,2.63
2020,CB2020,081,4,Queens,41032021004,33,15,18,1.73
2020,CB2020,081,4,Queens,41032021005,127,65,62,2.5
2020,CB2020,081,4,Queens,41032021006,184,111,73,3.47
2020,CB2020,081,4,Queens,41032021007,65,41,24,14.47
2020,CB2020,081,4,Queens,41032021008,172,95,77,3.45
2020,CB2020,081,4,Queens,41032021009,145,88,57,3.26
2020,CB2020,081,4,Queens,41032021010,106,44,62,1.97
2020,CB2020,081,4,Queens,41032021011,0,0,0,0.49
2020,CB2020,081,4,Queens,41032021012,71,42,29,1.86
2020,CB2020,081,4,Queens,41032022000,172,84,88,3.92
2020,CB2020,081,4,Queens,41032022001,32,8,24,1.36
2020,CB2020,081,4,Queens,41032022002,60,20,40,2.13
2020,CB2020,081,4,Queens,41032022003,64,35,29,1.91
2020,CB2020,081,4,Queens,41032022004,29,2,27,1.53
2020,CB2020,081,4,Queens,41032022005,146,78,68,8.74
2020,CB2020,081,4,Queens,41032022006,6,5,1,0.53
2020,CB2020,081,4,Queens,41032022007,333,204,129,8.84
2020,CB2020,081,4,Queens,41032022008,85,29,56,3.62
2020,CB2020,081,4,Queens,41032022009,140,102,38,8.04
2020,CB2020,081,4,Queens,41032022010,53,22,31,1.92
2020,CB2020,081,4,Queens,41032022011,45,17,28,2.28
2020,CB2020,081,4,Queens,41032022012,45,19,26,1.21
2020,CB2020,081,4,Queens,41032022013,58,17,41,2.13
2020,CB2020,081,4,Queens,41032022014,49,19,30,1.53
2020,CB2020,081,4,Queens,41032022015,83,56,27,2.58
2020,CB2020,081,4,Queens,41032022016,58,29,29,1.55
2020,CB2020,081,4,Queens,41032022017,71,26,45,2.62
2020,CB2020,081,4,Queens,41032023000,196,98,98,4.41
2020,CB2020,081,4,Queens,41032023001,665,311,354,5.57
2020,CB2020,081,4,Queens,41032023002,241,104,137,5.31
2020,CB2020,081,4,Queens,41032023003,308,173,135,6.17
2020,CB2020,081,4,Queens,41032023004,223,137,86,3.37
2020,CB2020,081,4,Queens,41032023005,715,342,373,5.34
2020,CB2020,081,4,Queens,41032024000,540,246,294,6.77
2020,CB2020,081,4,Queens,41032024001,130,69,61,2.75
2020,CB2020,081,4,Queens,41032024002,491,250,241,10.2
2020,CB2020,081,4,Queens,41032024003,28,12,16,2.8
2020,CB2020,081,4,Queens,41032024004,0,0,0,3.1
2020,CB2020,081,4,Queens,41032024005,620,323,297,5.42
2020,CB2020,081,4,Queens,41033001000,172,91,81,5.33
2020,CB2020,081,4,Queens,41033001001,187,88,99,3.64
2020,CB2020,081,4,Queens,41033001002,160,96,64,3.59
2020,CB2020,081,4,Queens,41033001003,118,36,82,3.64
2020,CB2020,081,4,Queens,41033001004,208,91,117,5.33
2020,CB2020,081,4,Queens,41033001005,191,110,81,5.35
2020,CB2020,081,4,Queens,41033001006,136,68,68,3.64
2020,CB2020,081,4,Queens,41033001007,117,58,59,3.64
2020,CB2020,081,4,Queens,41033001008,169,88,81,5.33
2020,CB2020,081,4,Queens,41033001009,139,48,91,4.13
2020,CB2020,081,4,Queens,41033002000,65,29,36,2.45
2020,CB2020,081,4,Queens,41033002001,68,37,31,1.47
2020,CB2020,081,4,Queens,41033002002,178,66,112,4.78
2020,CB2020,081,4,Queens,41033002003,181,99,82,5.34
2020,CB2020,081,4,Queens,41033002004,151,90,61,3.64
2020,CB2020,081,4,Queens,41033002005,163,75,88,5.04
2020,CB2020,081,4,Queens,41033002006,149,53,96,7.39
2020,CB2020,081,4,Queens,41033002007,183,89,94,6.12
2020,CB2020,081,4,Queens,41033003000,78,37,41,1.46
2020,CB2020,081,4,Queens,41033003001,51,15,36,1.55
2020,CB2020,081,4,Queens,41033003002,178,105,73,4.17
2020,CB2020,081,4,Queens,41033003003,8,7,1,0.94
2020,CB2020,081,4,Queens,41033003004,87,44,43,6.04
2020,CB2020,081,4,Queens,41033003005,98,56,42,6.4
2020,CB2020,081,4,Queens,41033003006,81,40,41,4.68
2020,CB2020,081,4,Queens,41033003007,143,62,81,4.74
2020,CB2020,081,4,Queens,41033003008,99,29,70,4.74
2020,CB2020,081,4,Queens,41033003009,105,55,50,4.66
2020,CB2020,081,4,Queens,41033004000,133,83,50,5.76
2020,CB2020,081,4,Queens,41033004001,174,75,99,5.03
2020,CB2020,081,4,Queens,41033004002,116,50,66,2.88
2020,CB2020,081,4,Queens,41033004003,0,0,0,0.36
2020,CB2020,081,4,Queens,41033004004,123,41,82,5.08
2020,CB2020,081,4,Queens,41033004005,18,7,11,1.65
2020,CB2020,081,4,Queens,41033004006,15,13,2,0.73
2020,CB2020,081,4,Queens,41033004007,93,55,38,3.62
2020,CB2020,081,4,Queens,41033004008,124,70,54,5.39
2020,CB2020,081,4,Queens,41039001000,139,68,71,4.2
2020,CB2020,081,4,Queens,41039001001,28,14,14,1.81
2020,CB2020,081,4,Queens,41039001002,91,38,53,3.5
2020,CB2020,081,4,Queens,41039001003,62,46,16,3.07
2020,CB2020,081,4,Queens,41039001004,112,47,65,4.11
2020,CB2020,081,4,Queens,41039001005,113,62,51,4.31
2020,CB2020,081,4,Queens,41039001006,202,92,110,4.48
2020,CB2020,081,4,Queens,41039001007,149,78,71,5.7
2020,CB2020,081,4,Queens,41039001008,266,126,140,4.66
2020,CB2020,081,4,Queens,41039001009,130,47,83,3.01
2020,CB2020,081,4,Queens,41039001010,137,67,70,3.3
2020,CB2020,081,4,Queens,41039001011,192,88,104,4.7
2020,CB2020,081,4,Queens,41039001012,127,67,60,3.97
2020,CB2020,081,4,Queens,41039002000,169,68,101,4.56
2020,CB2020,081,4,Queens,41039002001,123,57,66,3.39
2020,CB2020,081,4,Queens,41039002002,86,51,35,3.36
2020,CB2020,081,4,Queens,41039002003,212,84,128,4.55
2020,CB2020,081,4,Queens,41039002004,145,72,73,4.59
2020,CB2020,081,4,Queens,41039002005,142,67,75,3.39
2020,CB2020,081,4,Queens,41039002006,120,44,76,3.38
2020,CB2020,081,4,Queens,41039002007,177,102,75,4.56
2020,CB2020,081,4,Queens,41039002008,185,103,82,4.57
2020,CB2020,081,4,Queens,41039002009,196,87,109,3.37
2020,CB2020,081,4,Queens,41039002010,106,63,43,3.35
2020,CB2020,081,4,Queens,41039002011,147,64,83,4.56
2020,CB2020,081,4,Queens,41039002012,265,137,128,6.33
2020,CB2020,081,4,Queens,41039002013,147,99,48,4.69
2020,CB2020,081,4,Queens,41039003000,0,0,0,1.29
2020,CB2020,081,4,Queens,41039003001,0,0,0,0.77
2020,CB2020,081,4,Queens,41039003002,0,0,0,0.84
2020,CB2020,081,4,Queens,41039003003,0,0,0,0.85
2020,CB2020,081,4,Queens,41039003004,30,13,17,2.65
2020,CB2020,081,4,Queens,41039003005,45,15,30,2.25
2020,CB2020,081,4,Queens,41039003006,73,44,29,2.82
2020,CB2020,081,4,Queens,41039003007,34,10,24,1.69
2020,CB2020,081,4,Queens,41039003008,234,135,99,4.87
2020,CB2020,081,4,Queens,41039003009,163,91,72,4.48
2020,CB2020,081,4,Queens,41039003010,0,0,0,3.39
2020,CB2020,081,4,Queens,41039003011,119,50,69,3.37
2020,CB2020,081,4,Queens,41039003012,224,126,98,4.63
2020,CB2020,081,4,Queens,41039003013,214,91,123,4.58
2020,CB2020,081,4,Queens,41039003014,136,61,75,3.36
2020,CB2020,081,4,Queens,41039004000,60,50,10,7
2020,CB2020,081,4,Queens,41039004001,107,44,63,3.8
2020,CB2020,081,4,Queens,41039004002,51,34,17,1.93
2020,CB2020,081,4,Queens,41039004003,40,27,13,1.64
2020,CB2020,081,4,Queens,41039004004,74,35,39,3.29
2020,CB2020,081,4,Queens,41039004005,0,0,0,0.55
2020,CB2020,081,4,Queens,41039004006,99,48,51,2.49
2020,CB2020,081,4,Queens,41039004007,66,22,44,2.26
2020,CB2020,081,4,Queens,41039004008,65,12,53,2.62
2020,CB2020,081,4,Queens,41039004009,51,19,32,2.09
2020,CB2020,081,4,Queens,41039004010,54,25,29,2.34
2020,CB2020,081,4,Queens,41039004011,24,13,11,1.78
2020,CB2020,081,4,Queens,41039004012,0,0,0,4.03
2020,CB2020,081,4,Queens,41039004013,30,19,11,13.55
2020,CB2020,081,4,Queens,41039004014,97,40,57,2.85
2020,CB2020,081,4,Queens,41039004015,560,285,275,11.18
2020,CB2020,081,4,Queens,41047001000,285,138,147,6.35
2020,CB2020,081,4,Queens,41047001001,126,70,56,4.76
2020,CB2020,081,4,Queens,41047001002,258,95,163,6.62
2020,CB2020,081,4,Queens,41047001003,171,70,101,4.45
2020,CB2020,081,4,Queens,41047001004,111,59,52,3.52
2020,CB2020,081,4,Queens,41047001005,143,77,66,4.53
2020,CB2020,081,4,Queens,41047001006,8,6,2,0.37
2020,CB2020,081,4,Queens,41047001007,111,66,45,2.68
2020,CB2020,081,4,Queens,41047001008,41,10,31,1.04
2020,CB2020,081,4,Queens,41047002000,252,131,121,23
2020,CB2020,081,4,Queens,41047002001,84,59,25,3.14
2020,CB2020,081,4,Queens,41047002002,107,30,77,2.84
2020,CB2020,081,4,Queens,41047002003,0,0,0,3.62
2020,CB2020,081,4,Queens,41047002004,0,0,0,3.71
2020,CB2020,081,4,Queens,41047002005,135,79,56,3.66
2020,CB2020,081,4,Queens,41047002006,126,57,69,3.74
2020,CB2020,081,4,Queens,41047002007,106,52,54,2.7
2020,CB2020,081,4,Queens,41047002008,32,11,21,1.22
2020,CB2020,081,4,Queens,41047002009,24,18,6,0.94
2020,CB2020,081,4,Queens,41047002010,90,55,35,2.6
2020,CB2020,081,4,Queens,41047002011,158,50,108,3.18
2020,CB2020,081,4,Queens,41047002012,151,71,80,9.59
2020,CB2020,081,4,Queens,41047003000,149,70,79,3.79
2020,CB2020,081,4,Queens,41047003001,404,172,232,4.81
2020,CB2020,081,4,Queens,41047003002,358,171,187,4.64
2020,CB2020,081,4,Queens,41047003003,159,77,82,3.66
2020,CB2020,081,4,Queens,41047003004,126,55,71,3.66
2020,CB2020,081,4,Queens,41047003005,152,59,93,4.65
2020,CB2020,081,4,Queens,41047003006,130,78,52,4.6
2020,CB2020,081,4,Queens,41047003007,59,33,26,3.14
2020,CB2020,081,4,Queens,41047003008,73,49,24,2.83
2020,CB2020,081,4,Queens,41047003009,92,48,44,6.55
2020,CB2020,081,4,Queens,41047003010,97,39,58,3.14
2020,CB2020,081,4,Queens,41047004000,207,92,115,6.96
2020,CB2020,081,4,Queens,41047004001,610,286,324,6.29
2020,CB2020,081,4,Queens,41047004002,848,373,475,8.79
2020,CB2020,081,4,Queens,41047005000,90,59,31,2.5
2020,CB2020,081,4,Queens,41047005001,90,33,57,2.53
2020,CB2020,081,4,Queens,41047005002,85,24,61,2.38
2020,CB2020,081,4,Queens,41047005003,132,70,62,3.2
2020,CB2020,081,4,Queens,41047005004,147,72,75,4.04
2020,CB2020,081,4,Queens,41047005005,239,152,87,5.28
2020,CB2020,081,4,Queens,41047005006,116,61,55,3.9
2020,CB2020,081,4,Queens,41047005007,114,47,67,3.73
2020,CB2020,081,4,Queens,41047005008,77,44,33,1.31
2020,CB2020,081,4,Queens,41047005009,76,40,36,1.34
2020,CB2020,081,4,Queens,41047005010,155,72,83,3.5
2020,CB2020,081,4,Queens,41047005011,193,84,109,3.75
2020,CB2020,081,4,Queens,41047005012,410,182,228,4.77
2020,CB2020,081,4,Queens,41059001000,106,49,57,4.66
2020,CB2020,081,4,Queens,41059001001,92,33,59,4.76
2020,CB2020,081,4,Queens,41059001002,131,49,82,5.37
2020,CB2020,081,4,Queens,41059001003,136,43,93,3.39
2020,CB2020,081,4,Queens,41059001004,140,74,66,2.67
2020,CB2020,081,4,Queens,41059001005,63,37,26,1.17
2020,CB2020,081,4,Queens,41059001006,99,51,48,3.71
2020,CB2020,081,4,Queens,41059001007,35,17,18,1.66
2020,CB2020,081,4,Queens,41059001008,41,16,25,2.01
2020,CB2020,081,4,Queens,41059001009,70,37,33,2.75
2020,CB2020,081,4,Queens,41059001010,46,27,19,2.29
2020,CB2020,081,4,Queens,41059001011,59,34,25,2.38
2020,CB2020,081,4,Queens,41059002000,131,54,77,5.37
2020,CB2020,081,4,Queens,41059002001,28,10,18,1.22
2020,CB2020,081,4,Queens,41059002002,136,48,88,2.37
2020,CB2020,081,4,Queens,41059002003,74,43,31,2.39
2020,CB2020,081,4,Queens,41059002004,22,5,17,1.28
2020,CB2020,081,4,Queens,41059002005,64,18,46,5.38
2020,CB2020,081,4,Queens,41059002006,115,75,40,5.37
2020,CB2020,081,4,Queens,41059002007,41,22,19,1.25
2020,CB2020,081,4,Queens,41059002008,91,55,36,2.54
2020,CB2020,081,4,Queens,41059002009,132,59,73,5.49
2020,CB2020,081,4,Queens,41059002010,43,25,18,2.4
2020,CB2020,081,4,Queens,41059003000,124,80,44,4.66
2020,CB2020,081,4,Queens,41059003001,71,32,39,4.76
2020,CB2020,081,4,Queens,41059003002,66,28,38,4.76
2020,CB2020,081,4,Queens,41059003003,79,24,55,4.65
2020,CB2020,081,4,Queens,41059003004,43,8,35,1.74
2020,CB2020,081,4,Queens,41059003005,58,31,27,2.91
2020,CB2020,081,4,Queens,41059003006,89,55,34,4.76
2020,CB2020,081,4,Queens,41059003007,30,16,14,2.14
2020,CB2020,081,4,Queens,41059003008,42,13,29,2.25
2020,CB2020,081,4,Queens,41059003009,39,11,28,2.21
2020,CB2020,081,4,Queens,41059003010,36,10,26,2.03
2020,CB2020,081,4,Queens,41059003011,111,74,37,3.92
2020,CB2020,081,4,Queens,41059004000,81,46,35,4.53
2020,CB2020,081,4,Queens,41059004001,95,53,42,4.65
2020,CB2020,081,4,Queens,41059004002,58,15,43,2.24
2020,CB2020,081,4,Queens,41059004003,66,37,29,1.59
2020,CB2020,081,4,Queens,41059004004,76,40,36,2.38
2020,CB2020,081,4,Queens,41059004005,61,18,43,2.93
2020,CB2020,081,4,Queens,41059004006,42,24,18,1.73
2020,CB2020,081,4,Queens,41059004007,96,42,54,4.62
2020,CB2020,081,4,Queens,41059004008,19,10,9,0.51
2020,CB2020,081,4,Queens,41059004009,78,22,56,3.31
2020,CB2020,081,4,Queens,41059004010,124,63,61,4.66
2020,CB2020,081,4,Queens,41059004011,90,41,49,4.65
2020,CB2020,081,4,Queens,41059004012,16,10,6,1.26
2020,CB2020,081,4,Queens,41059004013,138,72,66,4.71
2020,CB2020,081,4,Queens,41059004014,27,17,10,1.97
2020,CB2020,081,4,Queens,41059004015,62,17,45,2.1
2020,CB2020,081,4,Queens,41072011000,0,0,0,22.78
2020,CB2020,081,4,Queens,41072011001,0,0,0,0
2020,CB2020,081,4,Queens,41072011002,418,212,206,76.67
2020,CB2020,081,4,Queens,41072011003,76,45,31,1.93
2020,CB2020,081,4,Queens,41072011004,57,8,49,1.7
2020,CB2020,081,4,Queens,41072011005,22,5,17,2.53
2020,CB2020,081,4,Queens,41072011006,35,17,18,3.07
2020,CB2020,081,4,Queens,41072011007,29,22,7,1
2020,CB2020,081,4,Queens,41072011008,43,21,22,3.05
2020,CB2020,081,4,Queens,41072011009,17,11,6,0.87
2020,CB2020,081,4,Queens,41072011010,28,16,12,1.03
2020,CB2020,081,4,Queens,41072011011,53,28,25,3.14
2020,CB2020,081,4,Queens,41072011012,5,5,0,1.92
2020,CB2020,081,4,Queens,41072011013,47,20,27,4.68
2020,CB2020,081,4,Queens,41072011014,37,22,15,1.59
2020,CB2020,081,4,Queens,41072011015,51,32,19,1.9
2020,CB2020,081,4,Queens,41072011016,25,12,13,1.58
2020,CB2020,081,4,Queens,41072011017,37,34,3,31.28
2020,CB2020,081,4,Queens,41072011018,0,0,0,1.14
2020,CB2020,081,4,Queens,41072011019,119,46,73,4.75
2020,CB2020,081,4,Queens,41072011020,120,70,50,4.97
2020,CB2020,081,4,Queens,41072011021,22,4,18,1.53
2020,CB2020,081,4,Queens,41072011022,46,6,40,1.74
2020,CB2020,081,4,Queens,41072011023,57,22,35,1.99
2020,CB2020,081,4,Queens,41072011024,50,28,22,1.73
2020,CB2020,081,4,Queens,41072011025,63,28,35,1.77
2020,CB2020,081,4,Queens,41072011026,51,10,41,1.95
2020,CB2020,081,4,Queens,41072011027,24,8,16,0.99
2020,CB2020,081,4,Queens,41072011028,50,30,20,2.05
2020,CB2020,081,4,Queens,41072011029,60,47,13,2.96
2020,CB2020,081,4,Queens,41072011030,38,25,13,1.62
2020,CB2020,081,4,Queens,41072011031,115,75,40,4.75
2020,CB2020,081,4,Queens,41072011032,113,46,67,4.65
2020,CB2020,081,4,Queens,41072011033,103,44,59,4.58
2020,CB2020,081,4,Queens,41072011034,111,56,55,5.11
2020,CB2020,081,4,Queens,41072011035,57,28,29,5.4
2020,CB2020,081,4,Queens,41072011036,38,17,21,6.08
2020,CB2020,081,4,Queens,41072011037,91,60,31,4.26
2020,CB2020,081,4,Queens,41072011038,62,35,27,112.29
2020,CB2020,081,4,Queens,41072011039,0,0,0,4.67
2020,CB2020,081,4,Queens,41072020001,0,0,0,0
2020,CB2020,081,4,Queens,41072020002,0,0,0,0
2020,CB2020,081,4,Queens,41072020003,0,0,0,0
2020,CB2020,081,4,Queens,41072020004,0,0,0,0
2020,CB2020,081,4,Queens,41072020005,0,0,0,0
2020,CB2020,081,4,Queens,41072020006,0,0,0,0
2020,CB2020,081,4,Queens,41072020007,0,0,0,0
2020,CB2020,081,4,Queens,41072020008,0,0,0,0
2020,CB2020,081,4,Queens,41072020009,0,0,0,0
2020,CB2020,081,4,Queens,41072020010,0,0,0,0
2020,CB2020,081,4,Queens,41072020011,0,0,0,0
2020,CB2020,081,4,Queens,41072020012,0,0,0,0
2020,CB2020,081,4,Queens,41072020013,0,0,0,0
2020,CB2020,081,4,Queens,41072020014,0,0,0,0
2020,CB2020,081,4,Queens,41072020015,0,0,0,0
2020,CB2020,081,4,Queens,41072020016,0,0,0,0
2020,CB2020,081,4,Queens,41072020017,0,0,0,0
2020,CB2020,081,4,Queens,41072020018,0,0,0,0
2020,CB2020,081,4,Queens,41072021000,0,0,0,34.5
2020,CB2020,081,4,Queens,41072021001,0,0,0,0
2020,CB2020,081,4,Queens,41072021002,0,0,0,293.05
2020,CB2020,081,4,Queens,41072021003,0,0,0,231.07
2020,CB2020,081,4,Queens,41072021004,0,0,0,81.78
2020,CB2020,081,4,Queens,41072021005,0,0,0,430.69
2020,CB2020,081,4,Queens,41072021006,0,0,0,92.77
2020,CB2020,081,4,Queens,41072021007,0,0,0,395.81
2020,CB2020,081,4,Queens,41072021008,0,0,0,31.45
2020,CB2020,081,4,Queens,41072021009,0,0,0,15.77
2020,CB2020,081,4,Queens,41072021010,0,0,0,13.85
2020,CB2020,081,4,Queens,41072021011,0,0,0,36.13
2020,CB2020,081,4,Queens,41085001000,110,62,48,7.95
2020,CB2020,081,4,Queens,41085001001,62,12,50,2.67
2020,CB2020,081,4,Queens,41085001002,75,22,53,3.97
2020,CB2020,081,4,Queens,41085001003,55,29,26,2.95
2020,CB2020,081,4,Queens,41085001004,37,23,14,2.47
2020,CB2020,081,4,Queens,41085001005,35,24,11,1.53
2020,CB2020,081,4,Queens,41085001006,115,72,43,3.4
2020,CB2020,081,4,Queens,41085001007,101,62,39,3.98
2020,CB2020,081,4,Queens,41085001008,38,14,24,2.48
2020,CB2020,081,4,Queens,41085001009,23,21,2,0.92
2020,CB2020,081,4,Queens,41085001010,45,16,29,2.16
2020,CB2020,081,4,Queens,41085001011,85,29,56,3.55
2020,CB2020,081,4,Queens,41085001012,78,27,51,3.41
2020,CB2020,081,4,Queens,41085001013,31,21,10,1.36
2020,CB2020,081,4,Queens,41085002000,54,25,29,3.04
2020,CB2020,081,4,Queens,41085002001,142,79,63,2.27
2020,CB2020,081,4,Queens,41085002002,72,48,24,1.08
2020,CB2020,081,4,Queens,41085002003,87,50,37,1.97
2020,CB2020,081,4,Queens,41085002004,139,55,84,2.98
2020,CB2020,081,4,Queens,41085002005,0,0,0,1.03
2020,CB2020,081,4,Queens,41085002006,56,34,22,0.77
2020,CB2020,081,4,Queens,41085002007,280,119,161,3.07
2020,CB2020,081,4,Queens,41085003000,0,0,0,3.71
2020,CB2020,081,4,Queens,41085003001,112,59,53,5.94
2020,CB2020,081,4,Queens,41085003002,175,84,91,5.46
2020,CB2020,081,4,Queens,41085003003,133,67,66,4.98
2020,CB2020,081,4,Queens,41085003004,0,0,0,11.19
2020,CB2020,081,4,Queens,41085003005,95,34,61,3.11
2020,CB2020,081,4,Queens,41085003006,196,75,121,5.62
2020,CB2020,081,4,Queens,41085003007,247,122,125,7.84
2020,CB2020,081,4,Queens,41085003008,100,43,57,3.05
2020,CB2020,081,4,Queens,41093000001,0,0,0,0
2020,CB2020,081,4,Queens,41093001000,89,49,40,3.41
2020,CB2020,081,4,Queens,41093001001,65,37,28,4.46
2020,CB2020,081,4,Queens,41093001002,76,36,40,4.41
2020,CB2020,081,4,Queens,41093001003,67,34,33,4.72
2020,CB2020,081,4,Queens,41093001004,89,53,36,5.42
2020,CB2020,081,4,Queens,41093001005,116,61,55,6.36
2020,CB2020,081,4,Queens,41093001006,86,37,49,5.67
2020,CB2020,081,4,Queens,41093001007,122,57,65,7.34
2020,CB2020,081,4,Queens,41093001008,37,4,33,2.66
2020,CB2020,081,4,Queens,41093001009,28,11,17,1.75
2020,CB2020,081,4,Queens,41093001010,44,26,18,1.56
2020,CB2020,081,4,Queens,41093001011,87,39,48,5.03
2020,CB2020,081,4,Queens,41093001012,45,20,25,2.62
2020,CB2020,081,4,Queens,41093001013,32,20,12,1.32
2020,CB2020,081,4,Queens,41093001014,0,0,0,3.77
2020,CB2020,081,4,Queens,41093001015,0,0,0,2.15
2020,CB2020,081,4,Queens,41093002000,279,142,137,21.52
2020,CB2020,081,4,Queens,41093002001,43,25,18,4.29
2020,CB2020,081,4,Queens,41093002002,58,27,31,4.11
2020,CB2020,081,4,Queens,41093002003,72,34,38,3.98
2020,CB2020,081,4,Queens,41093002004,41,10,31,3.86
2020,CB2020,081,4,Queens,41093002005,65,41,24,3.88
2020,CB2020,081,4,Queens,41093002006,55,29,26,3.66
2020,CB2020,081,4,Queens,41093002007,71,34,37,3.59
2020,CB2020,081,4,Queens,41093002008,60,41,19,3.69
2020,CB2020,081,4,Queens,41093002009,65,23,42,3.7
2020,CB2020,081,4,Queens,41093002010,64,38,26,3.71
2020,CB2020,081,4,Queens,41093002011,79,43,36,3.57
2020,CB2020,081,4,Queens,41093002012,51,34,17,3.65
2020,CB2020,081,4,Queens,41093002013,64,11,53,3.69
2020,CB2020,081,4,Queens,41093002014,96,36,60,27.59
2020,CB2020,081,4,Queens,41093002015,0,0,0,2.5
2020,CB2020,081,4,Queens,41093002016,0,0,0,37.83
2020,CB2020,081,4,Queens,41093002017,0,0,0,4.94
2020,CB2020,081,4,Queens,41093003000,156,91,65,9.59
2020,CB2020,081,4,Queens,41093003001,48,5,43,4.2
2020,CB2020,081,4,Queens,41093003002,116,70,46,4.02
2020,CB2020,081,4,Queens,41093003003,88,20,68,3.52
2020,CB2020,081,4,Queens,41093003004,43,22,21,3.45
2020,CB2020,081,4,Queens,41093003005,53,19,34,3.34
2020,CB2020,081,4,Queens,41093003006,71,35,36,3.22
2020,CB2020,081,4,Queens,41093003007,46,26,20,3.65
2020,CB2020,081,4,Queens,41093003008,41,29,12,4.39
2020,CB2020,081,4,Queens,41093003009,50,35,15,4.48
2020,CB2020,081,4,Queens,41093003010,70,20,50,3.72
2020,CB2020,081,4,Queens,41093003011,72,39,33,3.47
2020,CB2020,081,4,Queens,41093003012,77,55,22,3.45
2020,CB2020,081,4,Queens,41093003013,62,35,27,3.44
2020,CB2020,081,4,Queens,41097001000,41,36,5,5.88
2020,CB2020,081,4,Queens,41097001001,53,21,32,3.12
2020,CB2020,081,4,Queens,41097001002,39,31,8,2.55
2020,CB2020,081,4,Queens,41097001003,48,26,22,2.27
2020,CB2020,081,4,Queens,41097001004,37,24,13,2.45
2020,CB2020,081,4,Queens,41097001005,41,10,31,2.33
2020,CB2020,081,4,Queens,41097001006,59,35,24,2.7
2020,CB2020,081,4,Queens,41097001007,80,37,43,4.59
2020,CB2020,081,4,Queens,41097001008,9,6,3,7.09
2020,CB2020,081,4,Queens,41097001009,0,0,0,7.02
2020,CB2020,081,4,Queens,41097001010,19,6,13,1.62
2020,CB2020,081,4,Queens,41097001011,50,12,38,2.54
2020,CB2020,081,4,Queens,41097001012,58,27,31,2.41
2020,CB2020,081,4,Queens,41097001013,47,20,27,2.34
2020,CB2020,081,4,Queens,41097002000,184,85,99,11.22
2020,CB2020,081,4,Queens,41097002001,81,43,38,5.16
2020,CB2020,081,4,Queens,41097002002,109,52,57,5.58
2020,CB2020,081,4,Queens,41097002003,45,28,17,2.59
2020,CB2020,081,4,Queens,41097002004,46,31,15,2.57
2020,CB2020,081,4,Queens,41097002005,33,13,20,1.55
2020,CB2020,081,4,Queens,41097002006,42,19,23,2.23
2020,CB2020,081,4,Queens,41097002007,0,0,0,2.53
2020,CB2020,081,4,Queens,41097003000,82,32,50,4.02
2020,CB2020,081,4,Queens,41097003001,0,0,0,3.58
2020,CB2020,081,4,Queens,41097003002,0,0,0,2.01
2020,CB2020,081,4,Queens,41097003003,106,50,56,3.12
2020,CB2020,081,4,Queens,41097003004,125,77,48,3.07
2020,CB2020,081,4,Queens,41097003005,31,16,15,0.96
2020,CB2020,081,4,Queens,41097003006,97,50,47,3.06
2020,CB2020,081,4,Queens,41097003007,72,32,40,3.04
2020,CB2020,081,4,Queens,41097003008,63,12,51,1.61
2020,CB2020,081,4,Queens,41097003009,55,39,16,1.63
2020,CB2020,081,4,Queens,41097003010,45,16,29,1.57
2020,CB2020,081,4,Queens,41099001000,0,0,0,1.51
2020,CB2020,081,4,Queens,41099001001,36,30,6,3.95
2020,CB2020,081,4,Queens,41099001002,129,40,89,3.93
2020,CB2020,081,4,Queens,41099001003,173,87,86,3.96
2020,CB2020,081,4,Queens,41099001004,203,100,103,3.94
2020,CB2020,081,4,Queens,41099001005,188,83,105,3.93
2020,CB2020,081,4,Queens,41099001006,136,90,46,3.11
2020,CB2020,081,4,Queens,41099001007,128,49,79,3.1
2020,CB2020,081,4,Queens,41099001008,150,70,80,3.11
2020,CB2020,081,4,Queens,41099001009,108,59,49,3.1
2020,CB2020,081,4,Queens,41099001010,141,72,69,3.04
2020,CB2020,081,4,Queens,41099001011,0,0,0,1.32
2020,CB2020,081,4,Queens,41099002000,0,0,0,1.34
2020,CB2020,081,4,Queens,41099002001,57,23,34,2.96
2020,CB2020,081,4,Queens,41099002002,95,29,66,2.98
2020,CB2020,081,4,Queens,41099002003,126,58,68,3.1
2020,CB2020,081,4,Queens,41099002004,30,15,15,3.39
2020,CB2020,081,4,Queens,41099002005,115,44,71,3.79
2020,CB2020,081,4,Queens,41099002006,166,81,85,4.17
2020,CB2020,081,4,Queens,41099002007,110,75,35,3.03
2020,CB2020,081,4,Queens,41099002008,81,33,48,1.56
2020,CB2020,081,4,Queens,41099002009,143,68,75,4.47
2020,CB2020,081,4,Queens,41099003000,199,96,103,3.94
2020,CB2020,081,4,Queens,41099003001,96,52,44,1.34
2020,CB2020,081,4,Queens,41099003002,182,87,95,2.61
2020,CB2020,081,4,Queens,41099003003,202,93,109,2.82
2020,CB2020,081,4,Queens,41099003004,83,43,40,3.84
2020,CB2020,081,4,Queens,41099003005,130,67,63,4.02
2020,CB2020,081,4,Queens,41099003006,116,58,58,2.3
2020,CB2020,081,4,Queens,41099003007,52,14,38,0.8
2020,CB2020,081,4,Queens,41099003008,163,91,72,3.1
2020,CB2020,081,4,Queens,41113000001,0,0,0,0
2020,CB2020,081,4,Queens,41113001000,0,0,0,29.26
2020,CB2020,081,4,Queens,41113001001,0,0,0,3.56
2020,CB2020,081,4,Queens,41113001002,263,116,147,34.89
2020,CB2020,081,4,Queens,41113001003,129,73,56,5.61
2020,CB2020,081,4,Queens,41113001004,61,42,19,2.16
2020,CB2020,081,4,Queens,41113001005,90,55,35,4.63
2020,CB2020,081,4,Queens,41113001006,57,24,33,2.12
2020,CB2020,081,4,Queens,41113001007,60,31,29,2.29
2020,CB2020,081,4,Queens,41113001008,49,7,42,3.16
2020,CB2020,081,4,Queens,41113001009,34,24,10,2
2020,CB2020,081,4,Queens,41113001010,75,13,62,3.87
2020,CB2020,081,4,Queens,41113001011,65,25,40,2.48
2020,CB2020,081,4,Queens,41113001012,57,37,20,2.57
2020,CB2020,081,4,Queens,41113001013,99,63,36,4.56
2020,CB2020,081,4,Queens,41113002000,35,24,11,2.33
2020,CB2020,081,4,Queens,41113002001,109,33,76,7.47
2020,CB2020,081,4,Queens,41113002002,119,61,58,2.5
2020,CB2020,081,4,Queens,41113002003,89,57,32,2.49
2020,CB2020,081,4,Queens,41113002004,149,65,84,14.41
2020,CB2020,081,4,Queens,41113002005,65,37,28,2.27
2020,CB2020,081,4,Queens,41113002006,37,31,6,2.1
2020,CB2020,081,4,Queens,41113002007,36,27,9,2.16
2020,CB2020,081,4,Queens,41113002008,112,44,68,2.85
2020,CB2020,081,4,Queens,41113003000,89,39,50,4.01
2020,CB2020,081,4,Queens,41113003001,49,23,26,4.74
2020,CB2020,081,4,Queens,41113003002,63,35,28,3.43
2020,CB2020,081,4,Queens,41113003003,44,21,23,3.39
2020,CB2020,081,4,Queens,41113003004,92,53,39,3.4
2020,CB2020,081,4,Queens,41113003005,138,64,74,3.39
2020,CB2020,081,4,Queens,41113003006,61,35,26,2.8
2020,CB2020,081,4,Queens,41113003007,49,39,10,2.81
2020,CB2020,081,4,Queens,41113003008,69,39,30,2.79
2020,CB2020,081,4,Queens,41113003009,56,23,33,2.82
2020,CB2020,081,4,Queens,41113003010,36,12,24,2.31
2020,CB2020,081,4,Queens,41113003011,75,35,40,2.81
2020,CB2020,081,4,Queens,41123001000,108,55,53,2.49
2020,CB2020,081,4,Queens,41123001001,111,48,63,2.38
2020,CB2020,081,4,Queens,41123001002,77,37,40,4.25
2020,CB2020,081,4,Queens,41123001003,137,74,63,5.38
2020,CB2020,081,4,Queens,41123001004,109,49,60,3.39
2020,CB2020,081,4,Queens,41123001005,185,76,109,3.38
2020,CB2020,081,4,Queens,41123001006,58,25,33,2.81
2020,CB2020,081,4,Queens,41123001007,81,39,42,2.8
2020,CB2020,081,4,Queens,41123001008,73,48,25,2.82
2020,CB2020,081,4,Queens,41123001009,105,46,59,3.59
2020,CB2020,081,4,Queens,41123002000,50,32,18,2.33
2020,CB2020,081,4,Queens,41123002001,153,80,73,3.39
2020,CB2020,081,4,Queens,41123002002,43,20,23,2.83
2020,CB2020,081,4,Queens,41123002003,125,66,59,2.97
2020,CB2020,081,4,Queens,41123002004,157,80,77,3.44
2020,CB2020,081,4,Queens,41123002005,101,49,52,3.73
2020,CB2020,081,4,Queens,41123002006,63,32,31,2.41
2020,CB2020,081,4,Queens,41123002007,108,53,55,2.5
2020,CB2020,081,4,Queens,41123002008,17,4,13,2.48
2020,CB2020,081,4,Queens,41123002009,71,35,36,2.49
2020,CB2020,081,4,Queens,41123002010,100,49,51,2.7
2020,CB2020,081,4,Queens,41123002011,81,30,51,2.31
2020,CB2020,081,4,Queens,41123002012,13,9,4,2.12
2020,CB2020,081,4,Queens,41129001000,58,38,20,2.53
2020,CB2020,081,4,Queens,41129001001,55,25,30,2.71
2020,CB2020,081,4,Queens,41129001002,72,28,44,2.84
2020,CB2020,081,4,Queens,41129001003,42,21,21,2.97
2020,CB2020,081,4,Queens,41129001004,102,54,48,3.42
2020,CB2020,081,4,Queens,41129001005,50,22,28,3.39
2020,CB2020,081,4,Queens,41129001006,66,24,42,3.41
2020,CB2020,081,4,Queens,41129001007,101,62,39,3.4
2020,CB2020,081,4,Queens,41129001008,60,23,37,2.98
2020,CB2020,081,4,Queens,41129001009,44,24,20,2.94
2020,CB2020,081,4,Queens,41129001010,58,24,34,2.96
2020,CB2020,081,4,Queens,41129002000,47,12,35,3.01
2020,CB2020,081,4,Queens,41129002001,55,24,31,3.03
2020,CB2020,081,4,Queens,41129002002,63,38,25,3.08
2020,CB2020,081,4,Queens,41129002003,0,0,0,1.36
2020,CB2020,081,4,Queens,41129002004,0,0,0,1.25
2020,CB2020,081,4,Queens,41129002005,0,0,0,0.67
2020,CB2020,081,4,Queens,41129002006,0,0,0,0.97
2020,CB2020,081,4,Queens,41129002007,90,45,45,3.47
2020,CB2020,081,4,Queens,41129002008,79,56,23,3.41
2020,CB2020,081,4,Queens,41129002009,73,36,37,3.4
2020,CB2020,081,4,Queens,41129002010,37,17,20,2.95
2020,CB2020,081,4,Queens,41129002011,60,31,29,2.96
2020,CB2020,081,4,Queens,41129002012,59,25,34,3.03
2020,CB2020,081,4,Queens,41129002013,0,0,0,1.03
2020,CB2020,081,4,Queens,41129003000,130,52,78,2.99
2020,CB2020,081,4,Queens,41129003001,187,82,105,2.59
2020,CB2020,081,4,Queens,41129003002,78,54,24,2.2
2020,CB2020,081,4,Queens,41129003003,60,19,41,1.8
2020,CB2020,081,4,Queens,41129003004,78,34,44,1.38
2020,CB2020,081,4,Queens,41129003005,42,32,10,1.61
2020,CB2020,081,4,Queens,41129003006,0,0,0,0.64
2020,CB2020,081,4,Queens,41129003007,0,0,0,0.34
2020,CB2020,081,4,Queens,41129003008,203,93,110,2.29
2020,CB2020,081,4,Queens,41129003009,199,96,103,4.71
2020,CB2020,081,4,Queens,41133001000,130,54,76,3.16
2020,CB2020,081,4,Queens,41133001001,149,51,98,3.17
2020,CB2020,081,4,Queens,41133001002,91,55,36,3.13
2020,CB2020,081,4,Queens,41133001003,112,51,61,2.82
2020,CB2020,081,4,Queens,41133001004,82,50,32,2.44
2020,CB2020,081,4,Queens,41133001005,72,27,45,2.07
2020,CB2020,081,4,Queens,41133001006,0,0,0,3.36
2020,CB2020,081,4,Queens,41133002000,0,0,0,2.71
2020,CB2020,081,4,Queens,41133002001,80,26,54,3.48
2020,CB2020,081,4,Queens,41133002002,81,26,55,3.39
2020,CB2020,081,4,Queens,41133002003,53,27,26,3.41
2020,CB2020,081,4,Queens,41133002004,109,71,38,3.41
2020,CB2020,081,4,Queens,41133002005,104,38,66,3.4
2020,CB2020,081,4,Queens,41133002006,123,65,58,3.35
2020,CB2020,081,4,Queens,41133002007,104,40,64,4.05
2020,CB2020,081,4,Queens,41133002008,41,24,17,2.41
2020,CB2020,081,4,Queens,41133002009,55,27,28,2.91
2020,CB2020,081,4,Queens,41133002010,58,31,27,2.98
2020,CB2020,081,4,Queens,41133002011,0,0,0,1.17
2020,CB2020,081,4,Queens,41133002012,0,0,0,0.54
2020,CB2020,081,4,Queens,41133002013,110,59,51,5.37
2020,CB2020,081,4,Queens,41139001000,56,18,38,2.78
2020,CB2020,081,4,Queens,41139001001,0,0,0,0.46
2020,CB2020,081,4,Queens,41139001002,127,63,64,3.76
2020,CB2020,081,4,Queens,41139001003,93,54,39,3.19
2020,CB2020,081,4,Queens,41139001004,123,57,66,5.52
2020,CB2020,081,4,Queens,41139001005,121,49,72,5.65
2020,CB2020,081,4,Queens,41139001006,146,65,81,5.62
2020,CB2020,081,4,Queens,41139001007,57,15,42,2.17
2020,CB2020,081,4,Queens,41139001008,0,0,0,0.35
2020,CB2020,081,4,Queens,41139001009,223,122,101,5.29
2020,CB2020,081,4,Queens,41139001010,0,0,0,4.83
2020,CB2020,081,4,Queens,41139002000,0,0,0,0.37
2020,CB2020,081,4,Queens,41139002001,76,47,29,1.98
2020,CB2020,081,4,Queens,41139002002,84,31,53,1.97
2020,CB2020,081,4,Queens,41139002003,154,92,62,2.54
2020,CB2020,081,4,Queens,41139002004,154,78,76,3.04
2020,CB2020,081,4,Queens,41139002005,286,113,173,2.77
2020,CB2020,081,4,Queens,41139002006,105,43,62,2.01
2020,CB2020,081,4,Queens,41139002007,169,89,80,2.13
2020,CB2020,081,4,Queens,41139002008,150,70,80,2.47
2020,CB2020,081,4,Queens,41139002009,202,71,131,2.65
2020,CB2020,081,4,Queens,41139002010,162,101,61,4.78
2020,CB2020,081,4,Queens,41139003000,89,37,52,3
2020,CB2020,081,4,Queens,41139003001,98,41,57,1.43
2020,CB2020,081,4,Queens,41139003002,179,90,89,2.87
2020,CB2020,081,4,Queens,41139003003,50,38,12,1.43
2020,CB2020,081,4,Queens,41139003004,77,50,27,1.44
2020,CB2020,081,4,Queens,41139003005,188,81,107,2.52
2020,CB2020,081,4,Queens,41139003006,125,60,65,3.45
2020,CB2020,081,4,Queens,41139003007,143,62,81,4.6
2020,CB2020,081,4,Queens,41139003008,165,66,99,4.34
2020,CB2020,081,4,Queens,41139003009,0,0,0,3.32
2020,CB2020,081,4,Queens,41141001000,86,48,38,2.79
2020,CB2020,081,4,Queens,41141001001,8,7,1,0.66
2020,CB2020,081,4,Queens,41141001002,108,56,52,4.88
2020,CB2020,081,4,Queens,41141001003,64,25,39,3.12
2020,CB2020,081,4,Queens,41141001004,31,9,22,1.24
2020,CB2020,081,4,Queens,41141001005,99,25,74,3.11
2020,CB2020,081,4,Queens,41141001006,64,37,27,3.09
2020,CB2020,081,4,Queens,41141001007,86,62,24,3.09
2020,CB2020,081,4,Queens,41141001008,43,11,32,2.01
2020,CB2020,081,4,Queens,41141001009,63,28,35,3.11
2020,CB2020,081,4,Queens,41141001010,129,54,75,4.07
2020,CB2020,081,4,Queens,41141001011,167,110,57,4.08
2020,CB2020,081,4,Queens,41141001012,0,0,0,4.5
2020,CB2020,081,4,Queens,41141001013,127,55,72,2.72
2020,CB2020,081,4,Queens,41141001014,103,60,43,4.08
2020,CB2020,081,4,Queens,41141001015,94,47,47,4.08
2020,CB2020,081,4,Queens,41141001016,96,48,48,4.07
2020,CB2020,081,4,Queens,41141001017,0,0,0,0.73
2020,CB2020,081,4,Queens,41141001018,94,51,43,4.07
2020,CB2020,081,4,Queens,41141002000,92,61,31,3.01
2020,CB2020,081,4,Queens,41141002001,86,43,43,3.01
2020,CB2020,081,4,Queens,41141002002,81,47,34,3.01
2020,CB2020,081,4,Queens,41141002003,78,27,51,3.01
2020,CB2020,081,4,Queens,41141002004,58,28,30,3.01
2020,CB2020,081,4,Queens,41141002005,68,20,48,3.01
2020,CB2020,081,4,Queens,41141002006,135,54,81,5.52
2020,CB2020,081,4,Queens,41141002007,94,56,38,5.53
2020,CB2020,081,4,Queens,41141002008,98,57,41,5.53
2020,CB2020,081,4,Queens,41141002009,129,38,91,5.53
2020,CB2020,081,4,Queens,41141002010,133,64,69,5.53
2020,CB2020,081,4,Queens,41141002011,66,18,48,5.53
2020,CB2020,081,4,Queens,41147001000,123,67,56,4.07
2020,CB2020,081,4,Queens,41147001001,151,72,79,4.07
2020,CB2020,081,4,Queens,41147001002,254,117,137,4.07
2020,CB2020,081,4,Queens,41147001003,96,55,41,4.07
2020,CB2020,081,4,Queens,41147001004,17,12,5,1.02
2020,CB2020,081,4,Queens,41147001005,81,21,60,4.01
2020,CB2020,081,4,Queens,41147001006,82,32,50,3.69
2020,CB2020,081,4,Queens,41147002000,65,33,32,3.02
2020,CB2020,081,4,Queens,41147002001,54,36,18,3
2020,CB2020,081,4,Queens,41147002002,68,35,33,3.01
2020,CB2020,081,4,Queens,41147002003,40,7,33,3.01
2020,CB2020,081,4,Queens,41147002004,36,11,25,3.01
2020,CB2020,081,4,Queens,41147002005,42,16,26,3.01
2020,CB2020,081,4,Queens,41147002006,73,24,49,5.52
2020,CB2020,081,4,Queens,41147002007,83,38,45,5.52
2020,CB2020,081,4,Queens,41147002008,108,66,42,5.51
2020,CB2020,081,4,Queens,41147002009,164,89,75,5.54
2020,CB2020,081,4,Queens,41147002010,183,93,90,5.53
2020,CB2020,081,4,Queens,41147002011,113,48,65,5.54
2020,CB2020,081,4,Queens,41151001000,100,48,52,3.42
2020,CB2020,081,4,Queens,41151001001,0,0,0,10.72
2020,CB2020,081,4,Queens,41151001002,61,46,15,3.95
2020,CB2020,081,4,Queens,41151001003,75,42,33,3.19
2020,CB2020,081,4,Queens,41151001004,76,26,50,3.03
2020,CB2020,081,4,Queens,41151001005,43,15,28,3.01
2020,CB2020,081,4,Queens,41151001006,28,23,5,3
2020,CB2020,081,4,Queens,41151001007,51,6,45,3.02
2020,CB2020,081,4,Queens,41151001008,39,23,16,3.02
2020,CB2020,081,4,Queens,41151001009,69,41,28,5.53
2020,CB2020,081,4,Queens,41151001010,64,30,34,5.53
2020,CB2020,081,4,Queens,41151001011,42,13,29,2.65
2020,CB2020,081,4,Queens,41151001012,38,18,20,2.83
2020,CB2020,081,4,Queens,41151001013,55,41,14,5.53
2020,CB2020,081,4,Queens,41151001014,181,84,97,5.57
2020,CB2020,081,4,Queens,41151001015,165,74,91,5.84
2020,CB2020,081,4,Queens,41155001000,87,54,33,3.68
2020,CB2020,081,4,Queens,41155001001,103,45,58,3.38
2020,CB2020,081,4,Queens,41155001002,69,43,26,3.68
2020,CB2020,081,4,Queens,41155001003,75,17,58,2.62
2020,CB2020,081,4,Queens,41155001004,101,51,50,3
2020,CB2020,081,4,Queens,41155001005,73,33,40,3.12
2020,CB2020,081,4,Queens,41155001006,212,91,121,5.74
2020,CB2020,081,4,Queens,41155001007,105,59,46,2.58
2020,CB2020,081,4,Queens,41155001008,241,131,110,2.48
2020,CB2020,081,4,Queens,41155001009,209,95,114,3.23
2020,CB2020,081,4,Queens,41155002000,95,66,29,2.91
2020,CB2020,081,4,Queens,41155002001,493,252,241,3
2020,CB2020,081,4,Queens,41155002002,113,67,46,3.4
2020,CB2020,081,4,Queens,41155002003,156,58,98,3.39
2020,CB2020,081,4,Queens,41157001000,68,34,34,2.49
2020,CB2020,081,4,Queens,41157001001,83,59,24,2.62
2020,CB2020,081,4,Queens,41157001002,75,31,44,3.01
2020,CB2020,081,4,Queens,41157001003,108,55,53,4.29
2020,CB2020,081,4,Queens,41157001004,91,51,40,4.78
2020,CB2020,081,4,Queens,41157001005,78,39,39,3.1
2020,CB2020,081,4,Queens,41157001006,120,61,59,2.93
2020,CB2020,081,4,Queens,41157001007,51,13,38,1.93
2020,CB2020,081,4,Queens,41157001008,52,21,31,1.29
2020,CB2020,081,4,Queens,41157001009,64,28,36,3.48
2020,CB2020,081,4,Queens,41157001010,79,54,25,3.52
2020,CB2020,081,4,Queens,41157001011,77,23,54,3.08
2020,CB2020,081,4,Queens,41157001012,77,36,41,3.04
2020,CB2020,081,4,Queens,41157002000,0,0,0,0.47
2020,CB2020,081,4,Queens,41157002001,218,108,110,2.81
2020,CB2020,081,4,Queens,41157002002,97,49,48,2.69
2020,CB2020,081,4,Queens,41157002003,378,200,178,2.89
2020,CB2020,081,4,Queens,41157002004,124,65,59,2.27
2020,CB2020,081,4,Queens,41157002005,149,48,101,2.41
2020,CB2020,081,4,Queens,41157002006,517,242,275,3.44
2020,CB2020,081,4,Queens,41157002007,203,70,133,2.73
2020,CB2020,081,4,Queens,41157002008,10,2,8,3.21
2020,CB2020,081,4,Queens,41157003000,52,29,23,2.53
2020,CB2020,081,4,Queens,41157003001,45,7,38,3.3
2020,CB2020,081,4,Queens,41157003002,6,3,3,1.35
2020,CB2020,081,4,Queens,41157003003,133,70,63,2.4
2020,CB2020,081,4,Queens,41157003004,425,200,225,3.11
2020,CB2020,081,4,Queens,41157003005,149,75,74,2.56
2020,CB2020,081,4,Queens,41159001000,64,33,31,2.73
2020,CB2020,081,4,Queens,41159001001,132,57,75,9.46
2020,CB2020,081,4,Queens,41159001002,305,133,172,7.52
2020,CB2020,081,4,Queens,41159001003,187,94,93,7.51
2020,CB2020,081,4,Queens,41159001004,165,89,76,6.19
2020,CB2020,081,4,Queens,41159002000,43,12,31,2.47
2020,CB2020,081,4,Queens,41159002001,39,23,16,2.61
2020,CB2020,081,4,Queens,41159002002,86,48,38,3.31
2020,CB2020,081,4,Queens,41159002003,82,41,41,2.67
2020,CB2020,081,4,Queens,41159002004,295,151,144,3.28
2020,CB2020,081,4,Queens,41159002005,179,84,95,3.47
2020,CB2020,081,4,Queens,41159002006,106,52,54,2.76
2020,CB2020,081,4,Queens,41159002007,83,40,43,2.53
2020,CB2020,081,4,Queens,41159002008,123,69,54,3.45
2020,CB2020,081,4,Queens,41159003000,129,76,53,2.77
2020,CB2020,081,4,Queens,41159003001,251,105,146,6.47
2020,CB2020,081,4,Queens,41159003002,1653,765,888,7.13
2020,CB2020,081,4,Queens,41161001000,69,35,34,3.65
2020,CB2020,081,4,Queens,41161001001,35,18,17,1.87
2020,CB2020,081,4,Queens,41161001002,77,43,34,5.89
2020,CB2020,081,4,Queens,41161001003,1613,720,893,9.93
2020,CB2020,081,4,Queens,41161002000,1803,812,991,9.68
2020,CB2020,081,4,Queens,41161002001,988,434,554,12.38
2020,CB2020,081,4,Queens,41163011000,1731,842,889,6.13
2020,CB2020,081,4,Queens,41163012000,354,139,215,3.39
2020,CB2020,081,4,Queens,41163012001,1008,472,536,7.84
2020,CB2020,081,4,Queens,41163013000,769,335,434,7.44
2020,CB2020,081,4,Queens,41163013001,1316,611,705,8.17
2020,CB2020,081,4,Queens,41163021000,164,84,80,2.64
2020,CB2020,081,4,Queens,41163021001,900,463,437,4.85
2020,CB2020,081,4,Queens,41163021002,821,387,434,4.88
2020,CB2020,081,4,Queens,41163022000,814,399,415,7.71
2020,CB2020,081,4,Queens,41163022001,477,225,252,5.48
2020,CB2020,081,4,Queens,41163022002,285,143,142,3.63
2020,CB2020,081,4,Queens,41167001000,130,67,63,4.78
2020,CB2020,081,4,Queens,41167001001,74,31,43,3.39
2020,CB2020,081,4,Queens,41167001002,170,75,95,3.65
2020,CB2020,081,4,Queens,41167001003,52,25,27,1.35
2020,CB2020,081,4,Queens,41167001004,177,86,91,3.1
2020,CB2020,081,4,Queens,41167001005,91,30,61,5.35
2020,CB2020,081,4,Queens,41167001006,96,61,35,0.75
2020,CB2020,081,4,Queens,41167001007,318,178,140,1.57
2020,CB2020,081,4,Queens,41167001008,0,0,0,1.11
2020,CB2020,081,4,Queens,41167001009,56,19,37,1.93
2020,CB2020,081,4,Queens,41167001010,288,149,139,2.41
2020,CB2020,081,4,Queens,41167001011,245,112,133,2.41
2020,CB2020,081,4,Queens,41167001012,79,44,35,1.92
2020,CB2020,081,4,Queens,41167001013,188,105,83,2.17
2020,CB2020,081,4,Queens,41167001014,130,53,77,5.17
2020,CB2020,081,4,Queens,41171001000,79,37,42,5.64
2020,CB2020,081,4,Queens,41171001001,79,38,41,5.14
2020,CB2020,081,4,Queens,41171001002,16,6,10,4.6
2020,CB2020,081,4,Queens,41171001003,46,29,17,4.15
2020,CB2020,081,4,Queens,41171001004,62,13,49,3.74
2020,CB2020,081,4,Queens,41171001005,69,38,31,3.32
2020,CB2020,081,4,Queens,41171001006,76,46,30,1.28
2020,CB2020,081,4,Queens,41171001007,0,0,0,0.45
2020,CB2020,081,4,Queens,41171001008,108,43,65,5.61
2020,CB2020,081,4,Queens,41171001009,121,67,54,2.24
2020,CB2020,081,4,Queens,41171001010,26,18,8,5.44
2020,CB2020,081,4,Queens,41171001011,23,6,17,2.31
2020,CB2020,081,4,Queens,41171001012,18,3,15,1.85
2020,CB2020,081,4,Queens,41171001013,20,5,15,0.89
2020,CB2020,081,4,Queens,41171002000,329,160,169,5.9
2020,CB2020,081,4,Queens,41171002001,145,76,69,6.29
2020,CB2020,081,4,Queens,41171002002,243,111,132,6.41
2020,CB2020,081,4,Queens,41171002003,98,47,51,6.11
2020,CB2020,081,4,Queens,41171002004,0,0,0,0.41
2020,CB2020,081,4,Queens,41171002005,121,53,68,2.61
2020,CB2020,081,4,Queens,41171002006,0,0,0,0.79
2020,CB2020,081,4,Queens,41171003000,75,40,35,2.15
2020,CB2020,081,4,Queens,41171003001,17,15,2,0.89
2020,CB2020,081,4,Queens,41171003002,0,0,0,0.48
2020,CB2020,081,4,Queens,41171003003,62,36,26,3.32
2020,CB2020,081,4,Queens,41171003004,149,83,66,2.42
2020,CB2020,081,4,Queens,41171003005,308,165,143,2.51
2020,CB2020,081,4,Queens,41171003006,170,72,98,2.69
2020,CB2020,081,4,Queens,41171003007,194,76,118,2.18
2020,CB2020,081,4,Queens,41171003008,95,41,54,2.37
2020,CB2020,081,4,Queens,41171003009,88,35,53,3.82
2020,CB2020,081,4,Queens,41171003010,0,0,0,0.25
2020,CB2020,081,4,Queens,41175001000,125,69,56,3.47
2020,CB2020,081,4,Queens,41175001001,100,38,62,3.91
2020,CB2020,081,4,Queens,41175001002,99,43,56,4.31
2020,CB2020,081,4,Queens,41175001003,102,51,51,4.58
2020,CB2020,081,4,Queens,41175001004,299,129,170,4.79
2020,CB2020,081,4,Queens,41175001005,143,69,74,4.85
2020,CB2020,081,4,Queens,41175001006,88,52,36,4.83
2020,CB2020,081,4,Queens,41175001007,84,34,50,4.92
2020,CB2020,081,4,Queens,41175001008,170,84,86,5.34
2020,CB2020,081,4,Queens,41175002000,201,99,102,3.05
2020,CB2020,081,4,Queens,41175002001,343,174,169,2.87
2020,CB2020,081,4,Queens,41175002002,674,342,332,2.75
2020,CB2020,081,4,Queens,41175002003,211,65,146,2.71
2020,CB2020,081,4,Queens,41175002004,248,114,134,2.56
2020,CB2020,081,4,Queens,41175002005,226,134,92,2.07
2020,CB2020,081,4,Queens,41175003000,189,97,92,3.32
2020,CB2020,081,4,Queens,41175003001,107,63,44,3.08
2020,CB2020,081,4,Queens,41175003002,235,95,140,2.73
2020,CB2020,081,4,Queens,41175003003,0,0,0,3
2020,CB2020,081,4,Queens,41175003004,0,0,0,2.38
2020,CB2020,081,4,Queens,41175003005,95,45,50,3.83
2020,CB2020,081,4,Queens,41175003006,67,23,44,3.23
2020,CB2020,081,4,Queens,41175003007,107,52,55,4.33
2020,CB2020,081,4,Queens,41175003008,0,0,0,8.81
2020,CB2020,081,4,Queens,41175004000,119,56,63,3.21
2020,CB2020,081,4,Queens,41175004001,82,47,35,3.05
2020,CB2020,081,4,Queens,41175004002,66,23,43,2.73
2020,CB2020,081,4,Queens,41175004003,53,27,26,3.71
2020,CB2020,081,4,Queens,41175004004,23,13,10,1.82
2020,CB2020,081,4,Queens,41175004005,40,17,23,1.94
2020,CB2020,081,4,Queens,41175004006,70,49,21,2.2
2020,CB2020,081,4,Queens,41175004007,54,32,22,2.51
2020,CB2020,081,4,Queens,41175004008,74,29,45,3.06
2020,CB2020,081,4,Queens,41175004009,110,47,63,3.63
2020,CB2020,081,4,Queens,41175005000,219,117,102,3.38
2020,CB2020,081,4,Queens,41175005001,137,80,57,3.4
2020,CB2020,081,4,Queens,41175005002,122,63,59,3.35
2020,CB2020,081,4,Queens,41175005003,108,30,78,3.07
2020,CB2020,081,4,Queens,41175005004,118,57,61,3.02
2020,CB2020,081,4,Queens,41175005005,102,49,53,3.21
2020,CB2020,081,4,Queens,41181001000,99,55,44,1.89
2020,CB2020,081,4,Queens,41181001001,101,56,45,2.62
2020,CB2020,081,4,Queens,41181001002,148,62,86,3.92
2020,CB2020,081,4,Queens,41181001003,160,73,87,3.4
2020,CB2020,081,4,Queens,41181001004,154,92,62,3.61
2020,CB2020,081,4,Queens,41181001005,176,94,82,4.19
2020,CB2020,081,4,Queens,41181001006,108,36,72,3.09
2020,CB2020,081,4,Queens,41181001007,78,36,42,5.06
2020,CB2020,081,4,Queens,41181002000,205,109,96,3.39
2020,CB2020,081,4,Queens,41181002001,230,92,138,3.38
2020,CB2020,081,4,Queens,41181002002,235,98,137,3.39
2020,CB2020,081,4,Queens,41181002003,121,68,53,3.28
2020,CB2020,081,4,Queens,41181002004,116,63,53,3.46
2020,CB2020,081,4,Queens,41181002005,84,40,44,3.55
2020,CB2020,081,4,Queens,41185001000,0,0,0,0.29
2020,CB2020,081,4,Queens,41185001001,0,0,0,0.85
2020,CB2020,081,4,Queens,41185001002,70,24,46,1.39
2020,CB2020,081,4,Queens,41185001003,46,18,28,1.94
2020,CB2020,081,4,Queens,41185001004,22,1,21,2.47
2020,CB2020,081,4,Queens,41185001005,122,52,70,2.81
2020,CB2020,081,4,Queens,41185001006,269,132,137,2.9
2020,CB2020,081,4,Queens,41185001007,247,134,113,3.1
2020,CB2020,081,4,Queens,41185001008,199,107,92,3.26
2020,CB2020,081,4,Queens,41185001009,174,94,80,3.42
2020,CB2020,081,4,Queens,41185001010,246,130,116,3.66
2020,CB2020,081,4,Queens,41185002000,375,182,193,3.87
2020,CB2020,081,4,Queens,41185002001,320,131,189,4.08
2020,CB2020,081,4,Queens,41185002002,189,90,99,2.85
2020,CB2020,081,4,Queens,41185002003,78,53,25,1.43
2020,CB2020,081,4,Queens,41187001000,456,206,250,4.5
2020,CB2020,081,4,Queens,41187001001,317,146,171,3.71
2020,CB2020,081,4,Queens,41187001002,187,121,66,5.54
2020,CB2020,081,4,Queens,41187001003,218,120,98,2.34
2020,CB2020,081,4,Queens,41187002000,161,70,91,4.01
2020,CB2020,081,4,Queens,41187002001,311,175,136,4.64
2020,CB2020,081,4,Queens,41187002002,145,70,75,5.17
2020,CB2020,081,4,Queens,41187002003,281,122,159,4.18
2020,CB2020,081,4,Queens,41187002004,166,80,86,3.88
2020,CB2020,081,4,Queens,41187002005,233,124,109,4.95
2020,CB2020,081,4,Queens,41187002006,173,82,91,3.33
2020,CB2020,081,4,Queens,41189001000,98,36,62,2.08
2020,CB2020,081,4,Queens,41189001001,228,101,127,4.93
2020,CB2020,081,4,Queens,41189001002,235,103,132,3.85
2020,CB2020,081,4,Queens,41189001003,263,140,123,3.86
2020,CB2020,081,4,Queens,41189001004,288,181,107,4.94
2020,CB2020,081,4,Queens,41189001005,57,20,37,1.35
2020,CB2020,081,4,Queens,41189001006,21,8,13,0.61
2020,CB2020,081,4,Queens,41189001007,260,150,110,4.91
2020,CB2020,081,4,Queens,41189001008,217,115,102,3.93
2020,CB2020,081,4,Queens,41189002000,220,120,100,4.78
2020,CB2020,081,4,Queens,41189002001,198,95,103,4.07
2020,CB2020,081,4,Queens,41189002002,175,100,75,3.49
2020,CB2020,081,4,Queens,41189002003,137,52,85,3.67
2020,CB2020,081,4,Queens,41189002004,228,108,120,3.53
2020,CB2020,081,4,Queens,41191001000,358,177,181,5.12
2020,CB2020,081,4,Queens,41191001001,345,148,197,5.15
2020,CB2020,081,4,Queens,41191001002,377,186,191,5.12
2020,CB2020,081,4,Queens,41191001003,418,247,171,5.14
2020,CB2020,081,4,Queens,41191001004,183,84,99,2.16
2020,CB2020,081,4,Queens,41191001005,203,108,95,2.95
2020,CB2020,081,4,Queens,41191001006,437,203,234,5.14
2020,CB2020,081,4,Queens,41191002000,302,168,134,5.77
2020,CB2020,081,4,Queens,41191002001,363,173,190,5.75
2020,CB2020,081,4,Queens,41191002002,489,235,254,5.72
2020,CB2020,081,4,Queens,41191002003,219,105,114,5.78
2020,CB2020,081,4,Queens,41193001000,148,73,75,5.93
2020,CB2020,081,4,Queens,41193001001,123,72,51,5.15
2020,CB2020,081,4,Queens,41193001002,135,47,88,5.13
2020,CB2020,081,4,Queens,41193001003,142,67,75,5.14
2020,CB2020,081,4,Queens,41193001004,149,77,72,5.13
2020,CB2020,081,4,Queens,41193001005,186,96,90,5.14
2020,CB2020,081,4,Queens,41193001006,410,198,212,5.11
2020,CB2020,081,4,Queens,41193002000,372,153,219,5.14
2020,CB2020,081,4,Queens,41193002001,338,206,132,5.15
2020,CB2020,081,4,Queens,41193002002,404,183,221,5.14
2020,CB2020,081,4,Queens,41195001000,82,51,31,3.14
2020,CB2020,081,4,Queens,41195001001,125,62,63,4.35
2020,CB2020,081,4,Queens,41195001002,99,45,54,4.27
2020,CB2020,081,4,Queens,41195001003,119,69,50,4.28
2020,CB2020,081,4,Queens,41195001004,157,81,76,4.5
2020,CB2020,081,4,Queens,41195001005,36,28,8,4.78
2020,CB2020,081,4,Queens,41195001006,151,57,94,5.05
2020,CB2020,081,4,Queens,41195001007,216,109,107,5.05
2020,CB2020,081,4,Queens,41195001008,111,50,61,5.73
2020,CB2020,081,4,Queens,41195001009,349,172,177,5.65
2020,CB2020,081,4,Queens,41199001000,237,145,92,5.75
2020,CB2020,081,4,Queens,41199001001,106,47,59,3.63
2020,CB2020,081,4,Queens,41199001002,79,30,49,2.1
2020,CB2020,081,4,Queens,41199001003,364,154,210,5.79
2020,CB2020,081,4,Queens,41199001004,148,67,81,4.65
2020,CB2020,081,4,Queens,41199001005,71,47,24,2.69
2020,CB2020,081,4,Queens,41199001006,72,41,31,1.93
2020,CB2020,081,4,Queens,41199001007,157,71,86,4.65
2020,CB2020,081,4,Queens,41199001008,122,66,56,3.64
2020,CB2020,081,4,Queens,41199001009,95,49,46,4.12
2020,CB2020,081,4,Queens,41199001010,104,54,50,2.98
2020,CB2020,081,4,Queens,41199001011,97,54,43,2.41
2020,CB2020,081,4,Queens,41199001012,47,25,22,1.2
2020,CB2020,081,4,Queens,41201001000,186,98,88,4.05
2020,CB2020,081,4,Queens,41201001001,150,74,76,3.62
2020,CB2020,081,4,Queens,41201001002,195,96,99,3.56
2020,CB2020,081,4,Queens,41201001003,177,89,88,3.27
2020,CB2020,081,4,Queens,41201001004,139,50,89,3.08
2020,CB2020,081,4,Queens,41201001005,218,99,119,4.36
2020,CB2020,081,4,Queens,41201001006,252,151,101,4.11
2020,CB2020,081,4,Queens,41201001007,65,29,36,3.08
2020,CB2020,081,4,Queens,41201001008,113,68,45,3.62
2020,CB2020,081,4,Queens,41201001009,122,66,56,2.28
2020,CB2020,081,4,Queens,41201001010,129,57,72,2.69
2020,CB2020,081,4,Queens,41201001011,94,37,57,2.52
2020,CB2020,081,4,Queens,41203001000,80,25,55,3.95
2020,CB2020,081,4,Queens,41203001001,46,28,18,3.18
2020,CB2020,081,4,Queens,41203001002,141,58,83,3.9
2020,CB2020,081,4,Queens,41203001003,40,23,17,1.45
2020,CB2020,081,4,Queens,41203001004,159,95,64,3.31
2020,CB2020,081,4,Queens,41203001005,150,78,72,3.92
2020,CB2020,081,4,Queens,41203001006,162,77,85,3.92
2020,CB2020,081,4,Queens,41203002000,65,42,23,1.58
2020,CB2020,081,4,Queens,41203002001,197,100,97,3.92
2020,CB2020,081,4,Queens,41203002002,181,87,94,3.98
2020,CB2020,081,4,Queens,41203002003,49,17,32,1.53
2020,CB2020,081,4,Queens,41203002004,54,28,26,1.55
2020,CB2020,081,4,Queens,41203002005,184,87,97,3.87
2020,CB2020,081,4,Queens,41203002006,262,133,129,3.84
2020,CB2020,081,4,Queens,41203002007,48,33,15,1.55
2020,CB2020,081,4,Queens,41205001000,273,110,163,3.9
2020,CB2020,081,4,Queens,41205001001,278,165,113,3.73
2020,CB2020,081,4,Queens,41205001002,195,95,100,3.58
2020,CB2020,081,4,Queens,41205001003,149,74,75,5.67
2020,CB2020,081,4,Queens,41205001004,280,168,112,5.08
2020,CB2020,081,4,Queens,41205001005,160,75,85,2.82
2020,CB2020,081,4,Queens,41205001006,180,80,100,2.65
2020,CB2020,081,4,Queens,41205001007,91,48,43,2.47
2020,CB2020,081,4,Queens,41205002000,190,80,110,4.35
2020,CB2020,081,4,Queens,41205002001,327,207,120,4.35
2020,CB2020,081,4,Queens,41205002002,187,87,100,4.37
2020,CB2020,081,4,Queens,41205002003,834,373,461,7
2020,CB2020,081,4,Queens,41207011000,170,78,92,4.23
2020,CB2020,081,4,Queens,41207011001,313,187,126,4.65
2020,CB2020,081,4,Queens,41207011002,319,145,174,4.61
2020,CB2020,081,4,Queens,41207011003,179,81,98,4.69
2020,CB2020,081,4,Queens,41207011004,128,57,71,3.64
2020,CB2020,081,4,Queens,41207011005,87,32,55,3.63
2020,CB2020,081,4,Queens,41207011006,67,33,34,3.37
2020,CB2020,081,4,Queens,41207011007,99,42,57,3.64
2020,CB2020,081,4,Queens,41207011008,86,40,46,3.65
2020,CB2020,081,4,Queens,41207011009,155,77,78,3.65
2020,CB2020,081,4,Queens,41207011010,31,9,22,1.14
2020,CB2020,081,4,Queens,41207011011,79,39,40,3.12
2020,CB2020,081,4,Queens,41207011012,31,18,13,0.88
2020,CB2020,081,4,Queens,41207011013,119,68,51,3.95
2020,CB2020,081,4,Queens,41207012000,107,48,59,3.13
2020,CB2020,081,4,Queens,41207012001,72,43,29,2.88
2020,CB2020,081,4,Queens,41207012002,101,53,48,2.91
2020,CB2020,081,4,Queens,41207012003,83,40,43,2.94
2020,CB2020,081,4,Queens,41207012004,82,28,54,3.56
2020,CB2020,081,4,Queens,41207012005,83,45,38,3.17
2020,CB2020,081,4,Queens,41207012006,101,47,54,4.41
2020,CB2020,081,4,Queens,41207012007,151,77,74,4.04
2020,CB2020,081,4,Queens,41207012008,13,5,8,0.27
2020,CB2020,081,4,Queens,41207012009,87,61,26,1.57
2020,CB2020,081,4,Queens,41207012010,127,51,76,5.1
2020,CB2020,081,4,Queens,41207012011,94,37,57,2.18
2020,CB2020,081,4,Queens,41207012012,46,18,28,2.9
2020,CB2020,081,4,Queens,41207012013,48,30,18,8.81
2020,CB2020,081,4,Queens,41207021000,3,2,1,77.27
2020,CB2020,081,4,Queens,41211001000,0,0,0,94.86
2020,CB2020,081,4,Queens,41211001001,2,2,0,147.23
2020,CB2020,081,4,Queens,41215001000,135,43,92,62.35
2020,CB2020,081,4,Queens,41215001001,65,34,31,1.02
2020,CB2020,081,4,Queens,41215001002,231,132,99,3.92
2020,CB2020,081,4,Queens,41215001003,212,93,119,3.57
2020,CB2020,081,4,Queens,41215001004,181,91,90,3.36
2020,CB2020,081,4,Queens,41215001005,171,70,101,3.63
2020,CB2020,081,4,Queens,41215001006,194,112,82,3.63
2020,CB2020,081,4,Queens,41215001007,238,131,107,3.78
2020,CB2020,081,4,Queens,41215001008,0,0,0,1.62
2020,CB2020,081,4,Queens,41215001009,0,0,0,1.88
2020,CB2020,081,4,Queens,41215001010,0,0,0,2.05
2020,CB2020,081,4,Queens,41215002000,167,91,76,3.25
2020,CB2020,081,4,Queens,41215002001,46,18,28,3.34
2020,CB2020,081,4,Queens,41215002002,136,64,72,3.71
2020,CB2020,081,4,Queens,41215002003,86,36,50,2.03
2020,CB2020,081,4,Queens,41215002004,115,56,59,1.92
2020,CB2020,081,4,Queens,41215002005,271,130,141,4.08
2020,CB2020,081,4,Queens,41215002006,195,98,97,4.29
2020,CB2020,081,4,Queens,41215002007,105,66,39,2.37
2020,CB2020,081,4,Queens,41215002008,164,86,78,2.71
2020,CB2020,081,4,Queens,41215002009,126,46,80,3.01
2020,CB2020,081,4,Queens,41215003000,301,152,149,3.79
2020,CB2020,081,4,Queens,41215003001,276,152,124,3.8
2020,CB2020,081,4,Queens,41215003002,206,105,101,3.9
2020,CB2020,081,4,Queens,41215003003,138,51,87,1.94
2020,CB2020,081,4,Queens,41215003004,165,96,69,3.77
2020,CB2020,081,4,Queens,41215003005,287,137,150,3.76
2020,CB2020,081,4,Queens,41215003006,242,109,133,3.68
2020,CB2020,081,4,Queens,41215003007,139,78,61,3.77
2020,CB2020,081,4,Queens,41215003008,0,0,0,4.17
2020,CB2020,081,4,Queens,41215003009,72,42,30,0.74
2020,CB2020,081,4,Queens,41215003010,73,49,24,1.23
2020,CB2020,081,4,Queens,41223001000,0,0,0,2.19
2020,CB2020,081,4,Queens,41223001001,0,0,0,4.62
2020,CB2020,081,4,Queens,41223001002,188,89,99,2.91
2020,CB2020,081,4,Queens,41223001003,184,61,123,2.89
2020,CB2020,081,4,Queens,41223001004,255,115,140,2.89
2020,CB2020,081,4,Queens,41223001005,192,83,109,2.88
2020,CB2020,081,4,Queens,41223001006,263,123,140,2.89
2020,CB2020,081,4,Queens,41223001007,187,100,87,2.93
2020,CB2020,081,4,Queens,41223001008,135,78,57,2.99
2020,CB2020,081,4,Queens,41223001009,198,106,92,2.88
2020,CB2020,081,4,Queens,41223002000,79,34,45,3.84
2020,CB2020,081,4,Queens,41223002001,108,50,58,3.84
2020,CB2020,081,4,Queens,41223002002,91,41,50,3.85
2020,CB2020,081,4,Queens,41223002003,83,49,34,3.85
2020,CB2020,081,4,Queens,41223002004,121,65,56,3.84
2020,CB2020,081,4,Queens,41223002005,117,61,56,3.85
2020,CB2020,081,4,Queens,41223002006,97,55,42,3.84
2020,CB2020,081,4,Queens,41223002007,80,30,50,3.85
2020,CB2020,081,4,Queens,41223002008,99,35,64,3.83
2020,CB2020,081,4,Queens,41223003000,101,50,51,6.44
2020,CB2020,081,4,Queens,41223003001,89,37,52,3.84
2020,CB2020,081,4,Queens,41223003002,64,39,25,2.38
2020,CB2020,081,4,Queens,41223003003,83,25,58,3.84
2020,CB2020,081,4,Queens,41223003004,102,55,47,3.86
2020,CB2020,081,4,Queens,41223003005,84,26,58,3.84
2020,CB2020,081,4,Queens,41223003006,95,36,59,3.86
2020,CB2020,081,4,Queens,41223003007,86,39,47,3.84
2020,CB2020,081,4,Queens,41223003008,110,51,59,3.85
2020,CB2020,081,4,Queens,41223003009,104,55,49,2.98
2020,CB2020,081,4,Queens,41223003010,60,32,28,2.98
2020,CB2020,081,4,Queens,41223003011,67,49,18,2.99
2020,CB2020,081,4,Queens,41223003012,57,21,36,3
2020,CB2020,081,4,Queens,41223003013,65,37,28,2.99
2020,CB2020,081,4,Queens,41223003014,54,30,24,2.99
2020,CB2020,081,4,Queens,41223003015,40,11,29,1.45
2020,CB2020,081,4,Queens,41223003016,84,41,43,2.72
2020,CB2020,081,4,Queens,41227021000,542,253,289,3.72
2020,CB2020,081,4,Queens,41227021001,794,404,390,18.04
2020,CB2020,081,4,Queens,41227021002,0,0,0,3.49
2020,CB2020,081,4,Queens,41227021003,0,0,0,0.59
2020,CB2020,081,4,Queens,41227021004,0,0,0,1.82
2020,CB2020,081,4,Queens,41227022000,447,180,267,4.54
2020,CB2020,081,4,Queens,41227022001,1142,397,745,13.39
2020,CB2020,081,4,Queens,41227023000,1190,485,705,14.18
2020,CB2020,081,4,Queens,41227023001,959,351,608,13.95
2020,CB2020,081,4,Queens,41227024000,45,30,15,0.66
2020,CB2020,081,4,Queens,41227024001,649,232,417,5.61
2020,CB2020,081,4,Queens,41227024002,330,151,179,13.13
2020,CB2020,081,4,Queens,41227025000,0,0,0,1.29
2020,CB2020,081,4,Queens,41227025001,0,0,0,3
2020,CB2020,081,4,Queens,41227025002,147,66,81,2.27
2020,CB2020,081,4,Queens,41227025003,141,77,64,2.01
2020,CB2020,081,4,Queens,41227025004,0,0,0,0.6
2020,CB2020,081,4,Queens,41227025005,170,88,82,2.92
2020,CB2020,081,4,Queens,41227025006,232,96,136,2.9
2020,CB2020,081,4,Queens,41227025007,100,55,45,1.79
2020,CB2020,081,4,Queens,41227025008,71,36,35,1.23
2020,CB2020,081,4,Queens,41227031000,0,0,0,1.06
2020,CB2020,081,4,Queens,41227031001,0,0,0,2.36
2020,CB2020,081,4,Queens,41227031002,186,93,93,2.95
2020,CB2020,081,4,Queens,41227031003,156,75,81,3.02
2020,CB2020,081,4,Queens,41227031004,225,118,107,2.91
2020,CB2020,081,4,Queens,41227031005,220,132,88,2.91
2020,CB2020,081,4,Queens,41227031006,168,93,75,2.92
2020,CB2020,081,4,Queens,41227031007,263,118,145,3.17
2020,CB2020,081,4,Queens,41227032000,1955,950,1005,24.72
2020,CB2020,081,4,Queens,41227033000,1238,618,620,14.04
2020,CB2020,081,4,Queens,41227034000,1618,780,838,26.69
2020,CB2020,081,4,Queens,41227035000,184,97,87,2.89
2020,CB2020,081,4,Queens,41227035001,204,106,98,3.21
2020,CB2020,081,4,Queens,41227035002,116,54,62,4.35
2020,CB2020,081,4,Queens,41227035003,96,38,58,3.84
2020,CB2020,081,4,Queens,41227035004,108,70,38,4.34
2020,CB2020,081,4,Queens,41227035005,64,35,29,3.35
2020,CB2020,081,4,Queens,41227041000,547,286,261,5.06
2020,CB2020,081,4,Queens,41227041001,487,213,274,4.82
2020,CB2020,081,4,Queens,41227041002,990,458,532,10.78
2020,CB2020,081,4,Queens,41227042000,897,437,460,20.93
2020,CB2020,081,4,Queens,41227043000,114,62,52,2.39
2020,CB2020,081,4,Queens,41227043001,135,71,64,2.85
2020,CB2020,081,4,Queens,41227043002,207,108,99,4.5
2020,CB2020,081,4,Queens,41227043003,188,84,104,3.89
2020,CB2020,081,4,Queens,41227043004,282,142,140,5.07
2020,CB2020,081,4,Queens,41227043005,597,297,300,4.25
2020,CB2020,081,4,Queens,41241001000,25,15,10,1.82
2020,CB2020,081,4,Queens,41241001001,56,18,38,1.93
2020,CB2020,081,4,Queens,41241001002,56,34,22,2.03
2020,CB2020,081,4,Queens,41241001003,50,21,29,2.14
2020,CB2020,081,4,Queens,41241001004,111,72,39,2.28
2020,CB2020,081,4,Queens,41241001005,136,59,77,5.06
2020,CB2020,081,4,Queens,41241001006,71,21,50,4.95
2020,CB2020,081,4,Queens,41241001007,97,50,47,4.62
2020,CB2020,081,4,Queens,41241001008,82,51,31,4.67
2020,CB2020,081,4,Queens,41241001009,78,44,34,3.7
2020,CB2020,081,4,Queens,41241001010,47,22,25,2.62
2020,CB2020,081,4,Queens,41241001011,45,14,31,2.05
2020,CB2020,081,4,Queens,41241001012,37,23,14,1.64
2020,CB2020,081,4,Queens,41241001013,19,10,9,1.53
2020,CB2020,081,4,Queens,41241001014,33,24,9,1.51
2020,CB2020,081,4,Queens,41241001015,127,62,65,3.46
2020,CB2020,081,4,Queens,41241001016,68,27,41,2.07
2020,CB2020,081,4,Queens,41241001017,72,30,42,1.9
2020,CB2020,081,4,Queens,41241001018,59,33,26,1.22
2020,CB2020,081,4,Queens,41241001019,106,58,48,3
2020,CB2020,081,4,Queens,41241001020,71,33,38,1.16
2020,CB2020,081,4,Queens,41241001021,91,35,56,2.89
2020,CB2020,081,4,Queens,41241001022,129,67,62,3.37
2020,CB2020,081,4,Queens,41241002000,130,51,79,2.71
2020,CB2020,081,4,Queens,41241002001,125,82,43,2.78
2020,CB2020,081,4,Queens,41241002002,106,54,52,2.8
2020,CB2020,081,4,Queens,41241002003,161,74,87,3.87
2020,CB2020,081,4,Queens,41241002004,130,59,71,3.63
2020,CB2020,081,4,Queens,41241002005,128,70,58,3.42
2020,CB2020,081,4,Queens,41241002006,98,37,61,3.44
2020,CB2020,081,4,Queens,41241002007,98,44,54,3.49
2020,CB2020,081,4,Queens,41241002008,151,79,72,3.72
2020,CB2020,081,4,Queens,41241003000,97,57,40,3.6
2020,CB2020,081,4,Queens,41241003001,138,83,55,2.8
2020,CB2020,081,4,Queens,41241003002,129,80,49,2.69
2020,CB2020,081,4,Queens,41241003003,122,44,78,3.67
2020,CB2020,081,4,Queens,41241003004,129,65,64,3.8
2020,CB2020,081,4,Queens,41241003005,122,56,66,4.15
2020,CB2020,081,4,Queens,41241003006,304,126,178,4.13
2020,CB2020,081,4,Queens,41241003007,86,34,52,3.3
2020,CB2020,081,4,Queens,41241003008,84,35,49,3.68
2020,CB2020,081,4,Queens,41247001000,128,43,85,3.01
2020,CB2020,081,4,Queens,41247001001,159,107,52,3.56
2020,CB2020,081,4,Queens,41247001002,155,76,79,3.47
2020,CB2020,081,4,Queens,41247001003,92,40,52,3.28
2020,CB2020,081,4,Queens,41247001004,79,35,44,3.03
2020,CB2020,081,4,Queens,41247001005,37,5,32,1.97
2020,CB2020,081,4,Queens,41247001006,53,24,29,1.98
2020,CB2020,081,4,Queens,41247001007,61,31,30,2.23
2020,CB2020,081,4,Queens,41247001008,49,32,17,2.42
2020,CB2020,081,4,Queens,41247001009,50,26,24,2.59
2020,CB2020,081,4,Queens,41247001010,18,5,13,4.18
2020,CB2020,081,4,Queens,41247001011,83,52,31,3.69
2020,CB2020,081,4,Queens,41247001012,42,23,19,2.15
2020,CB2020,081,4,Queens,41247001013,85,29,56,2.47
2020,CB2020,081,4,Queens,41247002000,141,53,88,3.43
2020,CB2020,081,4,Queens,41247002001,176,109,67,3.11
2020,CB2020,081,4,Queens,41247002002,158,61,97,2.98
2020,CB2020,081,4,Queens,41247002003,126,59,67,2.99
2020,CB2020,081,4,Queens,41247002004,82,46,36,2.99
2020,CB2020,081,4,Queens,41247002005,38,26,12,1.7
2020,CB2020,081,4,Queens,41247002006,113,61,52,4.88
2020,CB2020,081,4,Queens,41247002007,141,74,67,4.19
2020,CB2020,081,4,Queens,41247002008,186,93,93,3.75
2020,CB2020,081,4,Queens,41247002009,155,60,95,3.56
2020,CB2020,081,4,Queens,41247002010,40,29,11,0.87
2020,CB2020,081,4,Queens,41247002011,68,34,34,3.56
2020,CB2020,081,4,Queens,41247003000,92,39,53,2.32
2020,CB2020,081,4,Queens,41247003001,98,61,37,3.96
2020,CB2020,081,4,Queens,41247003002,89,29,60,4.42
2020,CB2020,081,4,Queens,41247003003,113,71,42,4.77
2020,CB2020,081,4,Queens,41247003004,92,50,42,5.1
2020,CB2020,081,4,Queens,41247003005,153,68,85,5.37
2020,CB2020,081,4,Queens,41247003006,104,61,43,2.99
2020,CB2020,081,4,Queens,41247003007,159,75,84,3.23
2020,CB2020,081,4,Queens,41247003008,140,72,68,3.1
2020,CB2020,081,4,Queens,41247003009,106,33,73,2.89
2020,CB2020,081,4,Queens,41247003010,73,36,37,3.29
2020,CB2020,081,4,Queens,41257001000,95,53,42,2.15
2020,CB2020,081,4,Queens,41257001001,21,9,12,0.71
2020,CB2020,081,4,Queens,41257001002,177,88,89,2.35
2020,CB2020,081,4,Queens,41257001003,79,61,18,1.04
2020,CB2020,081,4,Queens,41257001004,113,48,65,3.29
2020,CB2020,081,4,Queens,41257001005,115,45,70,2.88
2020,CB2020,081,4,Queens,41257001006,9,3,6,2.87
2020,CB2020,081,4,Queens,41257001007,201,101,100,3.33
2020,CB2020,081,4,Queens,41257001008,186,67,119,3.49
2020,CB2020,081,4,Queens,41257001009,149,67,82,2.87
2020,CB2020,081,4,Queens,41257001010,125,60,65,2.87
2020,CB2020,081,4,Queens,41257001011,288,133,155,3.7
2020,CB2020,081,4,Queens,41257002000,65,30,35,2.67
2020,CB2020,081,4,Queens,41257002001,104,59,45,2.99
2020,CB2020,081,4,Queens,41257002002,0,0,0,3.8
2020,CB2020,081,4,Queens,41257002003,152,72,80,3.6
2020,CB2020,081,4,Queens,41257002004,156,63,93,3
2020,CB2020,081,4,Queens,41257002005,74,29,45,2.6
2020,CB2020,081,4,Queens,41257002006,80,59,21,2.47
2020,CB2020,081,4,Queens,41257002007,118,73,45,3
2020,CB2020,081,4,Queens,41257002008,165,70,95,3.36
2020,CB2020,081,4,Queens,41257003000,155,65,90,2.38
2020,CB2020,081,4,Queens,41257003001,148,88,60,3
2020,CB2020,081,4,Queens,41257003002,102,61,41,3.15
2020,CB2020,081,4,Queens,41257003003,122,39,83,2.93
2020,CB2020,081,4,Queens,41257003004,95,51,44,3
2020,CB2020,081,4,Queens,41257003005,283,118,165,2.35
2020,CB2020,081,4,Queens,41257003006,0,0,0,0.44
2020,CB2020,081,4,Queens,41257003007,265,159,106,5.7
2020,CB2020,081,4,Queens,41265001000,115,52,63,2.99
2020,CB2020,081,4,Queens,41265001001,82,32,50,2.96
2020,CB2020,081,4,Queens,41265001002,76,60,16,2.52
2020,CB2020,081,4,Queens,41265001003,135,72,63,2.51
2020,CB2020,081,4,Queens,41265001004,38,16,22,2.57
2020,CB2020,081,4,Queens,41265001005,78,42,36,3.45
2020,CB2020,081,4,Queens,41265001006,71,25,46,2.82
2020,CB2020,081,4,Queens,41265001007,82,44,38,2.95
2020,CB2020,081,4,Queens,41265001008,78,51,27,3.07
2020,CB2020,081,4,Queens,41265001009,67,23,44,3.22
2020,CB2020,081,4,Queens,41265002000,181,81,100,5.14
2020,CB2020,081,4,Queens,41265002001,177,73,104,4.23
2020,CB2020,081,4,Queens,41265002002,114,60,54,3.89
2020,CB2020,081,4,Queens,41265002003,104,55,49,3.65
2020,CB2020,081,4,Queens,41265002004,197,106,91,3.64
2020,CB2020,081,4,Queens,41267001000,2376,1057,1319,95.24
2020,CB2020,081,4,Queens,41267001001,72,25,47,2.73
2020,CB2020,081,4,Queens,41267001002,117,39,78,2.81
2020,CB2020,081,4,Queens,41267001003,97,41,56,3.3
2020,CB2020,081,4,Queens,41267001004,11,11,0,1.58
2020,CB2020,081,4,Queens,41267001005,93,54,39,3.35
2020,CB2020,081,4,Queens,41267001006,63,27,36,3.16
2020,CB2020,081,4,Queens,41267001007,63,34,29,3.34
2020,CB2020,081,4,Queens,41267001008,37,28,9,1.69
2020,CB2020,081,4,Queens,41267001009,0,0,0,6.79
2020,CB2020,081,4,Queens,41267002000,164,106,58,4.57
2020,CB2020,081,4,Queens,41267002001,7,5,2,23.6
2020,CB2020,081,4,Queens,41267002002,140,58,82,4.5
2020,CB2020,081,4,Queens,41267002003,64,21,43,2.52
2020,CB2020,081,4,Queens,41267002004,120,49,71,2.21
2020,CB2020,081,4,Queens,41267002005,127,51,76,2.32
2020,CB2020,081,4,Queens,41267003000,124,68,56,3.49
2020,CB2020,081,4,Queens,41267003001,129,80,49,3.28
2020,CB2020,081,4,Queens,41267003002,109,56,53,3.28
2020,CB2020,081,4,Queens,41267003003,118,57,61,3.37
2020,CB2020,081,4,Queens,41267003004,132,44,88,3.32
2020,CB2020,081,4,Queens,41267003005,108,43,65,3.12
2020,CB2020,081,4,Queens,41267003006,135,59,76,3
2020,CB2020,081,4,Queens,41267003007,84,49,35,3.25
2020,CB2020,081,4,Queens,41277001000,64,32,32,5.79
2020,CB2020,081,4,Queens,41277001001,142,84,58,6.78
2020,CB2020,081,4,Queens,41277001002,79,53,26,3.22
2020,CB2020,081,4,Queens,41277001003,57,26,31,4.61
2020,CB2020,081,4,Queens,41277001004,130,59,71,9.47
2020,CB2020,081,4,Queens,41277001005,101,54,47,8.23
2020,CB2020,081,4,Queens,41277001006,131,39,92,6.39
2020,CB2020,081,4,Queens,41277001007,106,56,50,6.78
2020,CB2020,081,4,Queens,41277001008,79,33,46,9.14
2020,CB2020,081,4,Queens,41277001009,42,30,12,5.63
2020,CB2020,081,4,Queens,41277001010,50,16,34,6.81
2020,CB2020,081,4,Queens,41277001011,64,35,29,4.92
2020,CB2020,081,4,Queens,41277001012,0,0,0,2.31
2020,CB2020,081,4,Queens,41277001013,64,38,26,7.66
2020,CB2020,081,4,Queens,41277001014,38,26,12,3.67
2020,CB2020,081,4,Queens,41277001015,10,3,7,1.38
2020,CB2020,081,4,Queens,41277001016,0,0,0,0.89
2020,CB2020,081,4,Queens,41277002000,52,19,33,5.07
2020,CB2020,081,4,Queens,41277002001,66,45,21,4.55
2020,CB2020,081,4,Queens,41277002002,113,62,51,5.25
2020,CB2020,081,4,Queens,41277002003,42,20,22,5.47
2020,CB2020,081,4,Queens,41277002004,67,23,44,6.04
2020,CB2020,081,4,Queens,41277002005,105,80,25,5.11
2020,CB2020,081,4,Queens,41277002006,50,20,30,2.52
2020,CB2020,081,4,Queens,41277002007,73,20,53,4.47
2020,CB2020,081,4,Queens,41277002008,83,34,49,5.88
2020,CB2020,081,4,Queens,41277002009,75,17,58,7.08
2020,CB2020,081,4,Queens,41277002010,72,40,32,4.44
2020,CB2020,081,4,Queens,41277003000,32,27,5,2.86
2020,CB2020,081,4,Queens,41277003001,36,24,12,2.98
2020,CB2020,081,4,Queens,41277003002,43,14,29,2.46
2020,CB2020,081,4,Queens,41277003003,65,26,39,4.97
2020,CB2020,081,4,Queens,41277003004,65,42,23,4.92
2020,CB2020,081,4,Queens,41277003005,42,29,13,4.87
2020,CB2020,081,4,Queens,41277003006,89,31,58,7.5
2020,CB2020,081,4,Queens,41277003007,83,41,42,5.37
2020,CB2020,081,4,Queens,41277003008,63,41,22,4.47
2020,CB2020,081,4,Queens,41277003009,74,38,36,4.1
2020,CB2020,081,4,Queens,41277003010,93,45,48,4.45
2020,CB2020,081,4,Queens,41277003011,49,16,33,3.15
2020,CB2020,081,4,Queens,41277003012,0,0,0,7.6
2020,CB2020,081,4,Queens,41277003013,43,8,35,3.01
2020,CB2020,081,4,Queens,41277004000,78,47,31,4.24
2020,CB2020,081,4,Queens,41277004001,92,39,53,4.08
2020,CB2020,081,4,Queens,41277004002,91,44,47,4.09
2020,CB2020,081,4,Queens,41277004003,48,31,17,4.27
2020,CB2020,081,4,Queens,41277004004,67,35,32,3.95
2020,CB2020,081,4,Queens,41277004005,86,51,35,3.73
2020,CB2020,081,4,Queens,41277004006,91,34,57,3.72
2020,CB2020,081,4,Queens,41277004007,87,40,47,3.89
2020,CB2020,081,4,Queens,41277004008,31,21,10,2.34
2020,CB2020,081,4,Queens,41277004009,45,16,29,2.63
2020,CB2020,081,4,Queens,41277004010,58,35,23,3.58
2020,CB2020,081,4,Queens,41277004011,66,19,47,4.61
2020,CB2020,081,4,Queens,41277004012,28,2,26,6.78
2020,CB2020,081,4,Queens,41283001000,0,0,0,1.18
2020,CB2020,081,4,Queens,41283001001,0,0,0,0.7
2020,CB2020,081,4,Queens,41283001002,0,0,0,1.06
2020,CB2020,081,4,Queens,41283001003,0,0,0,71.91
2020,CB2020,081,4,Queens,41283001004,0,0,0,1.13
2020,CB2020,081,4,Queens,41283001005,0,0,0,1.25
2020,CB2020,081,4,Queens,41283001006,0,0,0,79.06
2020,CB2020,081,4,Queens,41283001007,0,0,0,2.52
2020,CB2020,081,4,Queens,41283001008,0,0,0,16.92
2020,CB2020,081,4,Queens,41283001009,0,0,0,36.11
2020,CB2020,081,4,Queens,41283001010,0,0,0,53.36
2020,CB2020,081,4,Queens,41283001011,5,4,1,83.36
2020,CB2020,081,4,Queens,41283001012,0,0,0,3.16
2020,CB2020,081,4,Queens,41283001013,0,0,0,2.01
2020,CB2020,081,4,Queens,41283001014,0,0,0,2.56
2020,CB2020,081,4,Queens,41283001015,0,0,0,6.58
2020,CB2020,081,4,Queens,41283001016,0,0,0,119.8
2020,CB2020,081,4,Queens,41283001017,0,0,0,1.01
2020,CB2020,081,4,Queens,41283001018,0,0,0,2.04
2020,CB2020,081,4,Queens,41283001019,0,0,0,1.54
2020,CB2020,081,4,Queens,41291021000,75,47,28,4.17
2020,CB2020,081,4,Queens,41291021001,52,16,36,5.39
2020,CB2020,081,4,Queens,41291021002,92,39,53,4.22
2020,CB2020,081,4,Queens,41291021003,60,34,26,4.4
2020,CB2020,081,4,Queens,41291021004,101,50,51,4.28
2020,CB2020,081,4,Queens,41291021005,104,60,44,4.47
2020,CB2020,081,4,Queens,41291021006,89,39,50,4.67
2020,CB2020,081,4,Queens,41291021007,73,29,44,4.87
2020,CB2020,081,4,Queens,41291021008,74,45,29,5.06
2020,CB2020,081,4,Queens,41291021009,136,74,62,5.47
2020,CB2020,081,4,Queens,41291021010,142,61,81,5.71
2020,CB2020,081,4,Queens,41291021011,31,21,10,2.77
2020,CB2020,081,4,Queens,41291022000,81,40,41,4.53
2020,CB2020,081,4,Queens,41291022001,83,52,31,5.87
2020,CB2020,081,4,Queens,41291022002,56,12,44,3.48
2020,CB2020,081,4,Queens,41291022003,0,0,0,13.66
2020,CB2020,081,4,Queens,41291022004,64,32,32,2.84
2020,CB2020,081,4,Queens,41291022005,55,21,34,3.62
2020,CB2020,081,4,Queens,41291022006,81,36,45,4.2
2020,CB2020,081,4,Queens,41291022007,86,50,36,4.23
2020,CB2020,081,4,Queens,41291022008,64,40,24,4.24
2020,CB2020,081,4,Queens,41291022009,108,58,50,4.24
2020,CB2020,081,4,Queens,41291022010,104,40,64,4.28
2020,CB2020,081,4,Queens,41291022011,53,32,21,3.61
2020,CB2020,081,4,Queens,41291022012,25,20,5,2.17
2020,CB2020,081,4,Queens,41291022013,0,0,0,15.3
2020,CB2020,081,4,Queens,41291022014,30,21,9,2.1
2020,CB2020,081,4,Queens,41291022015,50,22,28,2.52
2020,CB2020,081,4,Queens,41291023000,72,24,48,4.27
2020,CB2020,081,4,Queens,41291023001,68,43,25,4.29
2020,CB2020,081,4,Queens,41291023002,63,22,41,4.32
2020,CB2020,081,4,Queens,41291023003,69,26,43,4.03
2020,CB2020,081,4,Queens,41291023004,57,29,28,4.03
2020,CB2020,081,4,Queens,41291023005,77,43,34,4.02
2020,CB2020,081,4,Queens,41291023006,65,47,18,4.03
2020,CB2020,081,4,Queens,41291023007,83,38,45,4.04
2020,CB2020,081,4,Queens,41291023008,62,16,46,4.25
2020,CB2020,081,4,Queens,41291023009,20,11,9,1.9
2020,CB2020,081,4,Queens,41291023010,0,0,0,18.92
2020,CB2020,081,4,Queens,41291023011,57,39,18,3.81
2020,CB2020,081,4,Queens,41291024000,0,0,0,2.46
2020,CB2020,081,4,Queens,41291024001,524,209,315,9.31
2020,CB2020,081,4,Queens,41291024002,73,55,18,5.63
2020,CB2020,081,4,Queens,41291024003,53,21,32,3.8
2020,CB2020,081,4,Queens,41291024004,79,42,37,7.05
2020,CB2020,081,4,Queens,41291024005,46,38,8,3.83
2020,CB2020,081,4,Queens,41291024006,124,77,47,7.72
2020,CB2020,081,4,Queens,41291024007,0,0,0,1.83
2020,CB2020,081,4,Queens,41291024008,0,0,0,5.15
2020,CB2020,081,4,Queens,41291031000,274,121,153,5.26
2020,CB2020,081,4,Queens,41291031001,0,0,0,4.42
2020,CB2020,081,4,Queens,41291031002,142,61,81,4.41
2020,CB2020,081,4,Queens,41291031003,1130,532,598,19.4
2020,CB2020,081,4,Queens,41291032000,0,0,0,4.17
2020,CB2020,081,4,Queens,41291032001,1448,652,796,29.91
2020,CB2020,081,4,Queens,41291033000,159,69,90,11.14
2020,CB2020,081,4,Queens,41291033001,35,18,17,3.37
2020,CB2020,081,4,Queens,41291033002,67,35,32,3.97
2020,CB2020,081,4,Queens,41291033003,68,29,39,3.97
2020,CB2020,081,4,Queens,41291033004,72,48,24,3.99
2020,CB2020,081,4,Queens,41291033005,86,43,43,3.94
2020,CB2020,081,4,Queens,41291033006,91,55,36,3.9
2020,CB2020,081,4,Queens,41291033007,70,28,42,3.83
2020,CB2020,081,4,Queens,41291033008,83,40,43,3.58
2020,CB2020,081,4,Queens,41291033009,86,42,44,4.05
2020,CB2020,081,4,Queens,41291041000,91,40,51,4.3
2020,CB2020,081,4,Queens,41291041001,80,36,44,5.46
2020,CB2020,081,4,Queens,41291041002,113,58,55,4.88
2020,CB2020,081,4,Queens,41291041003,91,46,45,4.21
2020,CB2020,081,4,Queens,41291041004,108,63,45,6.64
2020,CB2020,081,4,Queens,41291042000,0,0,0,2.69
2020,CB2020,081,4,Queens,41291042001,0,0,0,0.97
2020,CB2020,081,4,Queens,41291042002,112,56,56,2.25
2020,CB2020,081,4,Queens,41291042003,33,10,23,1.15
2020,CB2020,081,4,Queens,41291042004,91,42,49,1.7
2020,CB2020,081,4,Queens,41291042005,320,138,182,10.4
2020,CB2020,081,4,Queens,41291042006,212,83,129,8.74
2020,CB2020,081,4,Queens,41291042007,184,67,117,7.3
2020,CB2020,081,4,Queens,41291043000,724,341,383,25.96
2020,CB2020,081,4,Queens,41291043001,148,70,78,4.94
2020,CB2020,081,4,Queens,41291043002,55,27,28,5.09
2020,CB2020,081,4,Queens,41291044000,72,48,24,5.15
2020,CB2020,081,4,Queens,41291044001,90,61,29,4.23
2020,CB2020,081,4,Queens,41291044002,100,48,52,4.27
2020,CB2020,081,4,Queens,41291044003,80,40,40,4.47
2020,CB2020,081,4,Queens,41291044004,45,8,37,4.32
2020,CB2020,081,4,Queens,41291044005,89,42,47,4.22
2020,CB2020,081,4,Queens,41291044006,85,26,59,4.29
2020,CB2020,081,4,Queens,41291044007,36,31,5,6.53
2020,CB2020,081,4,Queens,41291044008,72,24,48,3.75
2020,CB2020,081,4,Queens,41291044009,37,18,19,6.6
2020,CB2020,081,4,Queens,41291045000,593,255,338,13.98
2020,CB2020,081,4,Queens,41291045001,399,178,221,9.74
2020,CB2020,081,4,Queens,41291045002,258,134,124,6.78
2020,CB2020,081,4,Queens,41301001000,89,55,34,3.22
2020,CB2020,081,4,Queens,41301001001,136,67,69,4.64
2020,CB2020,081,4,Queens,41301001002,108,67,41,4.66
2020,CB2020,081,4,Queens,41301001003,123,61,62,4.69
2020,CB2020,081,4,Queens,41301001004,89,39,50,4.65
2020,CB2020,081,4,Queens,41301001005,71,27,44,4.65
2020,CB2020,081,4,Queens,41301001006,108,33,75,4.65
2020,CB2020,081,4,Queens,41301001007,102,59,43,3.61
2020,CB2020,081,4,Queens,41301001008,0,0,0,12.06
2020,CB2020,081,4,Queens,41301001009,65,44,21,2.33
2020,CB2020,081,4,Queens,41301001010,0,0,0,2.88
2020,CB2020,081,4,Queens,41301001011,0,0,0,1.26
2020,CB2020,081,4,Queens,41301002000,680,281,399,23.37
2020,CB2020,081,4,Queens,41301002001,0,0,0,0.5
2020,CB2020,081,4,Queens,41301002002,409,176,233,10.77
2020,CB2020,081,4,Queens,41301002003,0,0,0,1.93
2020,CB2020,081,4,Queens,41301003000,0,0,0,1.01
2020,CB2020,081,4,Queens,41301003001,64,23,41,4.16
2020,CB2020,081,4,Queens,41301003002,125,58,67,4.82
2020,CB2020,081,4,Queens,41301003003,89,42,47,4.72
2020,CB2020,081,4,Queens,41301003004,169,100,69,4.52
2020,CB2020,081,4,Queens,41301003005,0,0,0,13.9
2020,CB2020,081,4,Queens,41301003006,0,0,0,0.94
2020,CB2020,081,4,Queens,41301003007,102,40,62,3.63
2020,CB2020,081,4,Queens,41301003008,225,113,112,4.46
2020,CB2020,081,4,Queens,41301003009,121,52,69,3.88
2020,CB2020,081,4,Queens,41301003010,0,0,0,0.95
2020,CB2020,081,4,Queens,41301004000,29,20,9,0.78
2020,CB2020,081,4,Queens,41301004001,688,313,375,15.41
2020,CB2020,081,4,Queens,41301004002,140,71,69,2.98
2020,CB2020,081,4,Queens,41301004003,313,156,157,13.05
2020,CB2020,081,4,Queens,41301004004,43,21,22,0.65
2020,CB2020,081,4,Queens,41301004005,115,34,81,2.93
2020,CB2020,081,4,Queens,41333001000,0,0,0,12.36
2020,CB2020,081,4,Queens,41333001001,211,87,124,4.61
2020,CB2020,081,4,Queens,41333001002,226,109,117,4.37
2020,CB2020,081,4,Queens,41333001003,200,92,108,4.94
2020,CB2020,081,4,Queens,41333001004,108,53,55,4.93
2020,CB2020,081,4,Queens,41333001005,112,53,59,4.86
2020,CB2020,081,4,Queens,41333001006,108,62,46,4.83
2020,CB2020,081,4,Queens,41333001007,105,58,47,4.88
2020,CB2020,081,4,Queens,41333002000,86,49,37,4.77
2020,CB2020,081,4,Queens,41333002001,101,36,65,4.6
2020,CB2020,081,4,Queens,41333002002,108,32,76,4.5
2020,CB2020,081,4,Queens,41333002003,75,43,32,4.56
2020,CB2020,081,4,Queens,41333002004,78,41,37,4.45
2020,CB2020,081,4,Queens,41333002005,94,52,42,4.13
2020,CB2020,081,4,Queens,41333002006,82,45,37,4.19
2020,CB2020,081,4,Queens,41333002007,81,38,43,3.75
2020,CB2020,081,4,Queens,41333003000,88,43,45,4.72
2020,CB2020,081,4,Queens,41333003001,102,27,75,4.88
2020,CB2020,081,4,Queens,41333003002,85,18,67,4.97
2020,CB2020,081,4,Queens,41333003003,89,45,44,4.93
2020,CB2020,081,4,Queens,41333003004,125,75,50,5.9
2020,CB2020,081,4,Queens,41333003005,123,62,61,5.12
2020,CB2020,081,4,Queens,41333003006,120,75,45,5.4
2020,CB2020,081,4,Queens,41333003007,75,41,34,3.61
2020,CB2020,081,4,Queens,41333003008,95,50,45,3.41
2020,CB2020,081,4,Queens,41333003009,134,72,62,5.55
2020,CB2020,081,4,Queens,41333004000,189,64,125,4.56
2020,CB2020,081,4,Queens,41333004001,208,104,104,4.43
2020,CB2020,081,4,Queens,41333004002,173,78,95,5.02
2020,CB2020,081,4,Queens,41333004003,71,48,23,4.82
2020,CB2020,081,4,Queens,41333004004,103,28,75,4.73
2020,CB2020,081,4,Queens,41333004005,106,59,47,4.71
2020,CB2020,081,4,Queens,41333004006,88,53,35,4.79
2020,CB2020,081,4,Queens,41333004007,85,50,35,4.84
2020,CB2020,081,4,Queens,41333004008,81,46,35,4.71
2020,CB2020,081,4,Queens,41339001000,72,44,28,3.25
2020,CB2020,081,4,Queens,41339001001,68,56,12,3.39
2020,CB2020,081,4,Queens,41339001002,78,25,53,3.44
2020,CB2020,081,4,Queens,41339001003,69,28,41,3.52
2020,CB2020,081,4,Queens,41339001004,112,65,47,3.62
2020,CB2020,081,4,Queens,41339001005,148,62,86,3.7
2020,CB2020,081,4,Queens,41339001006,197,83,114,6.05
2020,CB2020,081,4,Queens,41339001007,148,63,85,5.97
2020,CB2020,081,4,Queens,41339001008,128,65,63,5.96
2020,CB2020,081,4,Queens,41339001009,119,60,59,5.78
2020,CB2020,081,4,Queens,41339001010,106,48,58,5.74
2020,CB2020,081,4,Queens,41339001011,115,71,44,5.47
2020,CB2020,081,4,Queens,41341001000,0,0,0,1.5
2020,CB2020,081,4,Queens,41341001001,0,0,0,3.43
2020,CB2020,081,4,Queens,41341001002,191,112,79,3.52
2020,CB2020,081,4,Queens,41341001003,190,101,89,3.51
2020,CB2020,081,4,Queens,41341001004,115,67,48,3.46
2020,CB2020,081,4,Queens,41341001005,140,69,71,3.15
2020,CB2020,081,4,Queens,41341001006,56,16,40,1.93
2020,CB2020,081,4,Queens,41341001007,131,64,67,4.74
2020,CB2020,081,4,Queens,41341001008,123,52,71,4.65
2020,CB2020,081,4,Queens,41341001009,97,22,75,4.18
2020,CB2020,081,4,Queens,41341001010,88,42,46,4.18
2020,CB2020,081,4,Queens,41341001011,78,35,43,3.1
2020,CB2020,081,4,Queens,41341001012,124,51,73,5.58
2020,CB2020,081,4,Queens,41341001013,132,82,50,5.44
2020,CB2020,081,4,Queens,41341002000,99,67,32,4.18
2020,CB2020,081,4,Queens,41341002001,118,53,65,4.2
2020,CB2020,081,4,Queens,41341002002,50,30,20,3
2020,CB2020,081,4,Queens,41341002003,78,32,46,5.14
2020,CB2020,081,4,Queens,41341002004,233,123,110,3.31
2020,CB2020,081,4,Queens,41341002005,143,72,71,2.39
2020,CB2020,081,4,Queens,41341002006,30,13,17,1.03
2020,CB2020,081,4,Queens,41341002007,92,29,63,4.47
2020,CB2020,081,4,Queens,41341002008,119,59,60,4.97
2020,CB2020,081,4,Queens,41341002009,148,84,64,5.54
2020,CB2020,081,4,Queens,41341002010,131,47,84,5.57
2020,CB2020,081,4,Queens,41341002011,149,81,68,5.56
2020,CB2020,081,4,Queens,41341002012,0,0,0,4.23
2020,CB2020,081,4,Queens,41341003000,59,31,28,3.49
2020,CB2020,081,4,Queens,41341003001,0,0,0,3.02
2020,CB2020,081,4,Queens,41341003002,0,0,0,1.8
2020,CB2020,081,4,Queens,41341003003,0,0,0,0.85
2020,CB2020,081,4,Queens,41341003004,42,12,30,2.49
2020,CB2020,081,4,Queens,41341003005,24,7,17,3.47
2020,CB2020,081,4,Queens,41341003006,83,38,45,3.72
2020,CB2020,081,4,Queens,41341003007,0,0,0,3.31
2020,CB2020,081,4,Queens,41341003008,84,51,33,2.62
2020,CB2020,081,4,Queens,41341003009,49,35,14,2.66
2020,CB2020,081,4,Queens,41341003010,274,127,147,3.91
2020,CB2020,081,4,Queens,41341003011,49,8,41,3
2020,CB2020,081,4,Queens,41341003012,67,19,48,3.12
2020,CB2020,081,4,Queens,41341003013,73,47,26,3.1
2020,CB2020,081,4,Queens,41347011000,94,79,15,7.79
2020,CB2020,081,4,Queens,41347011001,889,439,450,23.23
2020,CB2020,081,4,Queens,41347011002,477,201,276,7.85
2020,CB2020,081,4,Queens,41347011003,113,62,51,4.16
2020,CB2020,081,4,Queens,41347011004,496,209,287,7.4
2020,CB2020,081,4,Queens,41347011005,198,87,111,3.15
2020,CB2020,081,4,Queens,41347011006,150,85,65,5.26
2020,CB2020,081,4,Queens,41347011007,0,0,0,0.82
2020,CB2020,081,4,Queens,41347012000,250,103,147,15.98
2020,CB2020,081,4,Queens,41347012001,0,0,0,1.94
2020,CB2020,081,4,Queens,41347012002,0,0,0,0.86
2020,CB2020,081,4,Queens,41347012003,2140,963,1177,17.03
2020,CB2020,081,4,Queens,41347013000,572,269,303,16.26
2020,CB2020,081,4,Queens,41347013001,182,96,86,3.19
2020,CB2020,081,4,Queens,41347021000,159,77,82,3.85
2020,CB2020,081,4,Queens,41347021001,219,104,115,3.81
2020,CB2020,081,4,Queens,41347021002,218,98,120,3.85
2020,CB2020,081,4,Queens,41347021003,179,76,103,3.99
2020,CB2020,081,4,Queens,41347021004,450,217,233,15.43
2020,CB2020,081,4,Queens,41347021005,389,190,199,6.89
2020,CB2020,081,4,Queens,41347021006,575,288,287,10.75
2020,CB2020,081,4,Queens,41347021007,276,128,148,8.3
2020,CB2020,081,4,Queens,41347022000,489,229,260,8.05
2020,CB2020,081,4,Queens,41347022001,368,179,189,7.3
2020,CB2020,081,4,Queens,41347022002,195,100,95,2.58
2020,CB2020,081,4,Queens,41347022003,0,0,0,5.64
2020,CB2020,081,4,Queens,41347022004,435,208,227,9.43
2020,CB2020,081,4,Queens,41347022005,212,115,97,4.53
2020,CB2020,081,4,Queens,41347022006,285,125,160,10.85
2020,CB2020,081,4,Queens,41347022007,456,222,234,8.09
2020,CB2020,081,4,Queens,41347022008,195,84,111,3.15
2020,CB2020,081,4,Queens,41347023000,0,0,0,1.47
2020,CB2020,081,4,Queens,41347023001,0,0,0,4.73
2020,CB2020,081,4,Queens,41347023002,17,10,7,29
2020,CB2020,081,4,Queens,41367001000,117,71,46,4.39
2020,CB2020,081,4,Queens,41367001001,153,84,69,4.06
2020,CB2020,081,4,Queens,41367001002,149,76,73,4.06
2020,CB2020,081,4,Queens,41367001003,118,55,63,4.08
2020,CB2020,081,4,Queens,41367001004,115,52,63,4.05
2020,CB2020,081,4,Queens,41367001005,136,60,76,4.23
2020,CB2020,081,4,Queens,41367002000,76,48,28,3.34
2020,CB2020,081,4,Queens,41367002001,198,76,122,6.48
2020,CB2020,081,4,Queens,41367002002,341,158,183,10.36
2020,CB2020,081,4,Queens,41367003000,0,0,0,1.15
2020,CB2020,081,4,Queens,41367003001,0,0,0,2.74
2020,CB2020,081,4,Queens,41367003002,0,0,0,1.47
2020,CB2020,081,4,Queens,41367003003,0,0,0,0.42
2020,CB2020,081,4,Queens,41367003004,0,0,0,1.12
2020,CB2020,081,4,Queens,41367003005,0,0,0,1.88
2020,CB2020,081,4,Queens,41367003006,121,42,79,3.16
2020,CB2020,081,4,Queens,41367003007,51,42,9,2.93
2020,CB2020,081,4,Queens,41367003008,89,44,45,2.93
2020,CB2020,081,4,Queens,41367003009,48,39,9,2.93
2020,CB2020,081,4,Queens,41367003010,56,29,27,2.94
2020,CB2020,081,4,Queens,41367003011,39,9,30,2.95
2020,CB2020,081,4,Queens,41367003012,0,0,0,4.83
2020,CB2020,081,4,Queens,41367003013,72,36,36,4.94
2020,CB2020,081,4,Queens,41367003014,56,24,32,4.76
2020,CB2020,081,4,Queens,41367003015,80,59,21,4.77
2020,CB2020,081,4,Queens,41367003016,83,42,41,4.78
2020,CB2020,081,4,Queens,41367003017,89,30,59,4.78
2020,CB2020,081,4,Queens,41367003018,86,27,59,5.16
2020,CB2020,081,4,Queens,41367004000,1083,506,577,25.32
2020,CB2020,081,4,Queens,41367004001,289,123,166,7.24
2020,CB2020,081,4,Queens,41367004002,404,181,223,10.7
2020,CB2020,081,4,Queens,41367005000,822,383,439,10.08
2020,CB2020,081,4,Queens,41367005001,17,4,13,3.97
2020,CB2020,081,4,Queens,41367005002,130,74,56,3.96
2020,CB2020,081,4,Queens,41367005003,164,77,87,4.22
2020,CB2020,081,4,Queens,41367006000,30,20,10,5.91
2020,CB2020,081,4,Queens,41367006001,191,91,100,3.86
2020,CB2020,081,4,Queens,41367006002,366,185,181,3.48
2020,CB2020,081,4,Queens,41367006003,256,127,129,3.17
2020,CB2020,081,4,Queens,41367006004,225,99,126,3.23
2020,CB2020,081,4,Queens,41377001000,0,0,0,1.7
2020,CB2020,081,4,Queens,41377001001,23,10,13,3.25
2020,CB2020,081,4,Queens,41377001002,430,187,243,9.9
2020,CB2020,081,4,Queens,41377001003,275,143,132,9.66
2020,CB2020,081,4,Queens,41377001004,568,247,321,9.11
2020,CB2020,081,4,Queens,41377001005,375,187,188,7.14
2020,CB2020,081,4,Queens,41377002000,0,0,0,5.48
2020,CB2020,081,4,Queens,41377002001,444,202,242,12.38
2020,CB2020,081,4,Queens,41377002002,624,301,323,11.09
2020,CB2020,081,4,Queens,41377002003,589,304,285,11.48
2020,CB2020,081,4,Queens,41377002004,416,202,214,9.13
2020,CB2020,081,4,Queens,41377002005,442,201,241,9.47
2020,CB2020,081,4,Queens,41377003000,0,0,0,3.56
2020,CB2020,081,4,Queens,41377003001,114,65,49,3.11
2020,CB2020,081,4,Queens,41377003002,272,133,139,6.27
2020,CB2020,081,4,Queens,41377003003,151,99,52,3.19
2020,CB2020,081,4,Queens,41377003004,106,38,68,3.21
2020,CB2020,081,4,Queens,41377003005,164,79,85,3.51
2020,CB2020,081,4,Queens,41377003006,151,78,73,4.97
2020,CB2020,081,4,Queens,41377003007,204,102,102,4.76
2020,CB2020,081,4,Queens,41377003008,199,91,108,4.78
2020,CB2020,081,4,Queens,41377003009,229,137,92,4.78
2020,CB2020,081,4,Queens,41377003010,180,65,115,4.75
2020,CB2020,081,4,Queens,41377003011,168,88,80,4.82
2020,CB2020,081,4,Queens,41377004000,176,86,90,5.79
2020,CB2020,081,4,Queens,41377004001,168,72,96,5.21
2020,CB2020,081,4,Queens,41377004002,168,100,68,4.58
2020,CB2020,081,4,Queens,41377004003,112,60,52,3.73
2020,CB2020,081,4,Queens,41377004004,134,57,77,3.22
2020,CB2020,081,4,Queens,41377004005,122,42,80,2.99
2020,CB2020,081,4,Queens,41377004006,85,41,44,2.81
2020,CB2020,081,4,Queens,41377004007,78,49,29,2.71
2020,CB2020,081,4,Queens,41377004008,142,64,78,2.69
2020,CB2020,081,4,Queens,41385011000,58,32,26,3.08
2020,CB2020,081,4,Queens,41385011001,72,26,46,4.96
2020,CB2020,081,4,Queens,41385011002,55,29,26,4.76
2020,CB2020,081,4,Queens,41385011003,70,43,27,4.98
2020,CB2020,081,4,Queens,41385011004,72,51,21,5.35
2020,CB2020,081,4,Queens,41385011005,131,63,68,10.3
2020,CB2020,081,4,Queens,41385011006,46,20,26,3.54
2020,CB2020,081,4,Queens,41385011007,57,28,29,18.52
2020,CB2020,081,4,Queens,41385011008,57,24,33,56.69
2020,CB2020,081,4,Queens,41385011009,42,24,18,3.41
2020,CB2020,081,4,Queens,41385011010,40,19,21,3.17
2020,CB2020,081,4,Queens,41385011011,57,11,46,2.74
2020,CB2020,081,4,Queens,41385011012,59,43,16,3.33
2020,CB2020,081,4,Queens,41385011013,47,20,27,2.76
2020,CB2020,081,4,Queens,41385011014,65,39,26,3.84
2020,CB2020,081,4,Queens,41385012000,397,180,217,5.16
2020,CB2020,081,4,Queens,41385012001,247,136,111,4.11
2020,CB2020,081,4,Queens,41385012002,227,109,118,4.45
2020,CB2020,081,4,Queens,41385012003,163,70,93,2.95
2020,CB2020,081,4,Queens,41385012004,240,129,111,4.33
2020,CB2020,081,4,Queens,41385012005,228,95,133,4.15
2020,CB2020,081,4,Queens,41385013000,332,128,204,5.55
2020,CB2020,081,4,Queens,41385013001,210,103,107,4.11
2020,CB2020,081,4,Queens,41385013002,12,9,3,16.04
2020,CB2020,081,4,Queens,41385013003,245,123,122,4.35
2020,CB2020,081,4,Queens,41385013004,293,157,136,4.83
2020,CB2020,081,4,Queens,41385013005,0,0,0,3.36
2020,CB2020,081,4,Queens,41385014000,80,37,43,4.4
2020,CB2020,081,4,Queens,41385014001,61,45,16,3.13
2020,CB2020,081,4,Queens,41385014002,50,30,20,2.43
2020,CB2020,081,4,Queens,41385014003,32,18,14,2.35
2020,CB2020,081,4,Queens,41385014004,63,5,58,3.14
2020,CB2020,081,4,Queens,41385014005,74,36,38,4.43
2020,CB2020,081,4,Queens,41385014006,112,88,24,3.14
2020,CB2020,081,4,Queens,41385014007,133,54,79,4.11
2020,CB2020,081,4,Queens,41385014008,299,139,160,5.03
2020,CB2020,081,4,Queens,41385014009,242,125,117,5.22
2020,CB2020,081,4,Queens,41385014010,159,83,76,3.66
2020,CB2020,081,4,Queens,41385014011,72,29,43,2.32
2020,CB2020,081,4,Queens,41385014012,95,38,57,2.81
2020,CB2020,081,4,Queens,41385014013,0,0,0,2.69
2020,CB2020,081,4,Queens,41385014014,0,0,0,0.85
2020,CB2020,081,4,Queens,41385021000,0,0,0,17.71
2020,CB2020,081,4,Queens,41385021001,0,0,0,0
2020,CB2020,081,4,Queens,41385021002,0,0,0,23.94
2020,CB2020,081,4,Queens,41385021003,0,0,0,0.69
2020,CB2020,081,4,Queens,41385021004,0,0,0,1.31
2020,CB2020,081,4,Queens,41385021005,0,0,0,1.27
2020,CB2020,081,4,Queens,41385021006,0,0,0,0.17
2020,CB2020,081,4,Queens,41385021007,0,0,0,0
2020,CB2020,081,4,Queens,41385021008,0,0,0,77.91
2020,CB2020,081,4,Queens,41385021009,0,0,0,65.71
2020,CB2020,081,4,Queens,41385021010,0,0,0,1.71
2020,CB2020,081,4,Queens,41385021011,0,0,0,1.69
2020,CB2020,081,4,Queens,41385021012,0,0,0,18.6
2020,CB2020,081,4,Queens,41385021013,0,0,0,2.18
2020,CB2020,081,4,Queens,41385021014,0,0,0,2.96
2020,CB2020,081,4,Queens,41385021015,0,0,0,4.18
2020,CB2020,081,4,Queens,41385021016,3,2,1,56.07
2020,CB2020,081,4,Queens,41385021017,0,0,0,0.84
2020,CB2020,081,4,Queens,41385021018,0,0,0,10.06
2020,CB2020,081,4,Queens,41385021019,0,0,0,0.86
2020,CB2020,081,4,Queens,41385021020,0,0,0,3.51
2020,CB2020,081,4,Queens,41385021021,82,77,5,18.52
2020,CB2020,081,4,Queens,41385021022,0,0,0,212.56
2020,CB2020,081,4,Queens,41385021023,0,0,0,0.57
2020,CB2020,081,4,Queens,41385021024,0,0,0,3.96
2020,CB2020,081,4,Queens,41385021025,0,0,0,7.51
2020,CB2020,081,4,Queens,41385021026,0,0,0,0.84
2020,CB2020,081,4,Queens,41385021027,0,0,0,46.56
2020,CB2020,081,4,Queens,41399001000,36,30,6,3.77
2020,CB2020,081,4,Queens,41399001001,74,40,34,3.11
2020,CB2020,081,4,Queens,41399001002,88,42,46,3.42
2020,CB2020,081,4,Queens,41399001003,75,32,43,3.77
2020,CB2020,081,4,Queens,41399001004,86,38,48,4.13
2020,CB2020,081,4,Queens,41399001005,75,36,39,4.31
2020,CB2020,081,4,Queens,41399001006,94,56,38,4.01
2020,CB2020,081,4,Queens,41399001007,74,35,39,3.94
2020,CB2020,081,4,Queens,41399001008,93,30,63,3.95
2020,CB2020,081,4,Queens,41399001009,0,0,0,2.02
2020,CB2020,081,4,Queens,41399001010,0,0,0,2.65
2020,CB2020,081,4,Queens,41399002000,65,32,33,3.28
2020,CB2020,081,4,Queens,41399002001,93,30,63,4.14
2020,CB2020,081,4,Queens,41399002002,92,59,33,4.35
2020,CB2020,081,4,Queens,41399002003,145,71,74,3.85
2020,CB2020,081,4,Queens,41399002004,35,15,20,2.35
2020,CB2020,081,4,Queens,41399002005,48,18,30,3
2020,CB2020,081,4,Queens,41399002006,68,19,49,3.68
2020,CB2020,081,4,Queens,41399002007,76,39,37,3.69
2020,CB2020,081,4,Queens,41399002008,80,41,39,3.69
2020,CB2020,081,4,Queens,41399002009,84,38,46,3.66
2020,CB2020,081,4,Queens,41399002010,11,6,5,3.67
2020,CB2020,081,4,Queens,41399002011,87,45,42,3.69
2020,CB2020,081,4,Queens,41399002012,75,37,38,3.99
2020,CB2020,081,4,Queens,41399002013,115,53,62,3.88
2020,CB2020,081,4,Queens,41403001000,55,28,27,3.69
2020,CB2020,081,4,Queens,41403001001,96,40,56,4.23
2020,CB2020,081,4,Queens,41403001002,86,49,37,3.84
2020,CB2020,081,4,Queens,41403001003,97,38,59,3.84
2020,CB2020,081,4,Queens,41403001004,113,44,69,3.84
2020,CB2020,081,4,Queens,41403001005,115,60,55,3.83
2020,CB2020,081,4,Queens,41403001006,83,41,42,4.1
2020,CB2020,081,4,Queens,41403001007,72,42,30,3.65
2020,CB2020,081,4,Queens,41403001008,100,56,44,3.93
2020,CB2020,081,4,Queens,41403001009,68,31,37,4.32
2020,CB2020,081,4,Queens,41403001010,91,52,39,4.17
2020,CB2020,081,4,Queens,41403001011,103,50,53,4.16
2020,CB2020,081,4,Queens,41403002000,94,49,45,3.7
2020,CB2020,081,4,Queens,41403002001,137,65,72,3.7
2020,CB2020,081,4,Queens,41403002002,118,49,69,3.7
2020,CB2020,081,4,Queens,41403002003,0,0,0,4.52
2020,CB2020,081,4,Queens,41403002004,203,103,100,3.72
2020,CB2020,081,4,Queens,41403002005,149,91,58,3.71
2020,CB2020,081,4,Queens,41403002006,150,92,58,3.7
2020,CB2020,081,4,Queens,41403002007,128,45,83,3.99
2020,CB2020,081,4,Queens,41403002008,173,76,97,3.99
2020,CB2020,081,4,Queens,41403002009,175,104,71,3.51
2020,CB2020,081,4,Queens,41403002010,0,0,0,4.9
2020,CB2020,081,4,Queens,41403002011,0,0,0,1.47
2020,CB2020,081,4,Queens,41403002012,0,0,0,0.28
2020,CB2020,081,4,Queens,41409011000,0,0,0,1.98
2020,CB2020,081,4,Queens,41409011001,0,0,0,4.55
2020,CB2020,081,4,Queens,41409011002,72,42,30,3.73
2020,CB2020,081,4,Queens,41409011003,74,28,46,3.69
2020,CB2020,081,4,Queens,41409011004,0,0,0,3.7
2020,CB2020,081,4,Queens,41409011005,100,42,58,3.99
2020,CB2020,081,4,Queens,41409011006,104,52,52,3.98
2020,CB2020,081,4,Queens,41409011007,102,53,49,3.7
2020,CB2020,081,4,Queens,41409011008,92,64,28,3.7
2020,CB2020,081,4,Queens,41409011009,101,47,54,3.72
2020,CB2020,081,4,Queens,41409011010,79,55,24,3.34
2020,CB2020,081,4,Queens,41409011011,109,61,48,4
2020,CB2020,081,4,Queens,41409011012,111,55,56,4.02
2020,CB2020,081,4,Queens,41409011013,76,17,59,4.28
2020,CB2020,081,4,Queens,41409011014,0,0,0,7.73
2020,CB2020,081,4,Queens,41409011015,0,0,0,0.32
2020,CB2020,081,4,Queens,41409021000,150,52,98,3.67
2020,CB2020,081,4,Queens,41409021001,170,83,87,3.7
2020,CB2020,081,4,Queens,41409021002,131,62,69,3.77
2020,CB2020,081,4,Queens,41409021003,89,35,54,3.77
2020,CB2020,081,4,Queens,41409021004,112,65,47,3.51
2020,CB2020,081,4,Queens,41409021005,62,28,34,2.22
2020,CB2020,081,4,Queens,41409021006,22,18,4,0.79
2020,CB2020,081,4,Queens,41409021007,4,1,3,12.8
2020,CB2020,081,4,Queens,41409021008,110,63,47,3.87
2020,CB2020,081,4,Queens,41409021009,39,33,6,2.14
2020,CB2020,081,4,Queens,41409021010,8,4,4,0.75
2020,CB2020,081,4,Queens,41409021011,103,56,47,3.4
2020,CB2020,081,4,Queens,41409021012,0,0,0,6.92
2020,CB2020,081,4,Queens,41409021013,0,0,0,1.5
2020,CB2020,081,4,Queens,41409021014,121,64,57,2.82
2020,CB2020,081,4,Queens,41409021015,51,27,24,3.38
2020,CB2020,081,4,Queens,41409021016,12,8,4,7.48
2020,CB2020,081,4,Queens,41409021017,93,43,50,3.7
2020,CB2020,081,4,Queens,41409021018,89,46,43,3.94
2020,CB2020,081,4,Queens,41409022000,48,7,41,2.25
2020,CB2020,081,4,Queens,41409022001,50,23,27,1.73
2020,CB2020,081,4,Queens,41409022002,131,63,68,3.74
2020,CB2020,081,4,Queens,41409022003,94,21,73,3.98
2020,CB2020,081,4,Queens,41409022004,69,37,32,2.45
2020,CB2020,081,4,Queens,41409022005,220,114,106,4.66
2020,CB2020,081,4,Queens,41409022006,106,40,66,3.69
2020,CB2020,081,4,Queens,41409022007,114,66,48,4.26
2020,CB2020,081,4,Queens,41409022008,86,45,41,3.46
2020,CB2020,081,4,Queens,41409022009,58,20,38,2.98
2020,CB2020,081,4,Queens,41409022010,38,23,15,1.73
2020,CB2020,081,4,Queens,41409022011,29,0,29,2.12
2020,CB2020,081,4,Queens,41409022012,57,37,20,6.2
2020,CB2020,081,4,Queens,41409022013,73,38,35,2.66
2020,CB2020,081,4,Queens,41409022014,116,64,52,3.85
2020,CB2020,081,4,Queens,41409022015,98,36,62,4.09
2020,CB2020,081,4,Queens,41409022016,107,49,58,2.75
2020,CB2020,081,4,Queens,41409022017,46,39,7,2.12
2020,CB2020,081,4,Queens,41417001000,109,59,50,4.24
2020,CB2020,081,4,Queens,41417001001,27,22,5,1.14
2020,CB2020,081,4,Queens,41417001002,23,6,17,1.2
2020,CB2020,081,4,Queens,41417001003,64,34,30,1.61
2020,CB2020,081,4,Queens,41417001004,101,35,66,4.75
2020,CB2020,081,4,Queens,41417001005,51,10,41,2.52
2020,CB2020,081,4,Queens,41417001006,116,54,62,4.21
2020,CB2020,081,4,Queens,41417001007,99,57,42,4.16
2020,CB2020,081,4,Queens,41417001008,59,31,28,1.54
2020,CB2020,081,4,Queens,41417001009,92,47,45,3.57
2020,CB2020,081,4,Queens,41417002000,129,53,76,3.92
2020,CB2020,081,4,Queens,41417002001,166,77,89,3.93
2020,CB2020,081,4,Queens,41417002002,149,69,80,4.11
2020,CB2020,081,4,Queens,41417002003,120,49,71,4.13
2020,CB2020,081,4,Queens,41417002004,36,10,26,1.82
2020,CB2020,081,4,Queens,41417002005,141,73,68,5.19
2020,CB2020,081,4,Queens,41417002006,136,78,58,6.38
2020,CB2020,081,4,Queens,41417002007,126,61,65,5.81
2020,CB2020,081,4,Queens,41417002008,137,60,77,4.93
2020,CB2020,081,4,Queens,41417002009,99,49,50,4.38
2020,CB2020,081,4,Queens,41417002010,122,58,64,2.92
2020,CB2020,081,4,Queens,41417002011,81,45,36,2.35
2020,CB2020,081,4,Queens,41417002012,34,23,11,1.83
2020,CB2020,081,4,Queens,41417002013,0,0,0,0.55
2020,CB2020,081,4,Queens,41417002014,35,4,31,1.91
2020,CB2020,081,4,Queens,41417003000,127,60,67,5.99
2020,CB2020,081,4,Queens,41417003001,75,34,41,2.88
2020,CB2020,081,4,Queens,41417003002,66,42,24,2.93
2020,CB2020,081,4,Queens,41417003003,87,38,49,3.57
2020,CB2020,081,4,Queens,41417003004,44,9,35,1.74
2020,CB2020,081,4,Queens,41417003005,72,35,37,2.89
2020,CB2020,081,4,Queens,41417003006,82,56,26,2.06
2020,CB2020,081,4,Queens,41417003007,88,55,33,4
2020,CB2020,081,4,Queens,41417003008,145,44,101,3.58
2020,CB2020,081,4,Queens,41417003009,115,65,50,3.1
2020,CB2020,081,4,Queens,41417004000,0,0,0,9.74
2020,CB2020,081,4,Queens,41417004001,41,18,23,1.79
2020,CB2020,081,4,Queens,41417004002,107,39,68,3.4
2020,CB2020,081,4,Queens,41417004003,112,50,62,3.67
2020,CB2020,081,4,Queens,41417004004,58,27,31,2.73
2020,CB2020,081,4,Queens,41417004005,19,0,19,1.36
2020,CB2020,081,4,Queens,41417004006,83,40,43,3.79
2020,CB2020,081,4,Queens,41417004007,0,0,0,3.71
2020,CB2020,081,4,Queens,41417004008,65,28,37,3.54
2020,CB2020,081,4,Queens,41417004009,71,39,32,3.54
2020,CB2020,081,4,Queens,41417004010,68,40,28,3.41
2020,CB2020,081,4,Queens,41417004011,109,58,51,3.68
2020,CB2020,081,4,Queens,41417004012,90,31,59,3.67
2020,CB2020,081,4,Queens,41417004013,138,79,59,3.67
2020,CB2020,081,4,Queens,41417004014,144,74,70,5.25
2020,CB2020,081,4,Queens,41417004015,37,30,7,1.61
2020,CB2020,081,4,Queens,41417004016,0,0,0,0.38
2020,CB2020,081,4,Queens,41417004017,41,30,11,1.33
2020,CB2020,081,4,Queens,41417004018,67,36,31,2.32
2020,CB2020,081,4,Queens,41417004019,85,45,40,3.21
2020,CB2020,081,4,Queens,41417005000,0,0,0,3.44
2020,CB2020,081,4,Queens,41417005001,21,17,4,1.35
2020,CB2020,081,4,Queens,41417005002,120,61,59,3.35
2020,CB2020,081,4,Queens,41417005003,120,67,53,3.06
2020,CB2020,081,4,Queens,41417005004,5,2,3,14.44
2020,CB2020,081,4,Queens,41417005005,0,0,0,1.31
2020,CB2020,081,4,Queens,41417005006,0,0,0,2.5
2020,CB2020,081,4,Queens,41417005007,157,70,87,3.35
2020,CB2020,081,4,Queens,41417005008,64,17,47,4.08
2020,CB2020,081,4,Queens,41417005009,0,0,0,1.95
2020,CB2020,081,4,Queens,41429001000,133,66,67,4.51
2020,CB2020,081,4,Queens,41429001001,111,53,58,4.67
2020,CB2020,081,4,Queens,41429001002,154,77,77,4.69
2020,CB2020,081,4,Queens,41429001003,158,78,80,4.6
2020,CB2020,081,4,Queens,41429001004,134,64,70,3.52
2020,CB2020,081,4,Queens,41429001005,144,68,76,3.85
2020,CB2020,081,4,Queens,41429002000,363,168,195,9.94
2020,CB2020,081,4,Queens,41429002001,126,67,59,4.09
2020,CB2020,081,4,Queens,41429002002,153,80,73,4.34
2020,CB2020,081,4,Queens,41429002003,151,85,66,4.62
2020,CB2020,081,4,Queens,41429002004,210,106,104,4.83
2020,CB2020,081,4,Queens,41429002005,130,69,61,3.89
2020,CB2020,081,4,Queens,41429002006,13,4,9,1.19
2020,CB2020,081,4,Queens,41429002007,0,0,0,0.33
2020,CB2020,081,4,Queens,41429002008,69,44,25,2.71
2020,CB2020,081,4,Queens,41429002009,16,3,13,0.91
2020,CB2020,081,4,Queens,41429002010,34,29,5,0.8
2020,CB2020,081,4,Queens,41429002011,26,5,21,1.19
2020,CB2020,081,4,Queens,41429003000,127,75,52,3.35
2020,CB2020,081,4,Queens,41429003001,159,70,89,3.93
2020,CB2020,081,4,Queens,41429003002,110,56,54,4.35
2020,CB2020,081,4,Queens,41429003003,54,26,28,2.23
2020,CB2020,081,4,Queens,41429003004,46,26,20,1.72
2020,CB2020,081,4,Queens,41429003005,99,52,47,3.09
2020,CB2020,081,4,Queens,41429003006,89,45,44,3.76
2020,CB2020,081,4,Queens,41429003007,102,63,39,3.61
2020,CB2020,081,4,Queens,41429003008,97,40,57,3.09
2020,CB2020,081,4,Queens,41429003009,108,43,65,5.21
2020,CB2020,081,4,Queens,41429003010,64,35,29,2.3
2020,CB2020,081,4,Queens,41429003011,0,0,0,0.29
2020,CB2020,081,4,Queens,41429004000,89,41,48,3.57
2020,CB2020,081,4,Queens,41429004001,42,33,9,1.93
2020,CB2020,081,4,Queens,41429004002,96,32,64,3.63
2020,CB2020,081,4,Queens,41429004003,8,6,2,1.1
2020,CB2020,081,4,Queens,41429004004,55,41,14,2.58
2020,CB2020,081,4,Queens,41429004005,98,44,54,4.11
2020,CB2020,081,4,Queens,41429004006,25,11,14,1.31
2020,CB2020,081,4,Queens,41429004007,123,53,70,3.8
2020,CB2020,081,4,Queens,41429004008,94,44,50,3.42
2020,CB2020,081,4,Queens,41429004009,87,44,43,3.99
2020,CB2020,081,4,Queens,41435001000,128,56,72,6.31
2020,CB2020,081,4,Queens,41435001001,101,41,60,4.59
2020,CB2020,081,4,Queens,41435001002,83,49,34,4.47
2020,CB2020,081,4,Queens,41435001003,67,39,28,4.52
2020,CB2020,081,4,Queens,41435001004,107,71,36,5.23
2020,CB2020,081,4,Queens,41435001005,116,53,63,4.77
2020,CB2020,081,4,Queens,41435001006,148,54,94,4.7
2020,CB2020,081,4,Queens,41435001007,138,67,71,4.44
2020,CB2020,081,4,Queens,41435001008,188,100,88,4.18
2020,CB2020,081,4,Queens,41435001009,199,88,111,4.07
2020,CB2020,081,4,Queens,41435002000,84,53,31,3.78
2020,CB2020,081,4,Queens,41435002001,34,24,10,2.1
2020,CB2020,081,4,Queens,41435002002,87,41,46,3.67
2020,CB2020,081,4,Queens,41435002003,81,36,45,3.67
2020,CB2020,081,4,Queens,41435002004,71,18,53,4.23
2020,CB2020,081,4,Queens,41435002005,97,59,38,3.84
2020,CB2020,081,4,Queens,41435002006,65,35,30,3.79
2020,CB2020,081,4,Queens,41435002007,211,121,90,3.67
2020,CB2020,081,4,Queens,41435002008,194,64,130,3.67
2020,CB2020,081,4,Queens,41435002009,165,72,93,3.67
2020,CB2020,081,4,Queens,41435002010,0,0,0,3.42
2020,CB2020,081,4,Queens,41435002011,0,0,0,1.61
2020,CB2020,081,4,Queens,41441001000,61,40,21,3.23
2020,CB2020,081,4,Queens,41441001001,96,64,32,3.1
2020,CB2020,081,4,Queens,41441001002,99,55,44,3.1
2020,CB2020,081,4,Queens,41441001003,141,60,81,3.1
2020,CB2020,081,4,Queens,41441001004,188,68,120,3.09
2020,CB2020,081,4,Queens,41441001005,104,42,62,2.19
2020,CB2020,081,4,Queens,41441001006,114,58,56,1.94
2020,CB2020,081,4,Queens,41441002000,235,100,135,2.71
2020,CB2020,081,4,Queens,41441002001,206,93,113,2.71
2020,CB2020,081,4,Queens,41441002002,184,92,92,3.42
2020,CB2020,081,4,Queens,41441002003,57,20,37,0.58
2020,CB2020,081,4,Queens,41441002004,71,42,29,0.46
2020,CB2020,081,4,Queens,41441003000,151,76,75,3.72
2020,CB2020,081,4,Queens,41441003001,263,117,146,3.4
2020,CB2020,081,4,Queens,41441003002,29,4,25,0.97
2020,CB2020,081,4,Queens,41441003003,48,18,30,1.94
2020,CB2020,081,4,Queens,41441003004,66,21,45,2.62
2020,CB2020,081,4,Queens,41441003005,64,56,8,2.73
2020,CB2020,081,4,Queens,41441003006,71,34,37,3.67
2020,CB2020,081,4,Queens,41441004000,149,69,80,5.05
2020,CB2020,081,4,Queens,41441004001,60,45,15,2.98
2020,CB2020,081,4,Queens,41441004002,46,11,35,2.46
2020,CB2020,081,4,Queens,41441004003,49,23,26,2.16
2020,CB2020,081,4,Queens,41441004004,45,16,29,2.89
2020,CB2020,081,4,Queens,41441004005,46,22,24,3.96
2020,CB2020,081,4,Queens,41441004006,89,44,45,4.34
2020,CB2020,081,4,Queens,41441004007,103,53,50,4.47
2020,CB2020,081,4,Queens,41441004008,122,56,66,6.29
2020,CB2020,081,4,Queens,41447001000,40,31,9,4.68
2020,CB2020,081,4,Queens,41447001001,62,38,24,4.52
2020,CB2020,081,4,Queens,41447001002,187,98,89,4.25
2020,CB2020,081,4,Queens,41447001003,132,64,68,4.32
2020,CB2020,081,4,Queens,41447001004,145,56,89,4.63
2020,CB2020,081,4,Queens,41447001005,145,63,82,4.35
2020,CB2020,081,4,Queens,41447001006,197,82,115,4.93
2020,CB2020,081,4,Queens,41447001007,253,134,119,4.89
2020,CB2020,081,4,Queens,41447001008,0,0,0,5.29
2020,CB2020,081,4,Queens,41447001009,54,21,33,4.14
2020,CB2020,081,4,Queens,41447001010,0,0,0,1.5
2020,CB2020,081,4,Queens,41447002000,91,42,49,4.44
2020,CB2020,081,4,Queens,41447002001,175,74,101,4.4
2020,CB2020,081,4,Queens,41447002002,101,67,34,1.96
2020,CB2020,081,4,Queens,41447002003,97,44,53,2.08
2020,CB2020,081,4,Queens,41447002004,0,0,0,6.23
2020,CB2020,081,4,Queens,41447002005,223,91,132,4.84
2020,CB2020,081,4,Queens,41447002006,176,80,96,4.83
2020,CB2020,081,4,Queens,41447002007,44,21,23,0.66
2020,CB2020,081,4,Queens,41447002008,30,17,13,0.45
2020,CB2020,081,4,Queens,41447002009,170,80,90,2.63
2020,CB2020,081,4,Queens,41447002010,102,34,68,3.38
2020,CB2020,081,4,Queens,41447002011,82,49,33,2.8
2020,CB2020,081,4,Queens,41447002012,137,45,92,2.43
2020,CB2020,081,4,Queens,41447002013,141,89,52,3.5
2020,CB2020,081,4,Queens,41447002014,86,65,21,2.35
2020,CB2020,081,4,Queens,41447002015,131,62,69,2.96
2020,CB2020,081,4,Queens,41447002016,23,5,18,0.94
2020,CB2020,081,4,Queens,41447002017,60,31,29,2.14
2020,CB2020,081,4,Queens,41447002018,0,0,0,0.58
2020,CB2020,081,4,Queens,41447002019,47,26,21,0.9
2020,CB2020,081,4,Queens,41451011000,32,10,22,4.67
2020,CB2020,081,4,Queens,41451011001,139,58,81,4.59
2020,CB2020,081,4,Queens,41451011002,181,94,87,4.45
2020,CB2020,081,4,Queens,41451011003,59,28,31,4.6
2020,CB2020,081,4,Queens,41451011004,114,43,71,4.61
2020,CB2020,081,4,Queens,41451011005,143,61,82,4.88
2020,CB2020,081,4,Queens,41451011006,167,110,57,4.39
2020,CB2020,081,4,Queens,41451011007,103,43,60,3.72
2020,CB2020,081,4,Queens,41451011008,79,50,29,3.11
2020,CB2020,081,4,Queens,41451011009,66,35,31,2.66
2020,CB2020,081,4,Queens,41451011010,61,43,18,2.69
2020,CB2020,081,4,Queens,41451011011,83,20,63,2.84
2020,CB2020,081,4,Queens,41451011012,201,109,92,12.16
2020,CB2020,081,4,Queens,41451011013,73,29,44,2.89
2020,CB2020,081,4,Queens,41451021000,0,0,0,3.26
2020,CB2020,081,4,Queens,41451021001,21,15,6,1.2
2020,CB2020,081,4,Queens,41451021002,133,60,73,1.96
2020,CB2020,081,4,Queens,41451021003,130,86,44,2.76
2020,CB2020,081,4,Queens,41451021004,0,0,0,1.18
2020,CB2020,081,4,Queens,41451021005,49,23,26,2.29
2020,CB2020,081,4,Queens,41451021006,129,52,77,3.89
2020,CB2020,081,4,Queens,41451021007,103,54,49,3.62
2020,CB2020,081,4,Queens,41451021008,133,68,65,3.62
2020,CB2020,081,4,Queens,41451021009,79,31,48,3.7
2020,CB2020,081,4,Queens,41451021010,126,54,72,3.74
2020,CB2020,081,4,Queens,41451021011,126,68,58,3.69
2020,CB2020,081,4,Queens,41451021012,139,63,76,3.69
2020,CB2020,081,4,Queens,41451021013,117,56,61,3.95
2020,CB2020,081,4,Queens,41451022000,0,0,0,3.9
2020,CB2020,081,4,Queens,41451022001,25,10,15,0.63
2020,CB2020,081,4,Queens,41451022002,61,34,27,2.66
2020,CB2020,081,4,Queens,41451022003,125,64,61,2.76
2020,CB2020,081,4,Queens,41451022004,92,63,29,3.31
2020,CB2020,081,4,Queens,41451022005,78,26,52,3.15
2020,CB2020,081,4,Queens,41451022006,99,50,49,2.87
2020,CB2020,081,4,Queens,41451022007,77,40,37,2.29
2020,CB2020,081,4,Queens,41451022008,56,28,28,1.87
2020,CB2020,081,4,Queens,41451022009,134,61,73,3.12
2020,CB2020,081,4,Queens,41451022010,101,50,51,2.84
2020,CB2020,081,4,Queens,41451022011,68,17,51,2.76
2020,CB2020,081,4,Queens,41451022012,140,82,58,3.51
2020,CB2020,081,4,Queens,41451022013,48,24,24,1.28
2020,CB2020,081,4,Queens,41451022014,208,105,103,4.71
2020,CB2020,081,4,Queens,41451022015,0,0,0,0.25
2020,CB2020,081,4,Queens,41451022016,0,0,0,0.48
2020,CB2020,081,4,Queens,41459001000,116,62,54,4.76
2020,CB2020,081,4,Queens,41459001001,126,53,73,5.2
2020,CB2020,081,4,Queens,41459001002,109,46,63,5.17
2020,CB2020,081,4,Queens,41459001003,125,60,65,4.8
2020,CB2020,081,4,Queens,41459001004,111,66,45,4.05
2020,CB2020,081,4,Queens,41459001005,173,84,89,4.05
2020,CB2020,081,4,Queens,41459002000,144,72,72,4.04
2020,CB2020,081,4,Queens,41459002001,143,68,75,4.94
2020,CB2020,081,4,Queens,41459002002,157,77,80,5.47
2020,CB2020,081,4,Queens,41459002003,180,109,71,5.25
2020,CB2020,081,4,Queens,41459002004,120,61,59,4.11
2020,CB2020,081,4,Queens,41459002005,111,43,68,3.89
2020,CB2020,081,4,Queens,41459002006,132,61,71,3.97
2020,CB2020,081,4,Queens,41459002007,21,8,13,1.22
2020,CB2020,081,4,Queens,41459002008,67,20,47,2.42
2020,CB2020,081,4,Queens,41459003000,97,32,65,2.17
2020,CB2020,081,4,Queens,41459003001,137,70,67,3.61
2020,CB2020,081,4,Queens,41459003002,208,94,114,5.13
2020,CB2020,081,4,Queens,41459003003,132,81,51,3.55
2020,CB2020,081,4,Queens,41459003004,141,82,59,3.99
2020,CB2020,081,4,Queens,41459003005,138,68,70,4.17
2020,CB2020,081,4,Queens,41459003006,39,19,20,1.85
2020,CB2020,081,4,Queens,41459003007,143,63,80,4.19
2020,CB2020,081,4,Queens,41463001000,0,0,0,3.22
2020,CB2020,081,4,Queens,41463001001,154,70,84,3.53
2020,CB2020,081,4,Queens,41463001002,140,59,81,4.01
2020,CB2020,081,4,Queens,41463001003,195,93,102,4.07
2020,CB2020,081,4,Queens,41463001004,217,129,88,4.29
2020,CB2020,081,4,Queens,41463001005,217,75,142,3.7
2020,CB2020,081,4,Queens,41463001006,120,59,61,3.7
2020,CB2020,081,4,Queens,41463001007,126,64,62,3.69
2020,CB2020,081,4,Queens,41463001008,132,56,76,3.56
2020,CB2020,081,4,Queens,41463001009,51,40,11,2.06
2020,CB2020,081,4,Queens,41463001010,93,35,58,2.58
2020,CB2020,081,4,Queens,41463001011,123,69,54,2.47
2020,CB2020,081,4,Queens,41463001012,113,70,43,2.07
2020,CB2020,081,4,Queens,41463002000,283,136,147,5.75
2020,CB2020,081,4,Queens,41463002001,149,57,92,6.24
2020,CB2020,081,4,Queens,41463002002,167,67,100,4.32
2020,CB2020,081,4,Queens,41463002003,244,31,213,4.27
2020,CB2020,081,4,Queens,41463002004,70,37,33,1.64
2020,CB2020,081,4,Queens,41463002005,0,0,0,0.79
2020,CB2020,081,4,Queens,41463002006,0,0,0,0.59
2020,CB2020,081,4,Queens,41463002007,51,21,30,3.19
2020,CB2020,081,4,Queens,41463002008,20,3,17,0.69
2020,CB2020,081,4,Queens,41463002009,0,0,0,0.26
2020,CB2020,081,4,Queens,41463002010,56,43,13,3.31
2020,CB2020,081,4,Queens,41463002011,86,46,40,2.67
2020,CB2020,081,4,Queens,41463002012,122,67,55,3.38
2020,CB2020,081,4,Queens,41467001000,14,3,11,4.91
2020,CB2020,081,4,Queens,41467001001,295,127,168,6.34
2020,CB2020,081,4,Queens,41467001002,0,0,0,0.67
2020,CB2020,081,4,Queens,41467001003,168,80,88,2.91
2020,CB2020,081,4,Queens,41467001004,88,37,51,3.81
2020,CB2020,081,4,Queens,41467001005,108,51,57,2.8
2020,CB2020,081,4,Queens,41467001006,132,76,56,2.88
2020,CB2020,081,4,Queens,41467001007,63,34,29,3.03
2020,CB2020,081,4,Queens,41467001008,0,0,0,2.65
2020,CB2020,081,4,Queens,41467001009,163,110,53,2.56
2020,CB2020,081,4,Queens,41467001010,206,77,129,3.31
2020,CB2020,081,4,Queens,41467001011,88,37,51,2.61
2020,CB2020,081,4,Queens,41467002000,450,213,237,10.47
2020,CB2020,081,4,Queens,41467002001,102,52,50,2.6
2020,CB2020,081,4,Queens,41467002002,57,21,36,2.57
2020,CB2020,081,4,Queens,41467003000,233,111,122,7.23
2020,CB2020,081,4,Queens,41467003001,98,53,45,3.7
2020,CB2020,081,4,Queens,41467003002,170,87,83,3.8
2020,CB2020,081,4,Queens,41467003003,72,27,45,2.72
2020,CB2020,081,4,Queens,41467003004,88,27,61,2.63
2020,CB2020,081,4,Queens,41467003005,56,26,30,2.73
2020,CB2020,081,4,Queens,41467003006,156,95,61,3.83
2020,CB2020,081,4,Queens,41467003007,0,0,0,4.05
2020,CB2020,081,4,Queens,41467003008,0,0,0,2.05
2020,CB2020,081,4,Queens,41467003009,0,0,0,0.78
2020,CB2020,081,4,Queens,41471001000,0,0,0,0.39
2020,CB2020,081,4,Queens,41471001001,71,29,42,2.98
2020,CB2020,081,4,Queens,41471001002,354,172,182,13.79
2020,CB2020,081,4,Queens,41471001003,73,34,39,3.23
2020,CB2020,081,4,Queens,41471001004,97,58,39,2.31
2020,CB2020,081,4,Queens,41471001005,72,16,56,2.32
2020,CB2020,081,4,Queens,41471001006,126,67,59,2.89
2020,CB2020,081,4,Queens,41471001007,146,58,88,2.88
2020,CB2020,081,4,Queens,41471001008,133,49,84,2.89
2020,CB2020,081,4,Queens,41471001009,43,25,18,2.89
2020,CB2020,081,4,Queens,41471001010,82,27,55,2.91
2020,CB2020,081,4,Queens,41471001011,77,65,12,2.9
2020,CB2020,081,4,Queens,41471001012,54,36,18,2.94
2020,CB2020,081,4,Queens,41471001013,61,26,35,2.37
2020,CB2020,081,4,Queens,41471001014,107,63,44,3.02
2020,CB2020,081,4,Queens,41471001015,105,46,59,2.87
2020,CB2020,081,4,Queens,41471001016,83,27,56,1.91
2020,CB2020,081,4,Queens,41471001017,119,85,34,2.13
2020,CB2020,081,4,Queens,41471002000,452,184,268,9.49
2020,CB2020,081,4,Queens,41471002001,109,58,51,3.82
2020,CB2020,081,4,Queens,41471002002,119,70,49,4.91
2020,CB2020,081,4,Queens,41471002003,78,46,32,4.06
2020,CB2020,081,4,Queens,41471002004,120,37,83,4.05
2020,CB2020,081,4,Queens,41471002005,102,63,39,4.15
2020,CB2020,081,4,Queens,41471002006,109,57,52,4.23
2020,CB2020,081,4,Queens,41471002007,166,65,101,4.32
2020,CB2020,081,4,Queens,41471002008,44,16,28,2.9
2020,CB2020,081,4,Queens,41471002009,60,23,37,2.35
2020,CB2020,081,4,Queens,41471002010,77,27,50,2.32
2020,CB2020,081,4,Queens,41479001000,0,0,0,2.12
2020,CB2020,081,4,Queens,41479001001,0,0,0,0.39
2020,CB2020,081,4,Queens,41479001002,64,38,26,2.66
2020,CB2020,081,4,Queens,41479001003,17,1,16,1.04
2020,CB2020,081,4,Queens,41479001004,54,22,32,1.01
2020,CB2020,081,4,Queens,41479001005,109,68,41,5.94
2020,CB2020,081,4,Queens,41479001006,41,32,9,2.29
2020,CB2020,081,4,Queens,41479001007,76,39,37,4.33
2020,CB2020,081,4,Queens,41479001008,18,15,3,1.3
2020,CB2020,081,4,Queens,41479001009,279,132,147,9.22
2020,CB2020,081,4,Queens,41479001010,38,10,28,1.27
2020,CB2020,081,4,Queens,41479001011,50,16,34,4.16
2020,CB2020,081,4,Queens,41479001012,99,49,50,5.87
2020,CB2020,081,4,Queens,41479001013,67,29,38,2.86
2020,CB2020,081,4,Queens,41479001014,49,17,32,2.59
2020,CB2020,081,4,Queens,41479001015,75,24,51,4.39
2020,CB2020,081,4,Queens,41479001016,148,79,69,10.54
2020,CB2020,081,4,Queens,41479001017,25,8,17,0.96
2020,CB2020,081,4,Queens,41479001018,39,14,25,1.09
2020,CB2020,081,4,Queens,41479002000,444,184,260,47.51
2020,CB2020,081,4,Queens,41479002001,221,111,110,8.83
2020,CB2020,081,4,Queens,41479002002,0,0,0,1.16
2020,CB2020,081,4,Queens,41479002003,0,0,0,1.17
2020,CB2020,081,4,Queens,41479002004,30,19,11,7.94
2020,CB2020,081,4,Queens,41479002005,68,39,29,2.12
2020,CB2020,081,4,Queens,41479002006,154,83,71,3.99
2020,CB2020,081,4,Queens,41479002007,417,202,215,36.17
2020,CB2020,081,4,Queens,41479002008,146,69,77,3.05
2020,CB2020,081,4,Queens,41479003000,119,80,39,3.82
2020,CB2020,081,4,Queens,41479003001,65,26,39,1.69
2020,CB2020,081,4,Queens,41479003002,51,31,20,1.68
2020,CB2020,081,4,Queens,41479003003,27,9,18,1.96
2020,CB2020,081,4,Queens,41479003004,365,156,209,9.61
2020,CB2020,081,4,Queens,41479003005,77,32,45,3.65
2020,CB2020,081,4,Queens,41479003006,75,49,26,2.89
2020,CB2020,081,4,Queens,41479003007,180,91,89,4.94
2020,CB2020,081,4,Queens,41479003008,126,68,58,3.78
2020,CB2020,081,4,Queens,41479003009,176,67,109,4.9
2020,CB2020,081,4,Queens,41479003010,111,46,65,3.5
2020,CB2020,081,4,Queens,41479003011,179,87,92,6.37
2020,CB2020,081,4,Queens,41483000001,0,0,0,0
2020,CB2020,081,4,Queens,41483001000,233,129,104,45.67
2020,CB2020,081,4,Queens,41483001001,6,4,2,2
2020,CB2020,081,4,Queens,41483001002,34,21,13,0.83
2020,CB2020,081,4,Queens,41483001003,31,15,16,2.17
2020,CB2020,081,4,Queens,41483001004,36,10,26,2.9
2020,CB2020,081,4,Queens,41483001005,33,14,19,2.37
2020,CB2020,081,4,Queens,41483001006,35,19,16,3.68
2020,CB2020,081,4,Queens,41483001007,137,71,66,2.02
2020,CB2020,081,4,Queens,41483001008,14,7,7,2.03
2020,CB2020,081,4,Queens,41483001009,42,30,12,3.81
2020,CB2020,081,4,Queens,41483001010,22,14,8,2.49
2020,CB2020,081,4,Queens,41483001011,113,55,58,2.92
2020,CB2020,081,4,Queens,41483001012,9,1,8,2.59
2020,CB2020,081,4,Queens,41483001013,39,9,30,1.63
2020,CB2020,081,4,Queens,41483001014,37,14,23,2.01
2020,CB2020,081,4,Queens,41483001015,123,54,69,9.38
2020,CB2020,081,4,Queens,41483001016,0,0,0,0.28
2020,CB2020,081,4,Queens,41483001017,11,6,5,1.03
2020,CB2020,081,4,Queens,41483002000,62,17,45,16.24
2020,CB2020,081,4,Queens,41483002001,43,18,25,2.87
2020,CB2020,081,4,Queens,41483002002,37,5,32,2.96
2020,CB2020,081,4,Queens,41483002003,0,0,0,1.37
2020,CB2020,081,4,Queens,41483002004,55,40,15,7.58
2020,CB2020,081,4,Queens,41483002005,33,13,20,2.67
2020,CB2020,081,4,Queens,41483002006,38,23,15,4
2020,CB2020,081,4,Queens,41483002007,44,33,11,9.59
2020,CB2020,081,4,Queens,41483002008,48,23,25,2.91
2020,CB2020,081,4,Queens,41483002009,42,15,27,32.39
2020,CB2020,081,4,Queens,41483002010,36,24,12,2.78
2020,CB2020,081,4,Queens,41483002011,48,13,35,2.96
2020,CB2020,081,4,Queens,41483002012,63,38,25,2.72
2020,CB2020,081,4,Queens,41483003000,55,35,20,3.93
2020,CB2020,081,4,Queens,41483003001,14,6,8,1.77
2020,CB2020,081,4,Queens,41483003002,25,17,8,2.45
2020,CB2020,081,4,Queens,41483003003,0,0,0,2.78
2020,CB2020,081,4,Queens,41483003004,22,11,11,2.27
2020,CB2020,081,4,Queens,41483003005,26,13,13,2.08
2020,CB2020,081,4,Queens,41483003006,28,0,28,1.51
2020,CB2020,081,4,Queens,41483003007,0,0,0,0.3
2020,CB2020,081,4,Queens,41483003008,41,23,18,4.38
2020,CB2020,081,4,Queens,41483003009,44,36,8,5.12
2020,CB2020,081,4,Queens,41483003010,4,3,1,2.26
2020,CB2020,081,4,Queens,41483003011,26,7,19,2.37
2020,CB2020,081,4,Queens,41483003012,10,2,8,3.18
2020,CB2020,081,4,Queens,41483003013,0,0,0,3.03
2020,CB2020,081,4,Queens,41483003014,26,8,18,3.58
2020,CB2020,081,4,Queens,41483003015,32,3,29,3.02
2020,CB2020,081,4,Queens,41483003016,20,3,17,2.05
2020,CB2020,081,4,Queens,41483003017,17,5,12,2.23
2020,CB2020,081,4,Queens,41483003018,32,29,3,2.86
2020,CB2020,081,4,Queens,41483003019,50,28,22,3.82
2020,CB2020,081,4,Queens,41483003020,63,15,48,4.54
2020,CB2020,081,4,Queens,41483003021,66,40,26,5.1
2020,CB2020,081,4,Queens,41483003022,38,27,11,2.6
2020,CB2020,081,4,Queens,41483003023,34,22,12,2.78
2020,CB2020,081,4,Queens,41483003024,58,18,40,3.95
2020,CB2020,081,4,Queens,41483003025,59,39,20,4.11
2020,CB2020,081,4,Queens,41483004000,43,26,17,3.55
2020,CB2020,081,4,Queens,41483004001,35,16,19,4.15
2020,CB2020,081,4,Queens,41483004002,37,25,12,2.77
2020,CB2020,081,4,Queens,41483004003,6,6,0,1.92
2020,CB2020,081,4,Queens,41483004004,12,2,10,2.38
2020,CB2020,081,4,Queens,41483004005,15,13,2,2.82
2020,CB2020,081,4,Queens,41483004006,54,24,30,4.4
2020,CB2020,081,4,Queens,41483004007,22,14,8,3.52
2020,CB2020,081,4,Queens,41483004008,50,27,23,10.79
2020,CB2020,081,4,Queens,41483004009,10,8,2,1.55
2020,CB2020,081,4,Queens,41483004010,19,9,10,2.07
2020,CB2020,081,4,Queens,41483004011,65,32,33,4.89
2020,CB2020,081,4,Queens,41483004012,39,19,20,3.37
2020,CB2020,081,4,Queens,41483004013,28,21,7,1.98
2020,CB2020,081,4,Queens,41483004014,22,8,14,2.22
2020,CB2020,081,4,Queens,41483004015,46,16,30,4.88
2020,CB2020,081,4,Queens,41483004016,29,21,8,2.91
2020,CB2020,081,4,Queens,41483004017,82,29,53,6.49
2020,CB2020,081,4,Queens,41483004018,24,14,10,2.32
2020,CB2020,081,4,Queens,41483004019,36,14,22,1.77
2020,CB2020,081,4,Queens,41507011000,77,56,21,7.72
2020,CB2020,081,4,Queens,41507011001,68,43,25,5.07
2020,CB2020,081,4,Queens,41507011002,184,75,109,11.61
2020,CB2020,081,4,Queens,41507011003,74,41,33,3.8
2020,CB2020,081,4,Queens,41507011004,83,63,20,3.76
2020,CB2020,081,4,Queens,41507011005,42,11,31,2.95
2020,CB2020,081,4,Queens,41507011006,91,34,57,3.06
2020,CB2020,081,4,Queens,41507011007,81,39,42,4
2020,CB2020,081,4,Queens,41507011008,59,23,36,2.94
2020,CB2020,081,4,Queens,41507011009,46,14,32,3.02
2020,CB2020,081,4,Queens,41507011010,78,41,37,12
2020,CB2020,081,4,Queens,41507011011,54,20,34,3.1
2020,CB2020,081,4,Queens,41507011012,57,20,37,3.03
2020,CB2020,081,4,Queens,41507011013,35,5,30,2.48
2020,CB2020,081,4,Queens,41507011014,54,40,14,3.13
2020,CB2020,081,4,Queens,41507011015,42,23,19,4.05
2020,CB2020,081,4,Queens,41507011016,0,0,0,1.63
2020,CB2020,081,4,Queens,41507011017,0,0,0,1.61
2020,CB2020,081,4,Queens,41507011018,14,9,5,2.3
2020,CB2020,081,4,Queens,41507012000,17,10,7,4.2
2020,CB2020,081,4,Queens,41507012001,34,15,19,2.56
2020,CB2020,081,4,Queens,41507012002,33,17,16,2.63
2020,CB2020,081,4,Queens,41507012003,19,6,13,3.12
2020,CB2020,081,4,Queens,41507012004,49,19,30,3.4
2020,CB2020,081,4,Queens,41507012005,27,3,24,2.98
2020,CB2020,081,4,Queens,41507012006,44,18,26,2.62
2020,CB2020,081,4,Queens,41507012007,31,21,10,2.65
2020,CB2020,081,4,Queens,41507012008,90,52,38,4.31
2020,CB2020,081,4,Queens,41507012009,198,106,92,12.33
2020,CB2020,081,4,Queens,41507012010,49,27,22,3.53
2020,CB2020,081,4,Queens,41507012011,87,50,37,5.47
2020,CB2020,081,4,Queens,41507012012,84,30,54,4.92
2020,CB2020,081,4,Queens,41507012013,70,39,31,3.33
2020,CB2020,081,4,Queens,41507012014,63,27,36,4.73
2020,CB2020,081,4,Queens,41507012015,31,19,12,1.84
2020,CB2020,081,4,Queens,41507012016,38,27,11,2.61
2020,CB2020,081,4,Queens,41507012017,56,24,32,3.35
2020,CB2020,081,4,Queens,41507012018,57,13,44,4.73
2020,CB2020,081,4,Queens,41507012019,0,0,0,1.37
2020,CB2020,081,4,Queens,41507012020,0,0,0,1.36
2020,CB2020,081,4,Queens,41507012021,44,28,16,2.36
2020,CB2020,081,4,Queens,41507013000,144,67,77,4.08
2020,CB2020,081,4,Queens,41507013001,81,40,41,5.1
2020,CB2020,081,4,Queens,41507013002,124,45,79,20.24
2020,CB2020,081,4,Queens,41507013003,73,29,44,3
2020,CB2020,081,4,Queens,41507013004,23,18,5,2.79
2020,CB2020,081,4,Queens,41507013005,27,12,15,2.62
2020,CB2020,081,4,Queens,41507013006,44,25,19,4.52
2020,CB2020,081,4,Queens,41507013007,41,17,24,3.6
2020,CB2020,081,4,Queens,41507013008,51,25,26,5.28
2020,CB2020,081,4,Queens,41507013009,0,0,0,0.18
2020,CB2020,081,4,Queens,41507013010,51,25,26,3.6
2020,CB2020,081,4,Queens,41507021000,62,39,23,6.42
2020,CB2020,081,4,Queens,41507021001,102,49,53,8.08
2020,CB2020,081,4,Queens,41507021002,31,12,19,3.59
2020,CB2020,081,4,Queens,41507021003,38,11,27,2.67
2020,CB2020,081,4,Queens,41507021004,224,99,125,13.25
2020,CB2020,081,4,Queens,41507021005,55,22,33,4.93
2020,CB2020,081,4,Queens,41507021006,98,56,42,9.8
2020,CB2020,081,4,Queens,41507021007,69,22,47,7.11
2020,CB2020,081,4,Queens,41507021008,87,36,51,4.36
2020,CB2020,081,4,Queens,41507021009,84,32,52,6.73
2020,CB2020,081,4,Queens,41507021010,92,58,34,5.78
2020,CB2020,081,4,Queens,41507022000,40,16,24,2.16
2020,CB2020,081,4,Queens,41507022001,64,35,29,2.84
2020,CB2020,081,4,Queens,41507022002,86,51,35,3.19
2020,CB2020,081,4,Queens,41507022003,39,14,25,2.7
2020,CB2020,081,4,Queens,41507022004,0,0,0,3.33
2020,CB2020,081,4,Queens,41507022005,31,6,25,2.35
2020,CB2020,081,4,Queens,41507022006,28,17,11,2.35
2020,CB2020,081,4,Queens,41507022007,0,0,0,2.26
2020,CB2020,081,4,Queens,41507022008,40,12,28,2.19
2020,CB2020,081,4,Queens,41507022009,63,36,27,3.39
2020,CB2020,081,4,Queens,41507022010,57,26,31,3.44
2020,CB2020,081,4,Queens,41507022011,46,19,27,3.79
2020,CB2020,081,4,Queens,41507022012,61,30,31,3.92
2020,CB2020,081,4,Queens,41507022013,51,22,29,3.63
2020,CB2020,081,4,Queens,41507022014,64,47,17,3.23
2020,CB2020,081,4,Queens,41507022015,47,22,25,2.41
2020,CB2020,081,4,Queens,41507022016,48,28,20,3.5
2020,CB2020,081,4,Queens,41507023000,32,17,15,1.8
2020,CB2020,081,4,Queens,41507023001,6,6,0,2.39
2020,CB2020,081,4,Queens,41507023002,148,54,94,9.31
2020,CB2020,081,4,Queens,41507023003,12,10,2,0.93
2020,CB2020,081,4,Queens,41507023004,68,28,40,4.12
2020,CB2020,081,4,Queens,41507023005,59,39,20,4.95
2020,CB2020,081,4,Queens,41507023006,98,35,63,9.29
2020,CB2020,081,4,Queens,41507023007,390,166,224,13.3
2020,CB2020,081,4,Queens,41507023008,0,0,0,1.84
2020,CB2020,081,4,Queens,41507023009,10,0,10,3.52
2020,CB2020,081,4,Queens,41507023010,37,23,14,2.24
2020,CB2020,081,4,Queens,41507023011,0,0,0,1.92
2020,CB2020,081,4,Queens,41507023012,0,0,0,1.77
2020,CB2020,081,4,Queens,41507023013,0,0,0,0.84
2020,CB2020,081,4,Queens,41507023014,0,0,0,0.9
2020,CB2020,081,4,Queens,41507024000,57,37,20,2.37
2020,CB2020,081,4,Queens,41507024001,48,27,21,2.3
2020,CB2020,081,4,Queens,41507024002,8,6,2,0.52
2020,CB2020,081,4,Queens,41507024003,39,26,13,0.99
2020,CB2020,081,4,Queens,41507024004,228,108,120,9.92
2020,CB2020,081,4,Queens,41507024005,21,8,13,2.87
2020,CB2020,081,4,Queens,41507024006,21,7,14,1.13
2020,CB2020,081,4,Queens,41507024007,15,0,15,0.69
2020,CB2020,081,4,Queens,41507024008,25,12,13,2.22
2020,CB2020,081,4,Queens,41507024009,20,12,8,0.92
2020,CB2020,081,4,Queens,41529011000,777,347,430,151.3
2020,CB2020,081,4,Queens,41529011001,75,36,39,2.13
2020,CB2020,081,4,Queens,41529011002,271,157,114,5.47
2020,CB2020,081,4,Queens,41529011003,0,0,0,2.4
2020,CB2020,081,4,Queens,41529011004,84,39,45,3.86
2020,CB2020,081,4,Queens,41529011005,44,37,7,1.96
2020,CB2020,081,4,Queens,41529011006,32,10,22,2.21
2020,CB2020,081,4,Queens,41529011007,36,9,27,2.26
2020,CB2020,081,4,Queens,41529011008,0,0,0,4.08
2020,CB2020,081,4,Queens,41529011009,27,17,10,2.15
2020,CB2020,081,4,Queens,41529011010,0,0,0,0.3
2020,CB2020,081,4,Queens,41529011011,0,0,0,2.69
2020,CB2020,081,4,Queens,41529011012,0,0,0,0.53
2020,CB2020,081,4,Queens,41529011013,0,0,0,2.19
2020,CB2020,081,4,Queens,41529011014,0,0,0,3.83
2020,CB2020,081,4,Queens,41529011015,0,0,0,0.41
2020,CB2020,081,4,Queens,41529011016,0,0,0,0.85
2020,CB2020,081,4,Queens,41529011017,0,0,0,3.16
2020,CB2020,081,4,Queens,41529011018,0,0,0,2.81
2020,CB2020,081,4,Queens,41529011019,87,37,50,4.52
2020,CB2020,081,4,Queens,41529012000,438,222,216,27.08
2020,CB2020,081,4,Queens,41529012001,53,39,14,2.27
2020,CB2020,081,4,Queens,41529012002,497,231,266,12.05
2020,CB2020,081,4,Queens,41529012003,200,97,103,3.97
2020,CB2020,081,4,Queens,41529012004,174,83,91,3.16
2020,CB2020,081,4,Queens,41529012005,294,119,175,6.48
2020,CB2020,081,4,Queens,41529012006,311,157,154,4.92
2020,CB2020,081,4,Queens,41529012007,408,213,195,4.41
2020,CB2020,081,4,Queens,41529012008,331,126,205,3.53
2020,CB2020,081,4,Queens,41529013000,0,0,0,4.33
2020,CB2020,081,4,Queens,41529013001,578,287,291,24.48
2020,CB2020,081,4,Queens,41529013002,242,88,154,5.88
2020,CB2020,081,4,Queens,41529013003,80,43,37,2.9
2020,CB2020,081,4,Queens,41529013004,291,135,156,9.49
2020,CB2020,081,4,Queens,41529013005,99,45,54,3.13
2020,CB2020,081,4,Queens,41529013006,268,115,153,9.49
2020,CB2020,081,4,Queens,41529013007,337,151,186,9.54
2020,CB2020,081,4,Queens,41529013008,348,170,178,9.55
2020,CB2020,081,4,Queens,41529021000,201,91,110,8.62
2020,CB2020,081,4,Queens,41529021001,27,22,5,2.07
2020,CB2020,081,4,Queens,41529021002,281,133,148,8.2
2020,CB2020,081,4,Queens,41529021003,23,5,18,1.85
2020,CB2020,081,4,Queens,41529021004,44,13,31,3.85
2020,CB2020,081,4,Queens,41529021005,46,18,28,2.53
2020,CB2020,081,4,Queens,41529021006,38,23,15,3.15
2020,CB2020,081,4,Queens,41529021007,0,0,0,1.88
2020,CB2020,081,4,Queens,41529021008,0,0,0,2.46
2020,CB2020,081,4,Queens,41529021009,0,0,0,1.49
2020,CB2020,081,4,Queens,41529022000,0,0,0,2.61
2020,CB2020,081,4,Queens,41529022001,157,65,92,7.59
2020,CB2020,081,4,Queens,41529022002,313,164,149,18.07
2020,CB2020,081,4,Queens,41529022003,38,7,31,14.27
2020,CB2020,081,4,Queens,41529022004,48,31,17,3.32
2020,CB2020,081,4,Queens,41529022005,76,30,46,4.42
2020,CB2020,081,4,Queens,41529022006,89,44,45,4.33
2020,CB2020,081,4,Queens,41529022007,118,52,66,6.76
2020,CB2020,081,4,Queens,41529022008,0,0,0,4.84
2020,CB2020,081,4,Queens,41529022009,76,47,29,4.5
2020,CB2020,081,4,Queens,41529022010,0,0,0,2.63
2020,CB2020,081,4,Queens,41529022011,8,1,7,10.5
2020,CB2020,081,4,Queens,41529022012,95,53,42,3.92
2020,CB2020,081,4,Queens,41529022013,136,70,66,5.51
2020,CB2020,081,4,Queens,41529022014,33,16,17,2.45
2020,CB2020,081,4,Queens,41529023000,0,0,0,4.85
2020,CB2020,081,4,Queens,41529023001,0,0,0,1.17
2020,CB2020,081,4,Queens,41529023002,79,43,36,3.67
2020,CB2020,081,4,Queens,41529023003,172,92,80,4.95
2020,CB2020,081,4,Queens,41529023004,173,106,67,4.08
2020,CB2020,081,4,Queens,41529023005,89,31,58,2.96
2020,CB2020,081,4,Queens,41529023006,54,27,27,2.22
2020,CB2020,081,4,Queens,41529023007,113,43,70,3.42
2020,CB2020,081,4,Queens,41529023008,418,175,243,11
2020,CB2020,081,4,Queens,41529023009,149,76,73,3.9
2020,CB2020,081,4,Queens,41529023010,163,85,78,4.13
2020,CB2020,081,4,Queens,41529023011,139,65,74,4.5
2020,CB2020,081,4,Queens,41529023012,423,216,207,10.42
2020,CB2020,081,4,Queens,41529023013,35,7,28,4.71
2020,CB2020,081,4,Queens,41529024000,256,133,123,7.39
2020,CB2020,081,4,Queens,41529024001,599,295,304,16.38
2020,CB2020,081,4,Queens,41529024002,369,161,208,9.07
2020,CB2020,081,4,Queens,41529024003,0,0,0,5.93
2020,CB2020,081,4,Queens,41529024004,413,167,246,12.69
2020,CB2020,081,4,Queens,41529024005,174,89,85,6
2020,CB2020,081,4,Queens,41551011000,0,0,0,6.98
2020,CB2020,081,4,Queens,41551011001,1945,635,1310,110.43
2020,CB2020,081,4,Queens,41551031000,0,0,0,8.1
2020,CB2020,081,4,Queens,41551031001,861,401,460,38.35
2020,CB2020,081,4,Queens,41551031002,275,119,156,8
2020,CB2020,081,4,Queens,41551032000,239,114,125,9.05
2020,CB2020,081,4,Queens,41551032001,27,13,14,2.56
2020,CB2020,081,4,Queens,41551032002,85,40,45,4.42
2020,CB2020,081,4,Queens,41551032003,338,153,185,20.04
2020,CB2020,081,4,Queens,41551032004,66,29,37,5.13
2020,CB2020,081,4,Queens,41551032005,63,34,29,3.86
2020,CB2020,081,4,Queens,41551032006,0,0,0,2.74
2020,CB2020,081,4,Queens,41551032007,243,98,145,10.76
2020,CB2020,081,4,Queens,41551033000,437,220,217,12.97
2020,CB2020,081,4,Queens,41551033001,385,171,214,10.75
2020,CB2020,081,4,Queens,41551033002,0,0,0,4.12
2020,CB2020,081,4,Queens,41551033003,299,129,170,8.08
2020,CB2020,081,4,Queens,41551034000,324,151,173,9.24
2020,CB2020,081,4,Queens,41551034001,373,153,220,12.61
2020,CB2020,081,4,Queens,41551034002,358,178,180,10.82
2020,CB2020,081,4,Queens,41551041000,319,135,184,9.75
2020,CB2020,081,4,Queens,41551041001,428,207,221,14.19
2020,CB2020,081,4,Queens,41551041002,101,50,51,15.56
2020,CB2020,081,4,Queens,41551041003,326,147,179,9.59
2020,CB2020,081,4,Queens,41551041004,298,128,170,8.29
2020,CB2020,081,4,Queens,41551041005,235,104,131,6.21
2020,CB2020,081,4,Queens,41551041006,0,0,0,1.89
2020,CB2020,081,4,Queens,41551042000,629,235,394,52.07
2020,CB2020,081,4,Queens,41551042001,106,46,60,3.91
2020,CB2020,081,4,Queens,41551042002,85,55,30,3.8
2020,CB2020,081,4,Queens,41551042003,83,30,53,3.71
2020,CB2020,081,4,Queens,41551042004,53,25,28,2.49
2020,CB2020,081,4,Queens,41551042005,73,61,12,4.21
2020,CB2020,081,4,Queens,41551042006,88,36,52,3.75
2020,CB2020,081,4,Queens,41551042007,88,31,57,4
2020,CB2020,081,4,Queens,41551042008,134,65,69,3.94
2020,CB2020,081,4,Queens,41551042009,0,0,0,0.93
2020,CB2020,081,4,Queens,41551042010,29,17,12,1.4
2020,CB2020,081,4,Queens,41551042011,39,28,11,1.82
2020,CB2020,081,4,Queens,41551042012,54,16,38,2.19
2020,CB2020,081,4,Queens,41551042013,62,28,34,2.62
2020,CB2020,081,4,Queens,41551042014,69,37,32,3.7
2020,CB2020,081,4,Queens,41551042015,101,43,58,4.31
2020,CB2020,081,4,Queens,41551042016,0,0,0,0.52
2020,CB2020,081,4,Queens,41551042017,82,54,28,3.03
2020,CB2020,081,4,Queens,41551042018,70,36,34,2.85
2020,CB2020,081,4,Queens,41551042019,64,23,41,3.48
2020,CB2020,081,4,Queens,41551042020,0,0,0,0.38
2020,CB2020,081,4,Queens,41567001000,24,10,14,71.98
2020,CB2020,081,4,Queens,41567001001,0,0,0,3.62
2020,CB2020,081,4,Queens,41567001002,0,0,0,51.61
2020,CB2020,081,4,Queens,41567001003,0,0,0,0.63
2020,CB2020,081,4,Queens,41567001004,0,0,0,1.78
2020,CB2020,081,4,Queens,41567001005,365,269,96,32.8
2020,CB2020,081,4,Queens,41567001006,0,0,0,0.86
2020,CB2020,081,4,Queens,41567001007,0,0,0,4.16
2020,CB2020,081,4,Queens,41567001008,0,0,0,47.37
2020,CB2020,081,4,Queens,41567001009,807,429,378,119.87
2020,CB2020,081,4,Queens,41567001010,122,59,63,0.99
2020,CB2020,081,4,Queens,41567001011,79,29,50,4.93
2020,CB2020,081,4,Queens,41567001012,73,31,42,1.1
2020,CB2020,081,4,Queens,41567001013,0,0,0,1.23
2020,CB2020,081,4,Queens,41567001014,0,0,0,20.24
2020,CB2020,081,4,Queens,41571011000,420,195,225,14.48
2020,CB2020,081,4,Queens,41571011001,71,37,34,2.33
2020,CB2020,081,4,Queens,41571011002,66,33,33,1.73
2020,CB2020,081,4,Queens,41571011003,82,39,43,2.91
2020,CB2020,081,4,Queens,41571011004,32,12,20,1.19
2020,CB2020,081,4,Queens,41571012000,100,55,45,3.27
2020,CB2020,081,4,Queens,41571012001,70,30,40,1.68
2020,CB2020,081,4,Queens,41571012002,140,76,64,4.22
2020,CB2020,081,4,Queens,41571012003,112,67,45,3.66
2020,CB2020,081,4,Queens,41571012004,75,32,43,2.96
2020,CB2020,081,4,Queens,41571012005,277,136,141,7.44
2020,CB2020,081,4,Queens,41571012006,0,0,0,1.02
2020,CB2020,081,4,Queens,41571012007,0,0,0,0.34
2020,CB2020,081,4,Queens,41571013000,316,155,161,7.93
2020,CB2020,081,4,Queens,41571013001,305,124,181,8.41
2020,CB2020,081,4,Queens,41571014000,51,30,21,2.73
2020,CB2020,081,4,Queens,41571014001,76,26,50,2.37
2020,CB2020,081,4,Queens,41571014002,110,53,57,4.31
2020,CB2020,081,4,Queens,41571014003,108,43,65,4.41
2020,CB2020,081,4,Queens,41571014004,164,67,97,4.09
2020,CB2020,081,4,Queens,41571014005,120,72,48,4.19
2020,CB2020,081,4,Queens,41571014006,89,50,39,3.82
2020,CB2020,081,4,Queens,41571014007,76,59,17,3.54
2020,CB2020,081,4,Queens,41571014008,35,5,30,2.24
2020,CB2020,081,4,Queens,41571014009,0,0,0,0.25
2020,CB2020,081,4,Queens,41571014010,47,19,28,1.95
2020,CB2020,081,4,Queens,41571014011,0,0,0,1.44
2020,CB2020,081,4,Queens,41571014012,0,0,0,0.88
2020,CB2020,081,4,Queens,41571014013,28,11,17,2.15
2020,CB2020,081,4,Queens,41571014014,30,19,11,0.73
2020,CB2020,081,4,Queens,41571014015,28,10,18,1.82
2020,CB2020,081,4,Queens,41571014016,21,13,8,5.72
2020,CB2020,081,4,Queens,41571015000,37,13,24,2.33
2020,CB2020,081,4,Queens,41571015001,79,45,34,3.14
2020,CB2020,081,4,Queens,41571015002,94,44,50,4.02
2020,CB2020,081,4,Queens,41571015003,89,44,45,4.03
2020,CB2020,081,4,Queens,41571015004,110,54,56,4.02
2020,CB2020,081,4,Queens,41571015005,76,62,14,4.03
2020,CB2020,081,4,Queens,41571015006,99,82,17,4.04
2020,CB2020,081,4,Queens,41571015007,73,40,33,4.03
2020,CB2020,081,4,Queens,41571015008,86,29,57,4.11
2020,CB2020,081,4,Queens,41571015009,74,27,47,4.34
2020,CB2020,081,4,Queens,41571015010,103,43,60,4.63
2020,CB2020,081,4,Queens,41571015011,101,48,53,4.63
2020,CB2020,081,4,Queens,41571015012,102,27,75,4.62
2020,CB2020,081,4,Queens,41571016000,72,47,25,2.32
2020,CB2020,081,4,Queens,41571016001,180,111,69,4.63
2020,CB2020,081,4,Queens,41571016002,100,49,51,4.62
2020,CB2020,081,4,Queens,41571016003,122,51,71,4.63
2020,CB2020,081,4,Queens,41571016004,116,66,50,4.09
2020,CB2020,081,4,Queens,41571016005,129,73,56,4.09
2020,CB2020,081,4,Queens,41571016006,112,55,57,4.09
2020,CB2020,081,4,Queens,41571016007,80,49,31,4.1
2020,CB2020,081,4,Queens,41571016008,69,29,40,2.57
2020,CB2020,081,4,Queens,41571016009,85,51,34,2.32
2020,CB2020,081,4,Queens,41571016010,36,23,13,3.74
2020,CB2020,081,4,Queens,41571016011,103,50,53,4.09
2020,CB2020,081,4,Queens,41571016012,106,36,70,4.08
2020,CB2020,081,4,Queens,41571016013,84,19,65,4.09
2020,CB2020,081,4,Queens,41571016014,97,40,57,3.47
2020,CB2020,081,4,Queens,41571017000,122,56,66,4.06
2020,CB2020,081,4,Queens,41571017001,131,63,68,4.68
2020,CB2020,081,4,Queens,41571017002,81,49,32,4.69
2020,CB2020,081,4,Queens,41571017003,90,28,62,4.67
2020,CB2020,081,4,Queens,41571017004,105,53,52,4.54
2020,CB2020,081,4,Queens,41571017005,99,53,46,4.35
2020,CB2020,081,4,Queens,41571017006,76,40,36,4.11
2020,CB2020,081,4,Queens,41571017007,104,43,61,3.86
2020,CB2020,081,4,Queens,41571017008,51,37,14,2.81
2020,CB2020,081,4,Queens,41571017009,22,18,4,3.37
2020,CB2020,081,4,Queens,41571017010,39,14,25,1.7
2020,CB2020,081,4,Queens,41571017011,91,36,55,2.37
2020,CB2020,081,4,Queens,41571018000,161,77,84,4.34
2020,CB2020,081,4,Queens,41571018001,93,44,49,3.8
2020,CB2020,081,4,Queens,41571018002,68,23,45,3.52
2020,CB2020,081,4,Queens,41571018003,67,39,28,3.3
2020,CB2020,081,4,Queens,41571018004,60,38,22,3.14
2020,CB2020,081,4,Queens,41571018005,0,0,0,3.23
2020,CB2020,081,4,Queens,41571018006,78,40,38,3.19
2020,CB2020,081,4,Queens,41571018007,77,54,23,2.75
2020,CB2020,081,4,Queens,41571018008,9,4,5,0.38
2020,CB2020,081,4,Queens,41571018009,38,12,26,2.06
2020,CB2020,081,4,Queens,41571018010,44,22,22,2.03
2020,CB2020,081,4,Queens,41571018011,19,1,18,1.1
2020,CB2020,081,4,Queens,41571018012,50,17,33,2.72
2020,CB2020,081,4,Queens,41571018013,123,66,57,2.93
2020,CB2020,081,4,Queens,41571021000,0,0,0,1.01
2020,CB2020,081,4,Queens,41571021001,0,0,0,3.26
2020,CB2020,081,4,Queens,41571021002,70,46,24,2.8
2020,CB2020,081,4,Queens,41571021003,190,88,102,3.89
2020,CB2020,081,4,Queens,41571021004,122,72,50,2.88
2020,CB2020,081,4,Queens,41571021005,112,53,59,4.19
2020,CB2020,081,4,Queens,41571021006,128,63,65,3.2
2020,CB2020,081,4,Queens,41571021007,114,55,59,3.21
2020,CB2020,081,4,Queens,41571021008,129,57,72,3.2
2020,CB2020,081,4,Queens,41571021009,170,85,85,3.26
2020,CB2020,081,4,Queens,41571022000,0,0,0,2.64
2020,CB2020,081,4,Queens,41571022001,0,0,0,2.24
2020,CB2020,081,4,Queens,41571022002,129,69,60,3.9
2020,CB2020,081,4,Queens,41571022003,140,96,44,4.86
2020,CB2020,081,4,Queens,41571022004,160,92,68,4.63
2020,CB2020,081,4,Queens,41571022005,166,91,75,13.42
2020,CB2020,081,4,Queens,41571022006,127,50,77,4.11
2020,CB2020,081,4,Queens,41571022007,103,49,54,4.1
2020,CB2020,081,4,Queens,41571022008,120,61,59,4.47
2020,CB2020,081,4,Queens,41571022009,129,50,79,3.83
2020,CB2020,081,4,Queens,41579011000,55,9,46,2.29
2020,CB2020,081,4,Queens,41579011001,72,41,31,3.17
2020,CB2020,081,4,Queens,41579011002,88,31,57,4.02
2020,CB2020,081,4,Queens,41579011003,51,17,34,2.85
2020,CB2020,081,4,Queens,41579011004,43,31,12,1.18
2020,CB2020,081,4,Queens,41579011005,75,62,13,4.11
2020,CB2020,081,4,Queens,41579011006,80,47,33,4.11
2020,CB2020,081,4,Queens,41579011007,78,29,49,4.03
2020,CB2020,081,4,Queens,41579011008,106,60,46,4.03
2020,CB2020,081,4,Queens,41579011009,94,40,54,4.18
2020,CB2020,081,4,Queens,41579011010,91,44,47,4.18
2020,CB2020,081,4,Queens,41579012000,97,67,30,2.25
2020,CB2020,081,4,Queens,41579012001,117,57,60,5.42
2020,CB2020,081,4,Queens,41579012002,55,18,37,2.13
2020,CB2020,081,4,Queens,41579012003,46,26,20,2.14
2020,CB2020,081,4,Queens,41579012004,108,64,44,4.35
2020,CB2020,081,4,Queens,41579012005,88,61,27,4.35
2020,CB2020,081,4,Queens,41579012006,116,41,75,4.26
2020,CB2020,081,4,Queens,41579012007,80,43,37,4.27
2020,CB2020,081,4,Queens,41579012008,91,47,44,4.43
2020,CB2020,081,4,Queens,41579012009,86,31,55,4.43
2020,CB2020,081,4,Queens,41579013000,74,38,36,2.19
2020,CB2020,081,4,Queens,41579013001,151,51,100,4.98
2020,CB2020,081,4,Queens,41579013002,53,16,37,2.05
2020,CB2020,081,4,Queens,41579013003,112,48,64,4.11
2020,CB2020,081,4,Queens,41579013004,82,38,44,4.11
2020,CB2020,081,4,Queens,41579013005,93,43,50,4.03
2020,CB2020,081,4,Queens,41579013006,91,41,50,4.03
2020,CB2020,081,4,Queens,41579013007,87,55,32,4.18
2020,CB2020,081,4,Queens,41579013008,98,56,42,4.19
2020,CB2020,081,4,Queens,41579014000,91,35,56,2.5
2020,CB2020,081,4,Queens,41579014001,77,27,50,2.85
2020,CB2020,081,4,Queens,41579014002,86,11,75,2.76
2020,CB2020,081,4,Queens,41579014003,128,91,37,4.71
2020,CB2020,081,4,Queens,41579014004,95,37,58,4.72
2020,CB2020,081,4,Queens,41579014005,108,54,54,4.63
2020,CB2020,081,4,Queens,41579014006,129,70,59,4.62
2020,CB2020,081,4,Queens,41579014007,86,27,59,4.8
2020,CB2020,081,4,Queens,41579014008,110,73,37,4.81
2020,CB2020,081,4,Queens,41579015000,65,29,36,2.06
2020,CB2020,081,4,Queens,41579015001,65,43,22,2.68
2020,CB2020,081,4,Queens,41579015002,101,39,62,4.19
2020,CB2020,081,4,Queens,41579015003,106,50,56,4.17
2020,CB2020,081,4,Queens,41579015004,118,53,65,4.08
2020,CB2020,081,4,Queens,41579015005,117,61,56,4.08
2020,CB2020,081,4,Queens,41579015006,118,54,64,4.24
2020,CB2020,081,4,Queens,41579015007,99,47,52,4.26
2020,CB2020,081,4,Queens,41579016000,48,31,17,1.91
2020,CB2020,081,4,Queens,41579016001,29,16,13,2.35
2020,CB2020,081,4,Queens,41579016002,55,22,33,2.64
2020,CB2020,081,4,Queens,41579016003,42,32,10,2.08
2020,CB2020,081,4,Queens,41579016004,26,12,14,1.58
2020,CB2020,081,4,Queens,41579016005,0,0,0,1.1
2020,CB2020,081,4,Queens,41579016006,95,49,46,3.97
2020,CB2020,081,4,Queens,41579016007,75,36,39,4.04
2020,CB2020,081,4,Queens,41579016008,23,7,16,1.07
2020,CB2020,081,4,Queens,41579016009,58,33,25,2.12
2020,CB2020,081,4,Queens,41579016010,107,55,52,4.06
2020,CB2020,081,4,Queens,41579016011,113,53,60,3.97
2020,CB2020,081,4,Queens,41579016012,71,28,43,4.04
2020,CB2020,081,4,Queens,41579016013,0,0,0,0.42
2020,CB2020,081,4,Queens,41579016014,64,31,33,3.88
2020,CB2020,081,4,Queens,41579016015,50,9,41,3.35
2020,CB2020,081,4,Queens,41579016016,44,26,18,3.05
2020,CB2020,081,4,Queens,41579016017,27,19,8,2.21
2020,CB2020,081,4,Queens,41579021000,26,15,11,1.71
2020,CB2020,081,4,Queens,41579021001,52,11,41,1.18
2020,CB2020,081,4,Queens,41579021002,66,51,15,4.03
2020,CB2020,081,4,Queens,41579021003,80,40,40,4.03
2020,CB2020,081,4,Queens,41579021004,84,44,40,4.04
2020,CB2020,081,4,Queens,41579021005,0,0,0,0.81
2020,CB2020,081,4,Queens,41579021006,10,4,6,3.67
2020,CB2020,081,4,Queens,41579021007,77,44,33,3.89
2020,CB2020,081,4,Queens,41579021008,71,14,57,3.06
2020,CB2020,081,4,Queens,41579021009,40,20,20,2.53
2020,CB2020,081,4,Queens,41579021010,15,6,9,2
2020,CB2020,081,4,Queens,41579021011,10,7,3,1.45
2020,CB2020,081,4,Queens,41579022000,0,0,0,4.25
2020,CB2020,081,4,Queens,41579022001,123,72,51,4.27
2020,CB2020,081,4,Queens,41579022002,58,28,30,4.27
2020,CB2020,081,4,Queens,41579022003,93,46,47,4.26
2020,CB2020,081,4,Queens,41579022004,105,37,68,4.27
2020,CB2020,081,4,Queens,41579022005,114,69,45,4.27
2020,CB2020,081,4,Queens,41579022006,99,40,59,4.27
2020,CB2020,081,4,Queens,41579022007,122,64,58,4.27
2020,CB2020,081,4,Queens,41579022008,87,28,59,3.81
2020,CB2020,081,4,Queens,41579023000,107,70,37,4.01
2020,CB2020,081,4,Queens,41579023001,78,34,44,4.03
2020,CB2020,081,4,Queens,41579023002,126,44,82,4.03
2020,CB2020,081,4,Queens,41579023003,120,81,39,4.03
2020,CB2020,081,4,Queens,41579023004,92,29,63,4.03
2020,CB2020,081,4,Queens,41579023005,0,0,0,4.02
2020,CB2020,081,4,Queens,41579023006,111,57,54,4.02
2020,CB2020,081,4,Queens,41579023007,88,45,43,4.03
2020,CB2020,081,4,Queens,41579023008,67,20,47,3.01
2020,CB2020,081,4,Queens,41579024000,80,38,42,4.62
2020,CB2020,081,4,Queens,41579024001,95,61,34,4.62
2020,CB2020,081,4,Queens,41579024002,128,73,55,4.63
2020,CB2020,081,4,Queens,41579024003,107,44,63,4.63
2020,CB2020,081,4,Queens,41579024004,85,33,52,4.62
2020,CB2020,081,4,Queens,41579024005,133,82,51,4.63
2020,CB2020,081,4,Queens,41579024006,116,56,60,4.63
2020,CB2020,081,4,Queens,41579024007,58,20,38,2.6
2020,CB2020,081,4,Queens,41579024008,61,39,22,2.3
2020,CB2020,081,4,Queens,41579024009,57,18,39,2.25
2020,CB2020,081,4,Queens,41579025000,121,82,39,4.09
2020,CB2020,081,4,Queens,41579025001,62,19,43,4.07
2020,CB2020,081,4,Queens,41579025002,91,30,61,4.08
2020,CB2020,081,4,Queens,41579025003,97,52,45,4.1
2020,CB2020,081,4,Queens,41579025004,86,54,32,4.09
2020,CB2020,081,4,Queens,41579025005,86,33,53,4.09
2020,CB2020,081,4,Queens,41579025006,85,52,33,4.08
2020,CB2020,081,4,Queens,41579025007,44,20,24,2.06
2020,CB2020,081,4,Queens,41579025008,44,21,23,2.79
2020,CB2020,081,4,Queens,41579031000,36,27,9,1.32
2020,CB2020,081,4,Queens,41579031001,0,0,0,0.67
2020,CB2020,081,4,Queens,41579031002,58,33,25,1.24
2020,CB2020,081,4,Queens,41579031003,36,17,19,1.75
2020,CB2020,081,4,Queens,41579031004,52,14,38,2.23
2020,CB2020,081,4,Queens,41579031005,92,36,56,2.77
2020,CB2020,081,4,Queens,41579031006,79,49,30,3.24
2020,CB2020,081,4,Queens,41579031007,137,62,75,5.78
2020,CB2020,081,4,Queens,41579031008,168,77,91,5.98
2020,CB2020,081,4,Queens,41579031009,54,36,18,2.45
2020,CB2020,081,4,Queens,41579031010,49,38,11,2.99
2020,CB2020,081,4,Queens,41579031011,77,52,25,2.2
2020,CB2020,081,4,Queens,41579031012,48,20,28,2.23
2020,CB2020,081,4,Queens,41579031013,22,3,19,0.53
2020,CB2020,081,4,Queens,41579031014,48,21,27,1.95
2020,CB2020,081,4,Queens,41579032000,78,43,35,3.56
2020,CB2020,081,4,Queens,41579032001,31,16,15,0.6
2020,CB2020,081,4,Queens,41579032002,163,89,74,3.79
2020,CB2020,081,4,Queens,41579032003,94,47,47,0.64
2020,CB2020,081,4,Queens,41579032004,99,40,59,4.84
2020,CB2020,081,4,Queens,41579032005,49,14,35,0.89
2020,CB2020,081,4,Queens,41579032006,48,19,29,0.9
2020,CB2020,081,4,Queens,41579032007,60,19,41,3.11
2020,CB2020,081,4,Queens,41579032008,53,29,24,2.56
2020,CB2020,081,4,Queens,41579032009,169,68,101,4.7
2020,CB2020,081,4,Queens,41579032010,136,66,70,4.33
2020,CB2020,081,4,Queens,41579032011,71,56,15,1.96
2020,CB2020,081,4,Queens,41579032012,43,14,29,2.36
2020,CB2020,081,4,Queens,41579032013,77,55,22,3.41
2020,CB2020,081,4,Queens,41579033000,112,61,51,5.04
2020,CB2020,081,4,Queens,41579033001,109,62,47,4.72
2020,CB2020,081,4,Queens,41579033002,114,53,61,4.23
2020,CB2020,081,4,Queens,41579033003,30,4,26,3.83
2020,CB2020,081,4,Queens,41579033004,78,24,54,3.47
2020,CB2020,081,4,Queens,41579033005,92,55,37,3.09
2020,CB2020,081,4,Queens,41579033006,72,36,36,3.21
2020,CB2020,081,4,Queens,41579033007,136,66,70,3.74
2020,CB2020,081,4,Queens,41579033008,163,82,81,4.03
2020,CB2020,081,4,Queens,41579033009,108,42,66,3.97
2020,CB2020,081,4,Queens,41579033010,148,67,81,3.99
2020,CB2020,081,4,Queens,41579033011,142,88,54,4
2020,CB2020,081,4,Queens,41579033012,144,71,73,4.1
2020,CB2020,081,4,Queens,41579033013,69,32,37,3.39
2020,CB2020,081,4,Queens,41579034000,48,29,19,1.06
2020,CB2020,081,4,Queens,41579034001,87,41,46,2.93
2020,CB2020,081,4,Queens,41579034002,98,30,68,4.05
2020,CB2020,081,4,Queens,41579034003,104,56,48,3.99
2020,CB2020,081,4,Queens,41579034004,92,47,45,4.01
2020,CB2020,081,4,Queens,41579034005,102,57,45,3.97
2020,CB2020,081,4,Queens,41579034006,40,31,9,2.05
2020,CB2020,081,4,Queens,41579034007,113,75,38,6.51
2020,CB2020,081,4,Queens,41579034008,85,24,61,3.23
2020,CB2020,081,4,Queens,41579034009,54,13,41,2.02
2020,CB2020,081,4,Queens,41579034010,22,0,22,0.51
2020,CB2020,081,4,Queens,41617001000,48,8,40,1.8
2020,CB2020,081,4,Queens,41617001001,49,16,33,2.04
2020,CB2020,081,4,Queens,41617001002,14,3,11,2
2020,CB2020,081,4,Queens,41617001003,51,34,17,2.08
2020,CB2020,081,4,Queens,41617001004,62,22,40,2.69
2020,CB2020,081,4,Queens,41617001005,138,73,65,8.09
2020,CB2020,081,4,Queens,41617001006,107,59,48,3.28
2020,CB2020,081,4,Queens,41617001007,154,71,83,3.79
2020,CB2020,081,4,Queens,41617001008,0,0,0,2.85
2020,CB2020,081,4,Queens,41617001009,145,99,46,3.83
2020,CB2020,081,4,Queens,41617001010,130,59,71,3.8
2020,CB2020,081,4,Queens,41617001011,39,20,19,1.91
2020,CB2020,081,4,Queens,41617001012,119,69,50,3.81
2020,CB2020,081,4,Queens,41617001013,53,26,27,2.38
2020,CB2020,081,4,Queens,41617001014,87,41,46,1.9
2020,CB2020,081,4,Queens,41617001015,0,0,0,0.31
2020,CB2020,081,4,Queens,41617001016,0,0,0,1.8
2020,CB2020,081,4,Queens,41617001017,0,0,0,0.17
2020,CB2020,081,4,Queens,41617002000,184,90,94,3.57
2020,CB2020,081,4,Queens,41617002001,86,48,38,3.52
2020,CB2020,081,4,Queens,41617002002,83,39,44,3.33
2020,CB2020,081,4,Queens,41617002003,65,24,41,3.14
2020,CB2020,081,4,Queens,41617002004,53,20,33,3.14
2020,CB2020,081,4,Queens,41617002005,81,50,31,2.88
2020,CB2020,081,4,Queens,41617002006,68,44,24,3.39
2020,CB2020,081,4,Queens,41617002007,69,33,36,3.12
2020,CB2020,081,4,Queens,41617002008,52,19,33,2.57
2020,CB2020,081,4,Queens,41617002009,31,19,12,2.21
2020,CB2020,081,4,Queens,41617003000,62,25,37,2.2
2020,CB2020,081,4,Queens,41617003001,86,35,51,2.12
2020,CB2020,081,4,Queens,41617003002,125,46,79,3.58
2020,CB2020,081,4,Queens,41617003003,81,57,24,3.53
2020,CB2020,081,4,Queens,41617003004,99,64,35,4.18
2020,CB2020,081,4,Queens,41617003005,82,44,38,3.71
2020,CB2020,081,4,Queens,41617003006,61,28,33,2.59
2020,CB2020,081,4,Queens,41617003007,47,13,34,3.03
2020,CB2020,081,4,Queens,41617003008,96,28,68,3.58
2020,CB2020,081,4,Queens,41617003009,53,24,29,2.27
2020,CB2020,081,4,Queens,41617003010,88,44,44,1.91
2020,CB2020,081,4,Queens,41617003011,47,26,21,1.28
2020,CB2020,081,4,Queens,41617003012,38,26,12,1.77
2020,CB2020,081,4,Queens,41617004000,251,136,115,15.56
2020,CB2020,081,4,Queens,41617004001,170,81,89,7.63
2020,CB2020,081,4,Queens,41617004002,112,52,60,3.55
2020,CB2020,081,4,Queens,41617004003,92,48,44,2.97
2020,CB2020,081,4,Queens,41617004004,130,62,68,3.68
2020,CB2020,081,4,Queens,41617004005,188,100,88,4.26
2020,CB2020,081,4,Queens,41617004006,183,100,83,4.4
2020,CB2020,081,4,Queens,41617004007,93,50,43,2.91
2020,CB2020,081,4,Queens,41617004008,82,53,29,2.24
2020,CB2020,081,4,Queens,41617004009,0,0,0,0.67
2020,CB2020,081,4,Queens,41617004010,122,71,51,4.59
2020,CB2020,081,4,Queens,41617004011,151,48,103,4.67
2020,CB2020,081,4,Queens,41617004012,0,0,0,0.38
2020,CB2020,081,4,Queens,41617004013,34,17,17,0.9
2020,CB2020,081,4,Queens,41621001000,0,0,0,0.28
2020,CB2020,081,4,Queens,41621001001,350,182,168,16.41
2020,CB2020,081,4,Queens,41621001002,13,6,7,4.17
2020,CB2020,081,4,Queens,41621001003,231,118,113,5.22
2020,CB2020,081,4,Queens,41621001004,204,98,106,5.75
2020,CB2020,081,4,Queens,41621001005,275,150,125,6.34
2020,CB2020,081,4,Queens,41621001006,109,55,54,2.88
2020,CB2020,081,4,Queens,41621001007,0,0,0,0.52
2020,CB2020,081,4,Queens,41621001008,0,0,0,2.71
2020,CB2020,081,4,Queens,41621001009,0,0,0,0.9
2020,CB2020,081,4,Queens,41621002000,39,16,23,1.51
2020,CB2020,081,4,Queens,41621002001,76,34,42,1.37
2020,CB2020,081,4,Queens,41621002002,106,58,48,2.41
2020,CB2020,081,4,Queens,41621002003,413,198,215,3.94
2020,CB2020,081,4,Queens,41621002004,361,168,193,5.51
2020,CB2020,081,4,Queens,41621002005,257,124,133,4.01
2020,CB2020,081,4,Queens,41621002006,184,89,95,4.44
2020,CB2020,081,4,Queens,41621002007,50,35,15,0.85
2020,CB2020,081,4,Queens,41621002008,80,44,36,1.51
2020,CB2020,081,4,Queens,41621002009,198,96,102,3.22
2020,CB2020,081,4,Queens,41621002010,73,42,31,2.32
2020,CB2020,081,4,Queens,41621002011,62,30,32,1.24
2020,CB2020,081,4,Queens,41621003000,180,69,111,4.08
2020,CB2020,081,4,Queens,41621003001,155,86,69,3.87
2020,CB2020,081,4,Queens,41621003002,129,88,41,3.58
2020,CB2020,081,4,Queens,41621003003,114,53,61,3.31
2020,CB2020,081,4,Queens,41621003004,145,75,70,3.32
2020,CB2020,081,4,Queens,41621003005,168,68,100,3.42
2020,CB2020,081,4,Queens,41621003006,126,53,73,3.83
2020,CB2020,081,4,Queens,41621003007,186,87,99,3.77
2020,CB2020,081,4,Queens,41621004000,30,15,15,2
2020,CB2020,081,4,Queens,41621004001,172,75,97,4.12
2020,CB2020,081,4,Queens,41621004002,181,84,97,4.18
2020,CB2020,081,4,Queens,41621004003,165,92,73,3.73
2020,CB2020,081,4,Queens,41621004004,129,66,63,3.72
2020,CB2020,081,4,Queens,41621004005,71,36,35,2.43
2020,CB2020,081,4,Queens,41621004006,75,36,39,2.25
2020,CB2020,081,4,Queens,41621004007,53,21,32,2.05
2020,CB2020,081,4,Queens,41621004008,100,68,32,2.63
2020,CB2020,081,4,Queens,41621004009,56,26,30,2.21
2020,CB2020,081,4,Queens,41621005000,0,0,0,0.75
2020,CB2020,081,4,Queens,41621005001,88,41,47,2.35
2020,CB2020,081,4,Queens,41621005002,154,75,79,3.35
2020,CB2020,081,4,Queens,41621005003,137,64,73,4.11
2020,CB2020,081,4,Queens,41621005004,291,163,128,11.37
2020,CB2020,081,4,Queens,41621005005,19,11,8,1.04
2020,CB2020,081,4,Queens,41621005006,0,0,0,0.88
2020,CB2020,081,4,Queens,41621005007,0,0,0,0.29
2020,CB2020,081,4,Queens,41621005008,92,36,56,1.66
2020,CB2020,081,4,Queens,41621005009,96,54,42,1.79
2020,CB2020,081,4,Queens,41621005010,70,42,28,2.19
2020,CB2020,081,4,Queens,41621005011,61,37,24,1.52
2020,CB2020,081,4,Queens,41621005012,185,88,97,4.17
2020,CB2020,081,4,Queens,41621005013,126,50,76,2.66
2020,CB2020,081,4,Queens,41621005014,47,12,35,0.92
2020,CB2020,081,4,Queens,41621005015,0,0,0,0.44
2020,CB2020,081,4,Queens,49901000001,0,0,0,0
2020,CB2020,081,4,Queens,49901000002,0,0,0,0
2020,CB2020,081,4,Queens,49901000003,0,0,0,0
2020,CB2020,081,4,Queens,49901000004,0,0,0,0
2020,CB2020,081,4,Queens,49901000005,0,0,0,0
2020,CB2020,081,4,Queens,49901000006,0,0,0,0
2020,CB2020,085,5,Staten Island,50003000001,0,0,0,0
2020,CB2020,085,5,Staten Island,50003001000,0,0,0,18.66
2020,CB2020,085,5,Staten Island,50003001001,0,0,0,3.44
2020,CB2020,085,5,Staten Island,50003001002,287,173,114,2.64
2020,CB2020,085,5,Staten Island,50003001003,0,0,0,3.57
2020,CB2020,085,5,Staten Island,50003001004,614,296,318,8.12
2020,CB2020,085,5,Staten Island,50003002000,648,316,332,25.29
2020,CB2020,085,5,Staten Island,50003002001,113,56,57,6.26
2020,CB2020,085,5,Staten Island,50003002002,12,8,4,0.53
2020,CB2020,085,5,Staten Island,50003002003,278,164,114,5.82
2020,CB2020,085,5,Staten Island,50003002004,151,63,88,8.88
2020,CB2020,085,5,Staten Island,50003002005,195,107,88,8.04
2020,CB2020,085,5,Staten Island,50003002006,50,24,26,2.02
2020,CB2020,085,5,Staten Island,50006000001,0,0,0,0
2020,CB2020,085,5,Staten Island,50006000002,0,0,0,0
2020,CB2020,085,5,Staten Island,50006001000,61,27,34,41.61
2020,CB2020,085,5,Staten Island,50006001001,0,0,0,0.79
2020,CB2020,085,5,Staten Island,50006001002,10,6,4,6.28
2020,CB2020,085,5,Staten Island,50006001003,0,0,0,0.7
2020,CB2020,085,5,Staten Island,50006001004,18,7,11,2.14
2020,CB2020,085,5,Staten Island,50006001005,13,11,2,5.28
2020,CB2020,085,5,Staten Island,50006001006,102,43,59,2.26
2020,CB2020,085,5,Staten Island,50006001007,226,100,126,10.08
2020,CB2020,085,5,Staten Island,50006001008,245,128,117,7.76
2020,CB2020,085,5,Staten Island,50006001009,230,114,116,10.41
2020,CB2020,085,5,Staten Island,50006001010,34,22,12,1.28
2020,CB2020,085,5,Staten Island,50006001011,208,89,119,4.44
2020,CB2020,085,5,Staten Island,50006002000,857,356,501,22.84
2020,CB2020,085,5,Staten Island,50006002001,186,88,98,8.23
2020,CB2020,085,5,Staten Island,50006002002,170,91,79,4.04
2020,CB2020,085,5,Staten Island,50006002003,72,30,42,4.08
2020,CB2020,085,5,Staten Island,50006002004,73,35,38,9.74
2020,CB2020,085,5,Staten Island,50006002005,35,17,18,18.1
2020,CB2020,085,5,Staten Island,50006002006,279,140,139,4.4
2020,CB2020,085,5,Staten Island,50006002007,40,18,22,0.3
2020,CB2020,085,5,Staten Island,50007000001,0,0,0,0
2020,CB2020,085,5,Staten Island,50007001000,0,0,0,3
2020,CB2020,085,5,Staten Island,50007001001,0,0,0,1.64
2020,CB2020,085,5,Staten Island,50007001002,1359,581,778,18.4
2020,CB2020,085,5,Staten Island,50007001003,177,89,88,2.7
2020,CB2020,085,5,Staten Island,50007002000,661,323,338,17.54
2020,CB2020,085,5,Staten Island,50007002001,214,98,116,5.17
2020,CB2020,085,5,Staten Island,50007002002,181,83,98,3.66
2020,CB2020,085,5,Staten Island,50007003000,204,101,103,6.99
2020,CB2020,085,5,Staten Island,50007003001,442,219,223,5.21
2020,CB2020,085,5,Staten Island,50007003002,265,119,146,8.27
2020,CB2020,085,5,Staten Island,50007004000,0,0,0,11.59
2020,CB2020,085,5,Staten Island,50007004001,84,61,23,20.37
2020,CB2020,085,5,Staten Island,50007004002,0,0,0,5.34
2020,CB2020,085,5,Staten Island,50007004003,27,16,11,1.49
2020,CB2020,085,5,Staten Island,50007004004,1068,441,627,10.5
2020,CB2020,085,5,Staten Island,50007004005,0,0,0,2.81
2020,CB2020,085,5,Staten Island,50007004006,179,90,89,2.65
2020,CB2020,085,5,Staten Island,50007004007,282,134,148,3.15
2020,CB2020,085,5,Staten Island,50008001000,0,0,0,5.41
2020,CB2020,085,5,Staten Island,50008001001,0,0,0,4.03
2020,CB2020,085,5,Staten Island,50008001002,0,0,0,3.82
2020,CB2020,085,5,Staten Island,50008001003,37,29,8,2.07
2020,CB2020,085,5,Staten Island,50008001004,150,89,61,6.08
2020,CB2020,085,5,Staten Island,50008001005,140,61,79,6.19
2020,CB2020,085,5,Staten Island,50008001006,169,82,87,3.52
2020,CB2020,085,5,Staten Island,50008001007,115,52,63,3.05
2020,CB2020,085,5,Staten Island,50008001008,58,21,37,1.63
2020,CB2020,085,5,Staten Island,50008001009,112,51,61,2.01
2020,CB2020,085,5,Staten Island,50008001010,60,31,29,0.92
2020,CB2020,085,5,Staten Island,50008001011,138,60,78,10.3
2020,CB2020,085,5,Staten Island,50008001012,78,41,37,3.56
2020,CB2020,085,5,Staten Island,50008001013,65,42,23,1.11
2020,CB2020,085,5,Staten Island,50008001014,66,49,17,1.82
2020,CB2020,085,5,Staten Island,50008001015,185,103,82,4.87
2020,CB2020,085,5,Staten Island,50008001016,70,45,25,3.45
2020,CB2020,085,5,Staten Island,50008001017,123,46,77,2.65
2020,CB2020,085,5,Staten Island,50008001018,163,88,75,2.63
2020,CB2020,085,5,Staten Island,50008001019,0,0,0,4.41
2020,CB2020,085,5,Staten Island,50008001020,100,52,48,2.77
2020,CB2020,085,5,Staten Island,50008001021,86,63,23,2.6
2020,CB2020,085,5,Staten Island,50008001022,149,55,94,4.16
2020,CB2020,085,5,Staten Island,50008002000,117,56,61,3.74
2020,CB2020,085,5,Staten Island,50008002001,76,55,21,2.76
2020,CB2020,085,5,Staten Island,50008002002,117,49,68,2.68
2020,CB2020,085,5,Staten Island,50008002003,173,95,78,3.77
2020,CB2020,085,5,Staten Island,50008002004,516,244,272,10.41
2020,CB2020,085,5,Staten Island,50008002005,113,74,39,1.93
2020,CB2020,085,5,Staten Island,50008002006,175,91,84,4.08
2020,CB2020,085,5,Staten Island,50008002007,204,114,90,5.12
2020,CB2020,085,5,Staten Island,50008002008,34,14,20,1.17
2020,CB2020,085,5,Staten Island,50008002009,290,148,142,7.8
2020,CB2020,085,5,Staten Island,50008002010,57,20,37,0.88
2020,CB2020,085,5,Staten Island,50008002011,135,63,72,3.5
2020,CB2020,085,5,Staten Island,50008002012,151,54,97,3.63
2020,CB2020,085,5,Staten Island,50008003000,155,88,67,4.84
2020,CB2020,085,5,Staten Island,50008003001,231,108,123,6.45
2020,CB2020,085,5,Staten Island,50008003002,128,54,74,4.02
2020,CB2020,085,5,Staten Island,50008003003,107,44,63,4.29
2020,CB2020,085,5,Staten Island,50008003004,161,74,87,5.33
2020,CB2020,085,5,Staten Island,50008003005,431,242,189,9.64
2020,CB2020,085,5,Staten Island,50008003006,137,82,55,4.5
2020,CB2020,085,5,Staten Island,50008003007,110,57,53,2.83
2020,CB2020,085,5,Staten Island,50008003008,177,72,105,6.62
2020,CB2020,085,5,Staten Island,50008003009,148,73,75,4.7
2020,CB2020,085,5,Staten Island,50008003010,104,41,63,2.52
2020,CB2020,085,5,Staten Island,50008003011,91,38,53,2.2
2020,CB2020,085,5,Staten Island,50008003012,66,40,26,5.17
2020,CB2020,085,5,Staten Island,50009001000,94,34,60,5.61
2020,CB2020,085,5,Staten Island,50009001001,38,27,11,1.26
2020,CB2020,085,5,Staten Island,50009001002,316,177,139,5.87
2020,CB2020,085,5,Staten Island,50009001003,51,20,31,3.45
2020,CB2020,085,5,Staten Island,50009001004,391,197,194,11.64
2020,CB2020,085,5,Staten Island,50009001005,0,0,0,1.1
2020,CB2020,085,5,Staten Island,50009001006,131,82,49,1.6
2020,CB2020,085,5,Staten Island,50009001007,53,20,33,2.75
2020,CB2020,085,5,Staten Island,50009002000,195,105,90,3.59
2020,CB2020,085,5,Staten Island,50009002001,196,63,133,6.96
2020,CB2020,085,5,Staten Island,50009002002,229,101,128,3.49
2020,CB2020,085,5,Staten Island,50009002003,192,105,87,2.66
2020,CB2020,085,5,Staten Island,50009002004,163,94,69,3.22
2020,CB2020,085,5,Staten Island,50009002005,191,79,112,4.09
2020,CB2020,085,5,Staten Island,50011001000,326,186,140,7.28
2020,CB2020,085,5,Staten Island,50011001001,370,182,188,3.64
2020,CB2020,085,5,Staten Island,50011001002,146,59,87,3.63
2020,CB2020,085,5,Staten Island,50011001003,182,100,82,4.24
2020,CB2020,085,5,Staten Island,50011001004,47,23,24,4.21
2020,CB2020,085,5,Staten Island,50011001005,169,104,65,2.26
2020,CB2020,085,5,Staten Island,50011002000,234,136,98,4.38
2020,CB2020,085,5,Staten Island,50011002001,436,219,217,8.52
2020,CB2020,085,5,Staten Island,50011002002,399,199,200,6.46
2020,CB2020,085,5,Staten Island,50011002003,122,62,60,1.52
2020,CB2020,085,5,Staten Island,50011002004,0,0,0,0.99
2020,CB2020,085,5,Staten Island,50011002005,99,44,55,2.22
2020,CB2020,085,5,Staten Island,50011002006,48,20,28,3.82
2020,CB2020,085,5,Staten Island,50011002007,36,26,10,0.41
2020,CB2020,085,5,Staten Island,50011003000,238,111,127,4.96
2020,CB2020,085,5,Staten Island,50011003001,371,183,188,3.84
2020,CB2020,085,5,Staten Island,50011003002,294,153,141,4.35
2020,CB2020,085,5,Staten Island,50011003003,209,95,114,4.53
2020,CB2020,085,5,Staten Island,50011003004,194,86,108,4.65
2020,CB2020,085,5,Staten Island,50011003005,314,170,144,4.44
2020,CB2020,085,5,Staten Island,50017001000,722,393,329,33.25
2020,CB2020,085,5,Staten Island,50017001001,115,49,66,3.8
2020,CB2020,085,5,Staten Island,50017001002,64,26,38,3.05
2020,CB2020,085,5,Staten Island,50017001003,58,27,31,4.24
2020,CB2020,085,5,Staten Island,50017001004,63,37,26,6.44
2020,CB2020,085,5,Staten Island,50017002000,96,57,39,3.03
2020,CB2020,085,5,Staten Island,50017002001,226,136,90,2.69
2020,CB2020,085,5,Staten Island,50017002002,63,26,37,1.3
2020,CB2020,085,5,Staten Island,50017002003,32,8,24,2.52
2020,CB2020,085,5,Staten Island,50017002004,104,52,52,3.43
2020,CB2020,085,5,Staten Island,50017002005,159,76,83,3.81
2020,CB2020,085,5,Staten Island,50017002006,71,39,32,2.71
2020,CB2020,085,5,Staten Island,50017002007,92,55,37,5.34
2020,CB2020,085,5,Staten Island,50018000001,0,0,0,0
2020,CB2020,085,5,Staten Island,50018000002,0,0,0,0
2020,CB2020,085,5,Staten Island,50018000003,0,0,0,0
2020,CB2020,085,5,Staten Island,50018000004,0,0,0,0
2020,CB2020,085,5,Staten Island,50018000005,0,0,0,0
2020,CB2020,085,5,Staten Island,50018000006,0,0,0,0
2020,CB2020,085,5,Staten Island,50018000007,0,0,0,0
2020,CB2020,085,5,Staten Island,50018000008,0,0,0,0
2020,CB2020,085,5,Staten Island,50018000009,0,0,0,0
2020,CB2020,085,5,Staten Island,50018001000,0,0,0,9.87
2020,CB2020,085,5,Staten Island,50018001001,24,9,15,2.57
2020,CB2020,085,5,Staten Island,50018001002,17,4,13,2.14
2020,CB2020,085,5,Staten Island,50018001003,8,5,3,20.56
2020,CB2020,085,5,Staten Island,50018001004,0,0,0,7.22
2020,CB2020,085,5,Staten Island,50018001005,62,48,14,9.63
2020,CB2020,085,5,Staten Island,50018001006,8,5,3,13.13
2020,CB2020,085,5,Staten Island,50018001007,0,0,0,8.02
2020,CB2020,085,5,Staten Island,50018001008,11,4,7,0.63
2020,CB2020,085,5,Staten Island,50018001009,0,0,0,3.72
2020,CB2020,085,5,Staten Island,50018001010,0,0,0,5.84
2020,CB2020,085,5,Staten Island,50018001011,0,0,0,5.81
2020,CB2020,085,5,Staten Island,50018001012,0,0,0,1.45
2020,CB2020,085,5,Staten Island,50018001013,0,0,0,0.3
2020,CB2020,085,5,Staten Island,50018001014,0,0,0,0.19
2020,CB2020,085,5,Staten Island,50018001015,13,5,8,51.04
2020,CB2020,085,5,Staten Island,50018001016,0,0,0,8.29
2020,CB2020,085,5,Staten Island,50018001017,0,0,0,0.84
2020,CB2020,085,5,Staten Island,50018001018,20,10,10,1.74
2020,CB2020,085,5,Staten Island,50018001019,5,2,3,14.98
2020,CB2020,085,5,Staten Island,50018001020,63,32,31,6.57
2020,CB2020,085,5,Staten Island,50018001021,69,41,28,9.41
2020,CB2020,085,5,Staten Island,50018001022,146,68,78,23.55
2020,CB2020,085,5,Staten Island,50018001023,0,0,0,3.31
2020,CB2020,085,5,Staten Island,50018001024,0,0,0,3.01
2020,CB2020,085,5,Staten Island,50018001025,0,0,0,5.99
2020,CB2020,085,5,Staten Island,50018001026,0,0,0,2.46
2020,CB2020,085,5,Staten Island,50018001027,49,30,19,2.63
2020,CB2020,085,5,Staten Island,50020011000,75,34,41,2.45
2020,CB2020,085,5,Staten Island,50020011001,43,24,19,2.13
2020,CB2020,085,5,Staten Island,50020011002,486,226,260,14.04
2020,CB2020,085,5,Staten Island,50020011003,46,15,31,0.68
2020,CB2020,085,5,Staten Island,50020011004,42,15,27,1.97
2020,CB2020,085,5,Staten Island,50020011005,145,49,96,4.1
2020,CB2020,085,5,Staten Island,50020011006,34,17,17,1.62
2020,CB2020,085,5,Staten Island,50020011007,54,24,30,2.56
2020,CB2020,085,5,Staten Island,50020011008,84,46,38,3.96
2020,CB2020,085,5,Staten Island,50020011009,79,49,30,2.69
2020,CB2020,085,5,Staten Island,50020011010,27,12,15,0.32
2020,CB2020,085,5,Staten Island,50020011011,42,26,16,0.79
2020,CB2020,085,5,Staten Island,50020011012,90,56,34,2.34
2020,CB2020,085,5,Staten Island,50020011013,0,0,0,2.64
2020,CB2020,085,5,Staten Island,50020011014,0,0,0,1.58
2020,CB2020,085,5,Staten Island,50020011015,0,0,0,0.72
2020,CB2020,085,5,Staten Island,50020012000,277,130,147,6.04
2020,CB2020,085,5,Staten Island,50020012001,278,155,123,24.15
2020,CB2020,085,5,Staten Island,50020012002,83,37,46,2.3
2020,CB2020,085,5,Staten Island,50020012003,45,15,30,2.02
2020,CB2020,085,5,Staten Island,50020012004,83,50,33,2.38
2020,CB2020,085,5,Staten Island,50020012005,153,68,85,3.61
2020,CB2020,085,5,Staten Island,50020012006,19,5,14,9.97
2020,CB2020,085,5,Staten Island,50020012007,52,15,37,2.36
2020,CB2020,085,5,Staten Island,50020012008,27,9,18,1.56
2020,CB2020,085,5,Staten Island,50020012009,0,0,0,2.24
2020,CB2020,085,5,Staten Island,50020012010,11,5,6,6.92
2020,CB2020,085,5,Staten Island,50020012011,43,31,12,1.11
2020,CB2020,085,5,Staten Island,50020012012,78,41,37,1.55
2020,CB2020,085,5,Staten Island,50020012013,74,44,30,2.32
2020,CB2020,085,5,Staten Island,50020012014,54,17,37,1.72
2020,CB2020,085,5,Staten Island,50020012015,0,0,0,2.07
2020,CB2020,085,5,Staten Island,50020012016,0,0,0,4.47
2020,CB2020,085,5,Staten Island,50020012017,0,0,0,4.17
2020,CB2020,085,5,Staten Island,50020012018,0,0,0,1.23
2020,CB2020,085,5,Staten Island,50020021000,0,0,0,9.67
2020,CB2020,085,5,Staten Island,50020021001,0,0,0,8.34
2020,CB2020,085,5,Staten Island,50020021002,0,0,0,6.93
2020,CB2020,085,5,Staten Island,50020021003,316,163,153,10.04
2020,CB2020,085,5,Staten Island,50020021004,80,42,38,2.16
2020,CB2020,085,5,Staten Island,50020021005,73,23,50,2.24
2020,CB2020,085,5,Staten Island,50020021006,109,50,59,3.31
2020,CB2020,085,5,Staten Island,50020021007,112,65,47,3.44
2020,CB2020,085,5,Staten Island,50020021008,114,41,73,3.87
2020,CB2020,085,5,Staten Island,50020021009,33,26,7,2.72
2020,CB2020,085,5,Staten Island,50020021010,16,9,7,3.16
2020,CB2020,085,5,Staten Island,50020021011,75,49,26,14.81
2020,CB2020,085,5,Staten Island,50020021012,118,39,79,5.03
2020,CB2020,085,5,Staten Island,50020021013,175,79,96,4.14
2020,CB2020,085,5,Staten Island,50020021014,87,41,46,2.86
2020,CB2020,085,5,Staten Island,50020021015,61,23,38,1.94
2020,CB2020,085,5,Staten Island,50020021016,114,71,43,2.51
2020,CB2020,085,5,Staten Island,50020021017,64,21,43,3.32
2020,CB2020,085,5,Staten Island,50020021018,131,55,76,28.02
2020,CB2020,085,5,Staten Island,50020021019,123,62,61,2.96
2020,CB2020,085,5,Staten Island,50020021020,45,33,12,4.25
2020,CB2020,085,5,Staten Island,50020021021,109,57,52,3.92
2020,CB2020,085,5,Staten Island,50020021022,130,59,71,3.24
2020,CB2020,085,5,Staten Island,50020022000,319,161,158,13.31
2020,CB2020,085,5,Staten Island,50020022001,189,91,98,4.01
2020,CB2020,085,5,Staten Island,50020022002,0,0,0,2.73
2020,CB2020,085,5,Staten Island,50020022003,0,0,0,4.23
2020,CB2020,085,5,Staten Island,50020022004,0,0,0,1.47
2020,CB2020,085,5,Staten Island,50020022005,0,0,0,0.52
2020,CB2020,085,5,Staten Island,50020022006,498,250,248,22.05
2020,CB2020,085,5,Staten Island,50020022007,35,16,19,2.33
2020,CB2020,085,5,Staten Island,50020022008,63,22,41,2.77
2020,CB2020,085,5,Staten Island,50020022009,113,54,59,3.57
2020,CB2020,085,5,Staten Island,50020022010,0,0,0,0.83
2020,CB2020,085,5,Staten Island,50021000001,0,0,0,0
2020,CB2020,085,5,Staten Island,50021001000,111,51,60,3.53
2020,CB2020,085,5,Staten Island,50021001001,71,42,29,2.73
2020,CB2020,085,5,Staten Island,50021001002,230,94,136,4.88
2020,CB2020,085,5,Staten Island,50021001003,42,18,24,0.93
2020,CB2020,085,5,Staten Island,50021001004,108,56,52,3.91
2020,CB2020,085,5,Staten Island,50021001005,89,41,48,2.37
2020,CB2020,085,5,Staten Island,50021001006,101,59,42,2.92
2020,CB2020,085,5,Staten Island,50021001007,89,32,57,5.48
2020,CB2020,085,5,Staten Island,50021001008,85,57,28,3.96
2020,CB2020,085,5,Staten Island,50021001009,212,116,96,6.92
2020,CB2020,085,5,Staten Island,50021002000,798,393,405,30.14
2020,CB2020,085,5,Staten Island,50021002001,0,0,0,4.56
2020,CB2020,085,5,Staten Island,50021002002,0,0,0,3.04
2020,CB2020,085,5,Staten Island,50021002003,0,0,0,1.88
2020,CB2020,085,5,Staten Island,50021002004,0,0,0,0.95
2020,CB2020,085,5,Staten Island,50021002005,193,113,80,5.69
2020,CB2020,085,5,Staten Island,50021002006,26,8,18,1.88
2020,CB2020,085,5,Staten Island,50021002007,0,0,0,0.71
2020,CB2020,085,5,Staten Island,50021002008,0,0,0,1.36
2020,CB2020,085,5,Staten Island,50021002009,37,24,13,15.76
2020,CB2020,085,5,Staten Island,50021002010,0,0,0,2.43
2020,CB2020,085,5,Staten Island,50021002011,0,0,0,11.57
2020,CB2020,085,5,Staten Island,50021002012,0,0,0,1.73
2020,CB2020,085,5,Staten Island,50021002013,22,9,13,1.66
2020,CB2020,085,5,Staten Island,50021002014,91,65,26,0.96
2020,CB2020,085,5,Staten Island,50021002015,153,76,77,4.18
2020,CB2020,085,5,Staten Island,50021002016,78,51,27,2.14
2020,CB2020,085,5,Staten Island,50021002017,22,16,6,2.5
2020,CB2020,085,5,Staten Island,50021002018,26,11,15,1.41
2020,CB2020,085,5,Staten Island,50021002019,82,46,36,2.19
2020,CB2020,085,5,Staten Island,50021002020,97,49,48,3.63
2020,CB2020,085,5,Staten Island,50021002021,11,8,3,1.94
2020,CB2020,085,5,Staten Island,50021002022,43,17,26,3.82
2020,CB2020,085,5,Staten Island,50021002023,207,74,133,2.44
2020,CB2020,085,5,Staten Island,50021002024,80,29,51,1.54
2020,CB2020,085,5,Staten Island,50021002025,28,19,9,1.2
2020,CB2020,085,5,Staten Island,50021002026,202,108,94,6.38
2020,CB2020,085,5,Staten Island,50021003000,243,102,141,6.92
2020,CB2020,085,5,Staten Island,50021003001,212,110,102,5.57
2020,CB2020,085,5,Staten Island,50021003002,133,73,60,4.21
2020,CB2020,085,5,Staten Island,50021003003,75,28,47,1.98
2020,CB2020,085,5,Staten Island,50021003004,122,32,90,2.34
2020,CB2020,085,5,Staten Island,50021003005,73,35,38,1.29
2020,CB2020,085,5,Staten Island,50021003006,149,68,81,8.2
2020,CB2020,085,5,Staten Island,50021003007,0,0,0,2.68
2020,CB2020,085,5,Staten Island,50021003008,110,39,71,1.67
2020,CB2020,085,5,Staten Island,50021003009,113,65,48,2.39
2020,CB2020,085,5,Staten Island,50021003010,113,56,57,2.82
2020,CB2020,085,5,Staten Island,50021003011,444,210,234,10.72
2020,CB2020,085,5,Staten Island,50021003012,158,101,57,3.45
2020,CB2020,085,5,Staten Island,50021003013,188,105,83,4.03
2020,CB2020,085,5,Staten Island,50027001000,941,537,404,39.79
2020,CB2020,085,5,Staten Island,50027001001,294,158,136,4.41
2020,CB2020,085,5,Staten Island,50027002000,258,143,115,3.43
2020,CB2020,085,5,Staten Island,50027002001,147,98,49,4.96
2020,CB2020,085,5,Staten Island,50027002002,128,67,61,2.46
2020,CB2020,085,5,Staten Island,50027002003,211,109,102,4.7
2020,CB2020,085,5,Staten Island,50027002004,70,32,38,2.11
2020,CB2020,085,5,Staten Island,50029001000,335,174,161,8.57
2020,CB2020,085,5,Staten Island,50029001001,274,127,147,6.09
2020,CB2020,085,5,Staten Island,50029001002,124,41,83,2.39
2020,CB2020,085,5,Staten Island,50029001003,100,34,66,1.38
2020,CB2020,085,5,Staten Island,50029001004,108,60,48,2.45
2020,CB2020,085,5,Staten Island,50029001005,65,30,35,2
2020,CB2020,085,5,Staten Island,50029001006,226,117,109,3.62
2020,CB2020,085,5,Staten Island,50029001007,305,149,156,5.44
2020,CB2020,085,5,Staten Island,50029001008,111,50,61,2.73
2020,CB2020,085,5,Staten Island,50029002000,2728,1244,1484,25.42
2020,CB2020,085,5,Staten Island,50029003000,344,171,173,17.55
2020,CB2020,085,5,Staten Island,50029003001,44,32,12,0.56
2020,CB2020,085,5,Staten Island,50029003002,255,111,144,5.24
2020,CB2020,085,5,Staten Island,50029003003,119,50,69,2.73
2020,CB2020,085,5,Staten Island,50029003004,190,93,97,4.79
2020,CB2020,085,5,Staten Island,50029003005,0,0,0,1.99
2020,CB2020,085,5,Staten Island,50029003006,80,55,25,2.03
2020,CB2020,085,5,Staten Island,50029003007,128,54,74,1.89
2020,CB2020,085,5,Staten Island,50029003008,0,0,0,0.34
2020,CB2020,085,5,Staten Island,50029003009,94,46,48,2.52
2020,CB2020,085,5,Staten Island,50029003010,58,29,29,1.85
2020,CB2020,085,5,Staten Island,50029003011,104,43,61,3.25
2020,CB2020,085,5,Staten Island,50029004000,39,14,25,1.22
2020,CB2020,085,5,Staten Island,50029004001,70,29,41,1.89
2020,CB2020,085,5,Staten Island,50029004002,27,12,15,1.03
2020,CB2020,085,5,Staten Island,50029004003,74,39,35,1.75
2020,CB2020,085,5,Staten Island,50029004004,153,68,85,3.6
2020,CB2020,085,5,Staten Island,50029004005,139,86,53,3.9
2020,CB2020,085,5,Staten Island,50029004006,0,0,0,0.48
2020,CB2020,085,5,Staten Island,50029004007,106,57,49,1.92
2020,CB2020,085,5,Staten Island,50029004008,249,119,130,4.74
2020,CB2020,085,5,Staten Island,50029004009,149,77,72,3.3
2020,CB2020,085,5,Staten Island,50029004010,73,42,31,1.55
2020,CB2020,085,5,Staten Island,50033001000,803,386,417,13.91
2020,CB2020,085,5,Staten Island,50033001001,132,67,65,1.43
2020,CB2020,085,5,Staten Island,50033001002,75,17,58,4.16
2020,CB2020,085,5,Staten Island,50033001003,68,41,27,2.96
2020,CB2020,085,5,Staten Island,50033001004,101,52,49,3.41
2020,CB2020,085,5,Staten Island,50033001005,174,86,88,10.19
2020,CB2020,085,5,Staten Island,50033001006,80,50,30,5.04
2020,CB2020,085,5,Staten Island,50033002000,526,281,245,15.72
2020,CB2020,085,5,Staten Island,50033002001,94,48,46,5.92
2020,CB2020,085,5,Staten Island,50033002002,31,26,5,2.44
2020,CB2020,085,5,Staten Island,50033002003,605,262,343,45.45
2020,CB2020,085,5,Staten Island,50033002004,41,28,13,1.09
2020,CB2020,085,5,Staten Island,50033002005,132,54,78,35.36
2020,CB2020,085,5,Staten Island,50033002006,368,175,193,21.45
2020,CB2020,085,5,Staten Island,50033002007,72,42,30,7.57
2020,CB2020,085,5,Staten Island,50033002008,73,36,37,9.14
2020,CB2020,085,5,Staten Island,50033002009,53,26,27,6.31
2020,CB2020,085,5,Staten Island,50033002010,214,91,123,10.41
2020,CB2020,085,5,Staten Island,50033002011,72,36,36,6.94
2020,CB2020,085,5,Staten Island,50033002012,24,12,12,1.77
2020,CB2020,085,5,Staten Island,50036001000,163,74,89,5.38
2020,CB2020,085,5,Staten Island,50036001001,135,64,71,7.89
2020,CB2020,085,5,Staten Island,50036001002,50,35,15,2.41
2020,CB2020,085,5,Staten Island,50036001003,74,37,37,1.55
2020,CB2020,085,5,Staten Island,50036001004,105,50,55,2.12
2020,CB2020,085,5,Staten Island,50036001005,116,57,59,3.16
2020,CB2020,085,5,Staten Island,50036001006,74,32,42,1.02
2020,CB2020,085,5,Staten Island,50036001007,65,42,23,1.49
2020,CB2020,085,5,Staten Island,50036001008,100,64,36,2.89
2020,CB2020,085,5,Staten Island,50036001009,335,184,151,21.73
2020,CB2020,085,5,Staten Island,50036001010,75,32,43,0.99
2020,CB2020,085,5,Staten Island,50036001011,149,70,79,3.47
2020,CB2020,085,5,Staten Island,50036001012,0,0,0,3.01
2020,CB2020,085,5,Staten Island,50036001013,0,0,0,2
2020,CB2020,085,5,Staten Island,50036001014,0,0,0,1.87
2020,CB2020,085,5,Staten Island,50036002000,317,136,181,9.05
2020,CB2020,085,5,Staten Island,50036002001,101,64,37,3.35
2020,CB2020,085,5,Staten Island,50036002002,55,28,27,2.44
2020,CB2020,085,5,Staten Island,50036002003,106,35,71,2.75
2020,CB2020,085,5,Staten Island,50036002004,181,88,93,5.53
2020,CB2020,085,5,Staten Island,50036002005,94,51,43,2.51
2020,CB2020,085,5,Staten Island,50036002006,205,90,115,4.42
2020,CB2020,085,5,Staten Island,50036002007,48,24,24,1.92
2020,CB2020,085,5,Staten Island,50036002008,94,46,48,2.96
2020,CB2020,085,5,Staten Island,50036002009,66,40,26,2.89
2020,CB2020,085,5,Staten Island,50036002010,60,32,28,1.58
2020,CB2020,085,5,Staten Island,50036002011,24,11,13,0.75
2020,CB2020,085,5,Staten Island,50039001000,484,239,245,10.78
2020,CB2020,085,5,Staten Island,50039001001,218,115,103,12.16
2020,CB2020,085,5,Staten Island,50039001002,0,0,0,14.6
2020,CB2020,085,5,Staten Island,50039002000,40,22,18,8.01
2020,CB2020,085,5,Staten Island,50039002001,40,19,21,3.73
2020,CB2020,085,5,Staten Island,50039002002,459,208,251,6.54
2020,CB2020,085,5,Staten Island,50039002003,703,346,357,52.37
2020,CB2020,085,5,Staten Island,50039002004,43,21,22,4.46
2020,CB2020,085,5,Staten Island,50039002005,44,19,25,4.53
2020,CB2020,085,5,Staten Island,50039002006,34,8,26,5.04
2020,CB2020,085,5,Staten Island,50039002007,80,14,66,18.89
2020,CB2020,085,5,Staten Island,50039002008,4,1,3,1.29
2020,CB2020,085,5,Staten Island,50039002009,30,20,10,1.68
2020,CB2020,085,5,Staten Island,50040011000,216,89,127,8.14
2020,CB2020,085,5,Staten Island,50040011001,113,50,63,4.48
2020,CB2020,085,5,Staten Island,50040011002,177,64,113,4.31
2020,CB2020,085,5,Staten Island,50040011003,121,78,43,2.14
2020,CB2020,085,5,Staten Island,50040011004,203,101,102,6.53
2020,CB2020,085,5,Staten Island,50040011005,71,45,26,2.07
2020,CB2020,085,5,Staten Island,50040011006,236,106,130,3.17
2020,CB2020,085,5,Staten Island,50040011007,117,58,59,1.92
2020,CB2020,085,5,Staten Island,50040011008,28,16,12,2.23
2020,CB2020,085,5,Staten Island,50040012000,116,54,62,2.48
2020,CB2020,085,5,Staten Island,50040012001,272,143,129,6.24
2020,CB2020,085,5,Staten Island,50040012002,131,73,58,3.57
2020,CB2020,085,5,Staten Island,50040012003,96,48,48,2.78
2020,CB2020,085,5,Staten Island,50040012004,175,78,97,4.24
2020,CB2020,085,5,Staten Island,50040012005,703,367,336,20
2020,CB2020,085,5,Staten Island,50040021000,229,115,114,8.92
2020,CB2020,085,5,Staten Island,50040021001,194,124,70,2.45
2020,CB2020,085,5,Staten Island,50040021002,643,296,347,14.32
2020,CB2020,085,5,Staten Island,50040021003,154,64,90,2.47
2020,CB2020,085,5,Staten Island,50040021004,199,98,101,23.29
2020,CB2020,085,5,Staten Island,50040022000,481,237,244,11.81
2020,CB2020,085,5,Staten Island,50040022001,106,67,39,1.65
2020,CB2020,085,5,Staten Island,50040022002,90,39,51,1.07
2020,CB2020,085,5,Staten Island,50040022003,85,30,55,0.91
2020,CB2020,085,5,Staten Island,50040022004,201,93,108,2.27
2020,CB2020,085,5,Staten Island,50040022005,128,70,58,2.28
2020,CB2020,085,5,Staten Island,50040022006,94,27,67,0.9
2020,CB2020,085,5,Staten Island,50040022007,0,0,0,0.27
2020,CB2020,085,5,Staten Island,50040022008,114,47,67,1.28
2020,CB2020,085,5,Staten Island,50040022009,165,62,103,1.98
2020,CB2020,085,5,Staten Island,50040022010,152,69,83,1.64
2020,CB2020,085,5,Staten Island,50040022011,161,110,51,2.44
2020,CB2020,085,5,Staten Island,50040022012,213,103,110,3.43
2020,CB2020,085,5,Staten Island,50040031000,1093,492,601,6.44
2020,CB2020,085,5,Staten Island,50040031001,659,264,395,3.94
2020,CB2020,085,5,Staten Island,50040032000,1326,563,763,6.93
2020,CB2020,085,5,Staten Island,50040033000,527,235,292,7.5
2020,CB2020,085,5,Staten Island,50040033001,810,315,495,4.63
2020,CB2020,085,5,Staten Island,50040033002,0,0,0,9.07
2020,CB2020,085,5,Staten Island,50040033003,175,95,80,3.11
2020,CB2020,085,5,Staten Island,50040033004,130,80,50,2.89
2020,CB2020,085,5,Staten Island,50040033005,131,46,85,3.79
2020,CB2020,085,5,Staten Island,50040041000,514,201,313,7.07
2020,CB2020,085,5,Staten Island,50040041001,135,100,35,3.39
2020,CB2020,085,5,Staten Island,50040041002,78,33,45,2.24
2020,CB2020,085,5,Staten Island,50040041003,121,55,66,2.33
2020,CB2020,085,5,Staten Island,50040041004,80,28,52,2.29
2020,CB2020,085,5,Staten Island,50040041005,88,45,43,2.28
2020,CB2020,085,5,Staten Island,50040041006,93,38,55,2.12
2020,CB2020,085,5,Staten Island,50040041007,0,0,0,5.05
2020,CB2020,085,5,Staten Island,50040041008,29,17,12,1.75
2020,CB2020,085,5,Staten Island,50040041009,37,11,26,1.55
2020,CB2020,085,5,Staten Island,50040041010,0,0,0,4.08
2020,CB2020,085,5,Staten Island,50040041011,0,0,0,0.59
2020,CB2020,085,5,Staten Island,50040041012,0,0,0,0.52
2020,CB2020,085,5,Staten Island,50040041013,0,0,0,0.57
2020,CB2020,085,5,Staten Island,50040041014,109,41,68,1.76
2020,CB2020,085,5,Staten Island,50040041015,39,25,14,0.42
2020,CB2020,085,5,Staten Island,50040041016,0,0,0,1.03
2020,CB2020,085,5,Staten Island,50040042000,83,35,48,6.54
2020,CB2020,085,5,Staten Island,50040042001,89,45,44,3.34
2020,CB2020,085,5,Staten Island,50040042002,83,44,39,3.19
2020,CB2020,085,5,Staten Island,50040042003,255,118,137,4.9
2020,CB2020,085,5,Staten Island,50040042004,84,50,34,3.24
2020,CB2020,085,5,Staten Island,50040042005,39,16,23,2.35
2020,CB2020,085,5,Staten Island,50040042006,63,35,28,2.14
2020,CB2020,085,5,Staten Island,50040042007,116,60,56,2.28
2020,CB2020,085,5,Staten Island,50040042008,95,51,44,2
2020,CB2020,085,5,Staten Island,50040042009,75,28,47,2.47
2020,CB2020,085,5,Staten Island,50040042010,96,46,50,2.75
2020,CB2020,085,5,Staten Island,50040042011,0,0,0,1.15
2020,CB2020,085,5,Staten Island,50040042012,80,38,42,2.2
2020,CB2020,085,5,Staten Island,50040042013,97,42,55,2.33
2020,CB2020,085,5,Staten Island,50040042014,151,75,76,2.49
2020,CB2020,085,5,Staten Island,50040042015,78,43,35,2.28
2020,CB2020,085,5,Staten Island,50040042016,0,0,0,0.63
2020,CB2020,085,5,Staten Island,50040042017,0,0,0,0.84
2020,CB2020,085,5,Staten Island,50040042018,0,0,0,1.44
2020,CB2020,085,5,Staten Island,50040042019,0,0,0,1.15
2020,CB2020,085,5,Staten Island,50047001000,0,0,0,7.05
2020,CB2020,085,5,Staten Island,50047001001,268,152,116,16.57
2020,CB2020,085,5,Staten Island,50047001002,151,63,88,17.53
2020,CB2020,085,5,Staten Island,50047001003,379,154,225,2.78
2020,CB2020,085,5,Staten Island,50047001004,12,7,5,23.24
2020,CB2020,085,5,Staten Island,50047001005,361,161,200,44.71
2020,CB2020,085,5,Staten Island,50047001006,48,16,32,2.51
2020,CB2020,085,5,Staten Island,50047001007,5,2,3,2.23
2020,CB2020,085,5,Staten Island,50047001008,50,12,38,1.73
2020,CB2020,085,5,Staten Island,50047001009,33,23,10,3.41
2020,CB2020,085,5,Staten Island,50047001010,110,49,61,5.12
2020,CB2020,085,5,Staten Island,50047001011,52,26,26,4.23
2020,CB2020,085,5,Staten Island,50047001012,132,45,87,5.65
2020,CB2020,085,5,Staten Island,50047001013,161,81,80,5.81
2020,CB2020,085,5,Staten Island,50047001014,0,0,0,4.14
2020,CB2020,085,5,Staten Island,50047001015,0,0,0,5.1
2020,CB2020,085,5,Staten Island,50047001016,54,32,22,1.5
2020,CB2020,085,5,Staten Island,50047001017,47,9,38,2.56
2020,CB2020,085,5,Staten Island,50047001018,58,28,30,9.27
2020,CB2020,085,5,Staten Island,50047001019,85,46,39,8.45
2020,CB2020,085,5,Staten Island,50047001020,0,0,0,1.71
2020,CB2020,085,5,Staten Island,50047001021,29,16,13,1.16
2020,CB2020,085,5,Staten Island,50047001022,80,59,21,2.58
2020,CB2020,085,5,Staten Island,50047001023,89,50,39,4.29
2020,CB2020,085,5,Staten Island,50047001024,22,11,11,1.81
2020,CB2020,085,5,Staten Island,50047001025,31,7,24,1.22
2020,CB2020,085,5,Staten Island,50047002000,78,47,31,3.92
2020,CB2020,085,5,Staten Island,50047002001,83,35,48,4.32
2020,CB2020,085,5,Staten Island,50047002002,114,47,67,4.89
2020,CB2020,085,5,Staten Island,50047002003,62,43,19,2.62
2020,CB2020,085,5,Staten Island,50047002004,98,40,58,3.46
2020,CB2020,085,5,Staten Island,50047002005,92,42,50,3.72
2020,CB2020,085,5,Staten Island,50047002006,147,79,68,5.31
2020,CB2020,085,5,Staten Island,50047002007,0,0,0,4.36
2020,CB2020,085,5,Staten Island,50047002008,195,75,120,2.39
2020,CB2020,085,5,Staten Island,50050001000,89,24,65,3.16
2020,CB2020,085,5,Staten Island,50050001001,40,23,17,3.07
2020,CB2020,085,5,Staten Island,50050001002,86,36,50,2.62
2020,CB2020,085,5,Staten Island,50050001003,132,69,63,3.18
2020,CB2020,085,5,Staten Island,50050001004,286,132,154,10.16
2020,CB2020,085,5,Staten Island,50050001005,120,62,58,2.34
2020,CB2020,085,5,Staten Island,50050001006,312,162,150,7.13
2020,CB2020,085,5,Staten Island,50050001007,212,103,109,8.78
2020,CB2020,085,5,Staten Island,50050001008,85,38,47,7.06
2020,CB2020,085,5,Staten Island,50050001009,69,35,34,1.87
2020,CB2020,085,5,Staten Island,50050001010,239,115,124,7.71
2020,CB2020,085,5,Staten Island,50050001011,107,43,64,3.34
2020,CB2020,085,5,Staten Island,50050001012,92,48,44,2.28
2020,CB2020,085,5,Staten Island,50050001013,85,51,34,2.27
2020,CB2020,085,5,Staten Island,50050001014,13,1,12,3.19
2020,CB2020,085,5,Staten Island,50050001015,71,48,23,3.57
2020,CB2020,085,5,Staten Island,50050002000,0,0,0,4.57
2020,CB2020,085,5,Staten Island,50050002001,49,25,24,1.29
2020,CB2020,085,5,Staten Island,50050002002,19,16,3,1.01
2020,CB2020,085,5,Staten Island,50050002003,0,0,0,2.67
2020,CB2020,085,5,Staten Island,50050002004,165,95,70,4.11
2020,CB2020,085,5,Staten Island,50050002005,17,8,9,4.26
2020,CB2020,085,5,Staten Island,50050002006,80,45,35,3.54
2020,CB2020,085,5,Staten Island,50050002007,0,0,0,0.7
2020,CB2020,085,5,Staten Island,50050002008,104,49,55,4.1
2020,CB2020,085,5,Staten Island,50050002009,111,58,53,3.73
2020,CB2020,085,5,Staten Island,50050002010,596,260,336,14.52
2020,CB2020,085,5,Staten Island,50050002011,65,26,39,1.54
2020,CB2020,085,5,Staten Island,50050002012,59,23,36,1.85
2020,CB2020,085,5,Staten Island,50050002013,0,0,0,1.45
2020,CB2020,085,5,Staten Island,50050002014,90,44,46,2.09
2020,CB2020,085,5,Staten Island,50050002015,36,10,26,2.36
2020,CB2020,085,5,Staten Island,50050003000,0,0,0,2.69
2020,CB2020,085,5,Staten Island,50050003001,228,128,100,34.54
2020,CB2020,085,5,Staten Island,50050003002,51,25,26,2.57
2020,CB2020,085,5,Staten Island,50050003003,48,22,26,1.15
2020,CB2020,085,5,Staten Island,50050003004,0,0,0,6.59
2020,CB2020,085,5,Staten Island,50050003005,25,2,23,0.73
2020,CB2020,085,5,Staten Island,50050003006,30,18,12,1.07
2020,CB2020,085,5,Staten Island,50050003007,72,32,40,1.75
2020,CB2020,085,5,Staten Island,50050003008,150,65,85,5.27
2020,CB2020,085,5,Staten Island,50050003009,37,13,24,2.59
2020,CB2020,085,5,Staten Island,50050003010,85,16,69,6.07
2020,CB2020,085,5,Staten Island,50050003011,104,58,46,2.2
2020,CB2020,085,5,Staten Island,50050003012,58,20,38,1.58
2020,CB2020,085,5,Staten Island,50050003013,40,25,15,1.51
2020,CB2020,085,5,Staten Island,50059011000,207,114,93,6.31
2020,CB2020,085,5,Staten Island,50059011001,176,65,111,6.35
2020,CB2020,085,5,Staten Island,50059011002,185,92,93,7.08
2020,CB2020,085,5,Staten Island,50059011003,354,174,180,17.86
2020,CB2020,085,5,Staten Island,50059011004,54,34,20,1.87
2020,CB2020,085,5,Staten Island,50059011005,38,21,17,1.42
2020,CB2020,085,5,Staten Island,50059011006,32,20,12,1.4
2020,CB2020,085,5,Staten Island,50059011007,37,5,32,1.99
2020,CB2020,085,5,Staten Island,50059011008,25,8,17,1.99
2020,CB2020,085,5,Staten Island,50059011009,19,12,7,1.38
2020,CB2020,085,5,Staten Island,50059012000,750,359,391,127.91
2020,CB2020,085,5,Staten Island,50059012001,0,0,0,4.1
2020,CB2020,085,5,Staten Island,50059012002,23,6,17,1.55
2020,CB2020,085,5,Staten Island,50059012003,26,12,14,1.31
2020,CB2020,085,5,Staten Island,50059012004,130,61,69,8.62
2020,CB2020,085,5,Staten Island,50059012005,55,28,27,1.36
2020,CB2020,085,5,Staten Island,50059012006,82,46,36,3.84
2020,CB2020,085,5,Staten Island,50059012007,30,17,13,1.78
2020,CB2020,085,5,Staten Island,50059012008,268,144,124,13.51
2020,CB2020,085,5,Staten Island,50059012009,141,39,102,9.27
2020,CB2020,085,5,Staten Island,50059012010,120,48,72,4.13
2020,CB2020,085,5,Staten Island,50059012011,22,13,9,2.04
2020,CB2020,085,5,Staten Island,50059012012,23,11,12,1.82
2020,CB2020,085,5,Staten Island,50059012013,39,15,24,1.21
2020,CB2020,085,5,Staten Island,50059012014,18,7,11,1.41
2020,CB2020,085,5,Staten Island,50059021000,5,4,1,111.22
2020,CB2020,085,5,Staten Island,50064001000,82,44,38,4.53
2020,CB2020,085,5,Staten Island,50064001001,65,28,37,12.66
2020,CB2020,085,5,Staten Island,50064001002,49,26,23,2.85
2020,CB2020,085,5,Staten Island,50064001003,21,11,10,2.37
2020,CB2020,085,5,Staten Island,50064001004,40,24,16,2.81
2020,CB2020,085,5,Staten Island,50064001005,61,21,40,4.23
2020,CB2020,085,5,Staten Island,50064001006,55,38,17,3.13
2020,CB2020,085,5,Staten Island,50064001007,39,18,21,2.21
2020,CB2020,085,5,Staten Island,50064001008,50,14,36,3.24
2020,CB2020,085,5,Staten Island,50064001009,207,96,111,12.95
2020,CB2020,085,5,Staten Island,50064001010,76,26,50,4.38
2020,CB2020,085,5,Staten Island,50064002000,40,16,24,3.31
2020,CB2020,085,5,Staten Island,50064002001,95,32,63,3.52
2020,CB2020,085,5,Staten Island,50064002002,128,58,70,4.21
2020,CB2020,085,5,Staten Island,50064002003,101,64,37,4.37
2020,CB2020,085,5,Staten Island,50064002004,132,53,79,5.56
2020,CB2020,085,5,Staten Island,50064002005,95,52,43,6.3
2020,CB2020,085,5,Staten Island,50064002006,148,92,56,3.28
2020,CB2020,085,5,Staten Island,50064002007,84,42,42,5.97
2020,CB2020,085,5,Staten Island,50064003000,85,55,30,3.44
2020,CB2020,085,5,Staten Island,50064003001,104,42,62,4.54
2020,CB2020,085,5,Staten Island,50064003002,149,74,75,5.07
2020,CB2020,085,5,Staten Island,50064003003,41,16,25,2.67
2020,CB2020,085,5,Staten Island,50064003004,157,76,81,12.12
2020,CB2020,085,5,Staten Island,50064003005,70,26,44,9.12
2020,CB2020,085,5,Staten Island,50064003006,224,111,113,6.05
2020,CB2020,085,5,Staten Island,50064003007,936,376,560,21.66
2020,CB2020,085,5,Staten Island,50064003008,24,18,6,0.27
2020,CB2020,085,5,Staten Island,50064003009,26,13,13,9.55
2020,CB2020,085,5,Staten Island,50064003010,125,69,56,4.02
2020,CB2020,085,5,Staten Island,50064003011,91,46,45,2.53
2020,CB2020,085,5,Staten Island,50064003012,98,39,59,2.45
2020,CB2020,085,5,Staten Island,50067001000,176,76,100,90.04
2020,CB2020,085,5,Staten Island,50067001001,96,52,44,5.39
2020,CB2020,085,5,Staten Island,50067001002,27,14,13,2.13
2020,CB2020,085,5,Staten Island,50067001003,27,4,23,2.3
2020,CB2020,085,5,Staten Island,50067001004,36,18,18,2.53
2020,CB2020,085,5,Staten Island,50067001005,123,64,59,5.38
2020,CB2020,085,5,Staten Island,50067001006,58,41,17,3.92
2020,CB2020,085,5,Staten Island,50067001007,62,22,40,3.95
2020,CB2020,085,5,Staten Island,50067001008,61,26,35,4.34
2020,CB2020,085,5,Staten Island,50067001009,78,49,29,3.28
2020,CB2020,085,5,Staten Island,50067001010,345,209,136,25.59
2020,CB2020,085,5,Staten Island,50067002000,154,72,82,9.09
2020,CB2020,085,5,Staten Island,50067002001,132,50,82,5.67
2020,CB2020,085,5,Staten Island,50067002002,96,51,45,3.48
2020,CB2020,085,5,Staten Island,50067002003,61,34,27,2.69
2020,CB2020,085,5,Staten Island,50067002004,75,47,28,3.54
2020,CB2020,085,5,Staten Island,50067002005,90,36,54,3.41
2020,CB2020,085,5,Staten Island,50067002006,39,8,31,2.78
2020,CB2020,085,5,Staten Island,50067002007,31,20,11,1.93
2020,CB2020,085,5,Staten Island,50067002008,48,24,24,2.16
2020,CB2020,085,5,Staten Island,50067002009,39,25,14,2.99
2020,CB2020,085,5,Staten Island,50067002010,53,19,34,2.03
2020,CB2020,085,5,Staten Island,50067002011,82,38,44,2.34
2020,CB2020,085,5,Staten Island,50067002012,61,40,21,1.33
2020,CB2020,085,5,Staten Island,50067002013,32,9,23,1.88
2020,CB2020,085,5,Staten Island,50067003000,143,59,84,4.99
2020,CB2020,085,5,Staten Island,50067003001,138,70,68,5.45
2020,CB2020,085,5,Staten Island,50067003002,41,18,23,2.27
2020,CB2020,085,5,Staten Island,50067003003,49,26,23,3.56
2020,CB2020,085,5,Staten Island,50067003004,64,16,48,2.63
2020,CB2020,085,5,Staten Island,50067003005,55,18,37,2.15
2020,CB2020,085,5,Staten Island,50067003006,72,37,35,3.78
2020,CB2020,085,5,Staten Island,50067003007,77,49,28,2.64
2020,CB2020,085,5,Staten Island,50067003008,61,29,32,2.71
2020,CB2020,085,5,Staten Island,50067003009,86,37,49,3.7
2020,CB2020,085,5,Staten Island,50067003010,39,26,13,4.06
2020,CB2020,085,5,Staten Island,50067003011,20,11,9,2.86
2020,CB2020,085,5,Staten Island,50070011000,79,46,33,3.65
2020,CB2020,085,5,Staten Island,50070011001,68,24,44,3.36
2020,CB2020,085,5,Staten Island,50070011002,55,46,9,3.27
2020,CB2020,085,5,Staten Island,50070011003,0,0,0,3.24
2020,CB2020,085,5,Staten Island,50070011004,162,72,90,3.43
2020,CB2020,085,5,Staten Island,50070011005,81,40,41,3.8
2020,CB2020,085,5,Staten Island,50070011006,72,26,46,3.44
2020,CB2020,085,5,Staten Island,50070011007,107,37,70,3.51
2020,CB2020,085,5,Staten Island,50070011008,83,20,63,3.68
2020,CB2020,085,5,Staten Island,50070011009,53,24,29,3.27
2020,CB2020,085,5,Staten Island,50070011010,64,48,16,4.74
2020,CB2020,085,5,Staten Island,50070011011,69,48,21,3.31
2020,CB2020,085,5,Staten Island,50070011012,43,20,23,1.58
2020,CB2020,085,5,Staten Island,50070011013,17,9,8,2.05
2020,CB2020,085,5,Staten Island,50070011014,96,33,63,5.7
2020,CB2020,085,5,Staten Island,50070011015,99,31,68,4.08
2020,CB2020,085,5,Staten Island,50070011016,104,60,44,3.52
2020,CB2020,085,5,Staten Island,50070011017,116,80,36,5.1
2020,CB2020,085,5,Staten Island,50070012000,98,46,52,3.82
2020,CB2020,085,5,Staten Island,50070012001,86,30,56,3.84
2020,CB2020,085,5,Staten Island,50070012002,85,61,24,4.22
2020,CB2020,085,5,Staten Island,50070012003,66,19,47,4.73
2020,CB2020,085,5,Staten Island,50070012004,116,57,59,4.29
2020,CB2020,085,5,Staten Island,50070012005,115,58,57,4.55
2020,CB2020,085,5,Staten Island,50070012006,143,69,74,5.14
2020,CB2020,085,5,Staten Island,50070012007,58,31,27,2.34
2020,CB2020,085,5,Staten Island,50070012008,83,48,35,3.34
2020,CB2020,085,5,Staten Island,50070012009,77,23,54,2.73
2020,CB2020,085,5,Staten Island,50070012010,26,23,3,2.46
2020,CB2020,085,5,Staten Island,50070012011,37,33,4,1.92
2020,CB2020,085,5,Staten Island,50070012012,59,11,48,2.33
2020,CB2020,085,5,Staten Island,50070012013,115,48,67,2.95
2020,CB2020,085,5,Staten Island,50070012014,102,29,73,3.59
2020,CB2020,085,5,Staten Island,50070020001,0,0,0,0
2020,CB2020,085,5,Staten Island,50070020002,0,0,0,0
2020,CB2020,085,5,Staten Island,50070021000,106,65,41,2.75
2020,CB2020,085,5,Staten Island,50070021001,94,40,54,2.84
2020,CB2020,085,5,Staten Island,50070021002,233,86,147,5.28
2020,CB2020,085,5,Staten Island,50070021003,75,48,27,2.17
2020,CB2020,085,5,Staten Island,50070021004,116,49,67,2.68
2020,CB2020,085,5,Staten Island,50070021005,174,92,82,4.07
2020,CB2020,085,5,Staten Island,50070021006,140,57,83,4.23
2020,CB2020,085,5,Staten Island,50070021007,100,60,40,2.95
2020,CB2020,085,5,Staten Island,50070021008,222,134,88,7.65
2020,CB2020,085,5,Staten Island,50070021009,83,40,43,1.92
2020,CB2020,085,5,Staten Island,50070021010,59,27,32,1.22
2020,CB2020,085,5,Staten Island,50070021011,154,81,73,9.96
2020,CB2020,085,5,Staten Island,50070021012,28,10,18,1.45
2020,CB2020,085,5,Staten Island,50070021013,63,28,35,1.63
2020,CB2020,085,5,Staten Island,50070021014,214,136,78,5.79
2020,CB2020,085,5,Staten Island,50070022000,104,31,73,4.3
2020,CB2020,085,5,Staten Island,50070022001,122,60,62,4.38
2020,CB2020,085,5,Staten Island,50070022002,98,46,52,4.57
2020,CB2020,085,5,Staten Island,50070022003,117,48,69,4.57
2020,CB2020,085,5,Staten Island,50070022004,156,72,84,4.53
2020,CB2020,085,5,Staten Island,50070022005,86,54,32,3.44
2020,CB2020,085,5,Staten Island,50070022006,110,54,56,3.11
2020,CB2020,085,5,Staten Island,50070022007,270,129,141,6.18
2020,CB2020,085,5,Staten Island,50070022008,247,133,114,5.95
2020,CB2020,085,5,Staten Island,50070022009,127,60,67,3.69
2020,CB2020,085,5,Staten Island,50070022010,128,64,64,3.89
2020,CB2020,085,5,Staten Island,50070022011,136,77,59,3.73
2020,CB2020,085,5,Staten Island,50070022012,249,129,120,5.43
2020,CB2020,085,5,Staten Island,50070022013,282,145,137,5.45
2020,CB2020,085,5,Staten Island,50070022014,281,154,127,5.43
2020,CB2020,085,5,Staten Island,50070022015,55,39,16,2.5
2020,CB2020,085,5,Staten Island,50070022016,219,114,105,7.91
2020,CB2020,085,5,Staten Island,50070022017,0,0,0,0.28
2020,CB2020,085,5,Staten Island,50070022018,0,0,0,1.42
2020,CB2020,085,5,Staten Island,50070022019,127,65,62,3.01
2020,CB2020,085,5,Staten Island,50070022020,100,22,78,2.98
2020,CB2020,085,5,Staten Island,50070022021,124,54,70,3.51
2020,CB2020,085,5,Staten Island,50070022022,0,0,0,0.56
2020,CB2020,085,5,Staten Island,50070023000,468,227,241,60.87
2020,CB2020,085,5,Staten Island,50070023001,203,112,91,4.19
2020,CB2020,085,5,Staten Island,50070023002,182,87,95,3.88
2020,CB2020,085,5,Staten Island,50070023003,363,242,121,250.57
2020,CB2020,085,5,Staten Island,50070024000,0,0,0,0.61
2020,CB2020,085,5,Staten Island,50070024001,0,0,0,29.6
2020,CB2020,085,5,Staten Island,50070024002,0,0,0,38.31
2020,CB2020,085,5,Staten Island,50074000001,0,0,0,0
2020,CB2020,085,5,Staten Island,50074000002,0,0,0,0
2020,CB2020,085,5,Staten Island,50074001000,145,100,45,2.52
2020,CB2020,085,5,Staten Island,50074001001,53,42,11,1.46
2020,CB2020,085,5,Staten Island,50074001002,133,62,71,3.14
2020,CB2020,085,5,Staten Island,50074001003,153,64,89,3.34
2020,CB2020,085,5,Staten Island,50074001004,55,39,16,1.7
2020,CB2020,085,5,Staten Island,50074001005,129,60,69,3.06
2020,CB2020,085,5,Staten Island,50074001006,201,100,101,3.41
2020,CB2020,085,5,Staten Island,50074001007,317,167,150,6.55
2020,CB2020,085,5,Staten Island,50074001008,227,115,112,6.19
2020,CB2020,085,5,Staten Island,50074001009,284,136,148,7.25
2020,CB2020,085,5,Staten Island,50074001010,156,75,81,2.74
2020,CB2020,085,5,Staten Island,50074001011,172,87,85,4.3
2020,CB2020,085,5,Staten Island,50074001012,148,70,78,4.23
2020,CB2020,085,5,Staten Island,50074001013,191,84,107,4.29
2020,CB2020,085,5,Staten Island,50074002000,331,182,149,9.67
2020,CB2020,085,5,Staten Island,50074002001,99,63,36,2.53
2020,CB2020,085,5,Staten Island,50074002002,623,257,366,6.45
2020,CB2020,085,5,Staten Island,50074002003,0,0,0,0.42
2020,CB2020,085,5,Staten Island,50074002004,59,29,30,2.12
2020,CB2020,085,5,Staten Island,50074002005,211,126,85,2.81
2020,CB2020,085,5,Staten Island,50074002006,115,46,69,2.55
2020,CB2020,085,5,Staten Island,50074002007,378,163,215,6.62
2020,CB2020,085,5,Staten Island,50074002008,59,12,47,0.76
2020,CB2020,085,5,Staten Island,50074002009,402,188,214,8.25
2020,CB2020,085,5,Staten Island,50074002010,20,7,13,0.73
2020,CB2020,085,5,Staten Island,50074002011,61,44,17,1.46
2020,CB2020,085,5,Staten Island,50074002012,55,29,26,0.84
2020,CB2020,085,5,Staten Island,50074002013,28,12,16,1.04
2020,CB2020,085,5,Staten Island,50074002014,56,33,23,2.72
2020,CB2020,085,5,Staten Island,50074002015,96,61,35,2.44
2020,CB2020,085,5,Staten Island,50074003000,5,5,0,17.57
2020,CB2020,085,5,Staten Island,50074003001,0,0,0,10.56
2020,CB2020,085,5,Staten Island,50075001000,169,92,77,9.22
2020,CB2020,085,5,Staten Island,50075001001,235,122,113,4.04
2020,CB2020,085,5,Staten Island,50075001002,42,38,4,2.4
2020,CB2020,085,5,Staten Island,50075001003,285,139,146,10.05
2020,CB2020,085,5,Staten Island,50075001004,266,114,152,6.5
2020,CB2020,085,5,Staten Island,50075002000,494,242,252,8.23
2020,CB2020,085,5,Staten Island,50075002001,360,175,185,6.51
2020,CB2020,085,5,Staten Island,50075002002,119,68,51,4.57
2020,CB2020,085,5,Staten Island,50075002003,163,86,77,5.47
2020,CB2020,085,5,Staten Island,50075002004,61,26,35,5.68
2020,CB2020,085,5,Staten Island,50075002005,117,48,69,4.48
2020,CB2020,085,5,Staten Island,50075003000,252,124,128,12.38
2020,CB2020,085,5,Staten Island,50075003001,134,66,68,3.98
2020,CB2020,085,5,Staten Island,50075003002,183,88,95,5.64
2020,CB2020,085,5,Staten Island,50075003003,115,87,28,2.78
2020,CB2020,085,5,Staten Island,50075003004,419,292,127,6.99
2020,CB2020,085,5,Staten Island,50075003005,0,0,0,1.34
2020,CB2020,085,5,Staten Island,50075003006,197,88,109,6.19
2020,CB2020,085,5,Staten Island,50075003007,209,100,109,3.04
2020,CB2020,085,5,Staten Island,50075003008,265,106,159,3.06
2020,CB2020,085,5,Staten Island,50075003009,115,51,64,6.21
2020,CB2020,085,5,Staten Island,50077001000,219,103,116,4.93
2020,CB2020,085,5,Staten Island,50077001001,515,252,263,34.7
2020,CB2020,085,5,Staten Island,50077001002,80,52,28,2.41
2020,CB2020,085,5,Staten Island,50077001003,128,59,69,2.39
2020,CB2020,085,5,Staten Island,50077001004,108,43,65,2.64
2020,CB2020,085,5,Staten Island,50077001005,93,36,57,3.89
2020,CB2020,085,5,Staten Island,50077001006,155,52,103,2.33
2020,CB2020,085,5,Staten Island,50077001007,150,76,74,2.1
2020,CB2020,085,5,Staten Island,50077001008,211,114,97,2.37
2020,CB2020,085,5,Staten Island,50077001009,103,46,57,3.65
2020,CB2020,085,5,Staten Island,50081000001,0,0,0,0
2020,CB2020,085,5,Staten Island,50081001000,0,0,0,26.93
2020,CB2020,085,5,Staten Island,50081001001,110,40,70,5.44
2020,CB2020,085,5,Staten Island,50081001002,120,58,62,5.26
2020,CB2020,085,5,Staten Island,50081001003,345,202,143,10.92
2020,CB2020,085,5,Staten Island,50081001004,606,224,382,9.41
2020,CB2020,085,5,Staten Island,50081001005,122,61,61,4.41
2020,CB2020,085,5,Staten Island,50081001006,95,35,60,4.31
2020,CB2020,085,5,Staten Island,50081001007,140,69,71,4.46
2020,CB2020,085,5,Staten Island,50081001008,83,48,35,4.13
2020,CB2020,085,5,Staten Island,50081001009,48,25,23,2.58
2020,CB2020,085,5,Staten Island,50081002000,262,117,145,9.84
2020,CB2020,085,5,Staten Island,50081002001,196,101,95,3.69
2020,CB2020,085,5,Staten Island,50081002002,156,72,84,9.82
2020,CB2020,085,5,Staten Island,50081002003,60,34,26,4.98
2020,CB2020,085,5,Staten Island,50081002004,48,27,21,2.54
2020,CB2020,085,5,Staten Island,50081002005,577,320,257,7.85
2020,CB2020,085,5,Staten Island,50081002006,62,23,39,3.08
2020,CB2020,085,5,Staten Island,50081002007,89,39,50,4.17
2020,CB2020,085,5,Staten Island,50081002008,46,20,26,4.58
2020,CB2020,085,5,Staten Island,50081003000,279,145,134,10.15
2020,CB2020,085,5,Staten Island,50081003001,110,88,22,6.59
2020,CB2020,085,5,Staten Island,50081003002,96,46,50,2.9
2020,CB2020,085,5,Staten Island,50081003003,201,85,116,3.52
2020,CB2020,085,5,Staten Island,50081003004,243,110,133,11.46
2020,CB2020,085,5,Staten Island,50081003005,72,25,47,2.19
2020,CB2020,085,5,Staten Island,50081003006,157,81,76,6.37
2020,CB2020,085,5,Staten Island,50081003007,86,49,37,1.08
2020,CB2020,085,5,Staten Island,50081003008,84,34,50,7.62
2020,CB2020,085,5,Staten Island,50081003009,77,23,54,6.64
2020,CB2020,085,5,Staten Island,50081003010,103,39,64,5.82
2020,CB2020,085,5,Staten Island,50081003011,99,53,46,3.18
2020,CB2020,085,5,Staten Island,50081003012,50,27,23,3.42
2020,CB2020,085,5,Staten Island,50096011000,252,154,98,14.67
2020,CB2020,085,5,Staten Island,50096011001,25,19,6,0.7
2020,CB2020,085,5,Staten Island,50096011002,29,14,15,1.26
2020,CB2020,085,5,Staten Island,50096011003,129,68,61,15.92
2020,CB2020,085,5,Staten Island,50096011004,143,74,69,6.43
2020,CB2020,085,5,Staten Island,50096011005,102,62,40,3.44
2020,CB2020,085,5,Staten Island,50096011006,90,24,66,5.49
2020,CB2020,085,5,Staten Island,50096011007,288,131,157,14.12
2020,CB2020,085,5,Staten Island,50096011008,96,39,57,5.71
2020,CB2020,085,5,Staten Island,50096011009,60,22,38,4.1
2020,CB2020,085,5,Staten Island,50096011010,85,36,49,4.37
2020,CB2020,085,5,Staten Island,50096011011,194,98,96,19.67
2020,CB2020,085,5,Staten Island,50096011012,20,4,16,0.86
2020,CB2020,085,5,Staten Island,50096011013,73,59,14,3.09
2020,CB2020,085,5,Staten Island,50096011014,123,53,70,3.16
2020,CB2020,085,5,Staten Island,50096011015,36,12,24,2.72
2020,CB2020,085,5,Staten Island,50096011016,16,6,10,2.41
2020,CB2020,085,5,Staten Island,50096012000,56,32,24,2.94
2020,CB2020,085,5,Staten Island,50096012001,169,64,105,7.21
2020,CB2020,085,5,Staten Island,50096012002,404,116,288,12.39
2020,CB2020,085,5,Staten Island,50096012003,70,29,41,1.49
2020,CB2020,085,5,Staten Island,50096012004,111,36,75,3.86
2020,CB2020,085,5,Staten Island,50096012005,51,33,18,1.98
2020,CB2020,085,5,Staten Island,50096012006,241,109,132,7.63
2020,CB2020,085,5,Staten Island,50096012007,334,145,189,11.95
2020,CB2020,085,5,Staten Island,50096012008,78,59,19,2.72
2020,CB2020,085,5,Staten Island,50096012009,34,20,14,1.85
2020,CB2020,085,5,Staten Island,50096012010,64,25,39,1.9
2020,CB2020,085,5,Staten Island,50096012011,80,47,33,1.57
2020,CB2020,085,5,Staten Island,50096012012,50,29,21,2.25
2020,CB2020,085,5,Staten Island,50096012013,85,51,34,3.1
2020,CB2020,085,5,Staten Island,50096012014,157,77,80,5.18
2020,CB2020,085,5,Staten Island,50096012015,92,54,38,3.5
2020,CB2020,085,5,Staten Island,50096012016,69,55,14,2.81
2020,CB2020,085,5,Staten Island,50096012017,31,6,25,2.25
2020,CB2020,085,5,Staten Island,50096012018,38,21,17,2.25
2020,CB2020,085,5,Staten Island,50096012019,0,0,0,0.89
2020,CB2020,085,5,Staten Island,50096012020,100,46,54,3.99
2020,CB2020,085,5,Staten Island,50096021000,81,41,40,4.03
2020,CB2020,085,5,Staten Island,50096021001,95,48,47,3.8
2020,CB2020,085,5,Staten Island,50096021002,103,51,52,3.54
2020,CB2020,085,5,Staten Island,50096021003,59,42,17,4.23
2020,CB2020,085,5,Staten Island,50096021004,71,36,35,2.3
2020,CB2020,085,5,Staten Island,50096021005,58,41,17,3.67
2020,CB2020,085,5,Staten Island,50096021006,68,18,50,3.67
2020,CB2020,085,5,Staten Island,50096021007,83,33,50,2.62
2020,CB2020,085,5,Staten Island,50096021008,72,37,35,3.27
2020,CB2020,085,5,Staten Island,50096021009,123,68,55,5.28
2020,CB2020,085,5,Staten Island,50096021010,136,61,75,4.05
2020,CB2020,085,5,Staten Island,50096021011,109,34,75,5.37
2020,CB2020,085,5,Staten Island,50096021012,85,32,53,3.64
2020,CB2020,085,5,Staten Island,50096021013,89,56,33,3.63
2020,CB2020,085,5,Staten Island,50096022000,20,5,15,1.13
2020,CB2020,085,5,Staten Island,50096022001,0,0,0,1.12
2020,CB2020,085,5,Staten Island,50096022002,108,46,62,3.85
2020,CB2020,085,5,Staten Island,50096022003,87,45,42,3.43
2020,CB2020,085,5,Staten Island,50096022004,43,15,28,1.79
2020,CB2020,085,5,Staten Island,50096022005,112,52,60,4.24
2020,CB2020,085,5,Staten Island,50096022006,184,93,91,3.52
2020,CB2020,085,5,Staten Island,50096022007,0,0,0,0.68
2020,CB2020,085,5,Staten Island,50096022008,199,99,100,4.85
2020,CB2020,085,5,Staten Island,50096022009,134,57,77,4.12
2020,CB2020,085,5,Staten Island,50096022010,149,82,67,3.14
2020,CB2020,085,5,Staten Island,50096022011,81,32,49,3.67
2020,CB2020,085,5,Staten Island,50096022012,79,46,33,2.88
2020,CB2020,085,5,Staten Island,50096022013,65,45,20,3.07
2020,CB2020,085,5,Staten Island,50096023000,187,94,93,6.92
2020,CB2020,085,5,Staten Island,50096023001,186,72,114,7.44
2020,CB2020,085,5,Staten Island,50096023002,154,68,86,7.88
2020,CB2020,085,5,Staten Island,50096023003,93,73,20,8.21
2020,CB2020,085,5,Staten Island,50096023004,116,68,48,5.15
2020,CB2020,085,5,Staten Island,50096023005,86,38,48,5.17
2020,CB2020,085,5,Staten Island,50096023006,295,144,151,6.81
2020,CB2020,085,5,Staten Island,50096023007,120,60,60,4.2
2020,CB2020,085,5,Staten Island,50096023008,10,5,5,3.44
2020,CB2020,085,5,Staten Island,50096023009,27,20,7,2.82
2020,CB2020,085,5,Staten Island,50097010001,0,0,0,0
2020,CB2020,085,5,Staten Island,50097011000,7,4,3,34.5
2020,CB2020,085,5,Staten Island,50097011001,550,264,286,11.47
2020,CB2020,085,5,Staten Island,50097011002,477,223,254,13.65
2020,CB2020,085,5,Staten Island,50097011003,604,240,364,9.45
2020,CB2020,085,5,Staten Island,50097011004,125,62,63,2.32
2020,CB2020,085,5,Staten Island,50097011005,92,53,39,1.09
2020,CB2020,085,5,Staten Island,50097011006,92,49,43,1.07
2020,CB2020,085,5,Staten Island,50097011007,95,28,67,1.43
2020,CB2020,085,5,Staten Island,50097012000,412,192,220,19.92
2020,CB2020,085,5,Staten Island,50097012001,24,14,10,0.91
2020,CB2020,085,5,Staten Island,50097012002,128,76,52,3.9
2020,CB2020,085,5,Staten Island,50097012003,117,71,46,4.68
2020,CB2020,085,5,Staten Island,50097012004,548,223,325,17.08
2020,CB2020,085,5,Staten Island,50097013000,0,0,0,12.86
2020,CB2020,085,5,Staten Island,50097013001,90,53,37,4.84
2020,CB2020,085,5,Staten Island,50097013002,44,25,19,2.86
2020,CB2020,085,5,Staten Island,50097013003,100,45,55,4.35
2020,CB2020,085,5,Staten Island,50097013004,43,19,24,7.01
2020,CB2020,085,5,Staten Island,50097013005,388,182,206,13.06
2020,CB2020,085,5,Staten Island,50097013006,143,86,57,9.18
2020,CB2020,085,5,Staten Island,50097013007,65,22,43,3.65
2020,CB2020,085,5,Staten Island,50097013008,67,35,32,3.87
2020,CB2020,085,5,Staten Island,50097013009,45,25,20,3.87
2020,CB2020,085,5,Staten Island,50097013010,106,35,71,5.89
2020,CB2020,085,5,Staten Island,50097013011,92,29,63,3.73
2020,CB2020,085,5,Staten Island,50097020001,0,0,0,0
2020,CB2020,085,5,Staten Island,50097021000,0,0,0,7.67
2020,CB2020,085,5,Staten Island,50097021001,8,4,4,77.28
2020,CB2020,085,5,Staten Island,50097021002,0,0,0,5.86
2020,CB2020,085,5,Staten Island,50105001000,78,20,58,6.63
2020,CB2020,085,5,Staten Island,50105001001,367,176,191,9.49
2020,CB2020,085,5,Staten Island,50105001002,202,105,97,6.57
2020,CB2020,085,5,Staten Island,50105001003,18,13,5,4.85
2020,CB2020,085,5,Staten Island,50105001004,58,13,45,4
2020,CB2020,085,5,Staten Island,50105001005,88,44,44,3.99
2020,CB2020,085,5,Staten Island,50105002000,115,48,67,5.48
2020,CB2020,085,5,Staten Island,50105002001,104,44,60,5.89
2020,CB2020,085,5,Staten Island,50105002002,125,69,56,4.22
2020,CB2020,085,5,Staten Island,50105002003,126,68,58,4.86
2020,CB2020,085,5,Staten Island,50105002004,59,35,24,4.25
2020,CB2020,085,5,Staten Island,50105002005,75,31,44,2.28
2020,CB2020,085,5,Staten Island,50105002006,70,32,38,2.3
2020,CB2020,085,5,Staten Island,50105002007,54,18,36,3.88
2020,CB2020,085,5,Staten Island,50105002008,71,38,33,4.16
2020,CB2020,085,5,Staten Island,50105003000,229,119,110,10.5
2020,CB2020,085,5,Staten Island,50105003001,188,89,99,8.79
2020,CB2020,085,5,Staten Island,50105003002,360,197,163,9.91
2020,CB2020,085,5,Staten Island,50105003003,45,12,33,2.4
2020,CB2020,085,5,Staten Island,50105003004,62,26,36,2.37
2020,CB2020,085,5,Staten Island,50105003005,47,16,31,4.18
2020,CB2020,085,5,Staten Island,50105004000,75,38,37,3.56
2020,CB2020,085,5,Staten Island,50105004001,131,57,74,8.59
2020,CB2020,085,5,Staten Island,50105004002,292,166,126,7.26
2020,CB2020,085,5,Staten Island,50105004003,208,111,97,4.29
2020,CB2020,085,5,Staten Island,50105004004,505,249,256,12.32
2020,CB2020,085,5,Staten Island,50105004005,240,105,135,6.09
2020,CB2020,085,5,Staten Island,50105004006,81,51,30,5.96
2020,CB2020,085,5,Staten Island,50105005000,157,68,89,7.07
2020,CB2020,085,5,Staten Island,50105005001,241,115,126,5.92
2020,CB2020,085,5,Staten Island,50105005002,316,175,141,8.05
2020,CB2020,085,5,Staten Island,50105005003,263,128,135,5.04
2020,CB2020,085,5,Staten Island,50105005004,176,76,100,3.23
2020,CB2020,085,5,Staten Island,50105005005,120,64,56,3.11
2020,CB2020,085,5,Staten Island,50105005006,80,37,43,3.51
2020,CB2020,085,5,Staten Island,50105005007,66,30,36,1.22
2020,CB2020,085,5,Staten Island,50105005008,105,61,44,5.59
2020,CB2020,085,5,Staten Island,50112010001,0,0,0,0
2020,CB2020,085,5,Staten Island,50112010002,0,0,0,0
2020,CB2020,085,5,Staten Island,50112011000,165,67,98,4.84
2020,CB2020,085,5,Staten Island,50112011001,93,45,48,16.18
2020,CB2020,085,5,Staten Island,50112011002,71,49,22,27.84
2020,CB2020,085,5,Staten Island,50112011003,17,5,12,2.16
2020,CB2020,085,5,Staten Island,50112011004,12,9,3,2.37
2020,CB2020,085,5,Staten Island,50112011005,11,9,2,1.49
2020,CB2020,085,5,Staten Island,50112011006,83,48,35,16.13
2020,CB2020,085,5,Staten Island,50112011007,120,44,76,5.03
2020,CB2020,085,5,Staten Island,50112011008,199,122,77,4.28
2020,CB2020,085,5,Staten Island,50112011009,12,3,9,1.66
2020,CB2020,085,5,Staten Island,50112011010,21,9,12,1.45
2020,CB2020,085,5,Staten Island,50112011011,15,14,1,1.37
2020,CB2020,085,5,Staten Island,50112011012,26,6,20,2.59
2020,CB2020,085,5,Staten Island,50112011013,36,4,32,2.54
2020,CB2020,085,5,Staten Island,50112011014,28,5,23,2.42
2020,CB2020,085,5,Staten Island,50112011015,17,9,8,2.4
2020,CB2020,085,5,Staten Island,50112011016,0,0,0,2.38
2020,CB2020,085,5,Staten Island,50112011017,104,63,41,13.8
2020,CB2020,085,5,Staten Island,50112011018,17,11,6,3.4
2020,CB2020,085,5,Staten Island,50112011019,43,31,12,3.29
2020,CB2020,085,5,Staten Island,50112011020,29,12,17,3.4
2020,CB2020,085,5,Staten Island,50112011021,79,53,26,7.66
2020,CB2020,085,5,Staten Island,50112011022,246,121,125,4.58
2020,CB2020,085,5,Staten Island,50112011023,27,15,12,1.5
2020,CB2020,085,5,Staten Island,50112011024,23,12,11,1.81
2020,CB2020,085,5,Staten Island,50112012000,119,67,52,4.84
2020,CB2020,085,5,Staten Island,50112012001,158,68,90,5.14
2020,CB2020,085,5,Staten Island,50112012002,145,58,87,3.96
2020,CB2020,085,5,Staten Island,50112012003,119,56,63,3.98
2020,CB2020,085,5,Staten Island,50112012004,114,50,64,11.43
2020,CB2020,085,5,Staten Island,50112012005,124,54,70,3.27
2020,CB2020,085,5,Staten Island,50112012006,68,30,38,6.09
2020,CB2020,085,5,Staten Island,50112012007,29,14,15,1.8
2020,CB2020,085,5,Staten Island,50112012008,59,45,14,1.89
2020,CB2020,085,5,Staten Island,50112012009,128,49,79,4.61
2020,CB2020,085,5,Staten Island,50112012010,81,42,39,12.24
2020,CB2020,085,5,Staten Island,50112012011,90,53,37,3.37
2020,CB2020,085,5,Staten Island,50112012012,110,32,78,2.57
2020,CB2020,085,5,Staten Island,50112012013,28,10,18,1.98
2020,CB2020,085,5,Staten Island,50112012014,39,29,10,1.83
2020,CB2020,085,5,Staten Island,50112012015,34,12,22,1.47
2020,CB2020,085,5,Staten Island,50112012016,138,75,63,4.76
2020,CB2020,085,5,Staten Island,50112012017,192,119,73,5.14
2020,CB2020,085,5,Staten Island,50112012018,170,74,96,4.42
2020,CB2020,085,5,Staten Island,50112012019,147,76,71,3.57
2020,CB2020,085,5,Staten Island,50112012020,0,0,0,1.93
2020,CB2020,085,5,Staten Island,50112012021,38,21,17,1.92
2020,CB2020,085,5,Staten Island,50112012022,54,30,24,2.37
2020,CB2020,085,5,Staten Island,50112013000,68,49,19,4.53
2020,CB2020,085,5,Staten Island,50112013001,144,94,50,5.1
2020,CB2020,085,5,Staten Island,50112013002,126,60,66,4.53
2020,CB2020,085,5,Staten Island,50112013003,111,57,54,4.57
2020,CB2020,085,5,Staten Island,50112013004,194,57,137,7.06
2020,CB2020,085,5,Staten Island,50112013005,125,73,52,4.21
2020,CB2020,085,5,Staten Island,50112013006,139,50,89,3.64
2020,CB2020,085,5,Staten Island,50112013007,149,82,67,4.14
2020,CB2020,085,5,Staten Island,50112013008,0,0,0,4.23
2020,CB2020,085,5,Staten Island,50112013009,86,51,35,4.58
2020,CB2020,085,5,Staten Island,50112013010,181,88,93,4.81
2020,CB2020,085,5,Staten Island,50112013011,106,48,58,4.83
2020,CB2020,085,5,Staten Island,50112013012,227,109,118,34.26
2020,CB2020,085,5,Staten Island,50112013013,15,9,6,5.03
2020,CB2020,085,5,Staten Island,50112013014,31,16,15,3.47
2020,CB2020,085,5,Staten Island,50112013015,57,34,23,3.5
2020,CB2020,085,5,Staten Island,50112013016,0,0,0,1.99
2020,CB2020,085,5,Staten Island,50112013017,0,0,0,2
2020,CB2020,085,5,Staten Island,50112013018,167,83,84,4.05
2020,CB2020,085,5,Staten Island,50112013019,164,51,113,4.43
2020,CB2020,085,5,Staten Island,50112014000,0,0,0,50.65
2020,CB2020,085,5,Staten Island,50112014001,0,0,0,0.57
2020,CB2020,085,5,Staten Island,50112031000,38,32,6,2.13
2020,CB2020,085,5,Staten Island,50112031001,203,120,83,6.44
2020,CB2020,085,5,Staten Island,50112031002,185,82,103,7.14
2020,CB2020,085,5,Staten Island,50112031003,183,92,91,3.83
2020,CB2020,085,5,Staten Island,50112031004,30,4,26,14.13
2020,CB2020,085,5,Staten Island,50112031005,71,23,48,2.78
2020,CB2020,085,5,Staten Island,50112031006,43,30,13,0.86
2020,CB2020,085,5,Staten Island,50112031007,29,11,18,2.11
2020,CB2020,085,5,Staten Island,50112031008,47,9,38,2.98
2020,CB2020,085,5,Staten Island,50112031009,69,30,39,4.34
2020,CB2020,085,5,Staten Island,50112031010,58,21,37,2.66
2020,CB2020,085,5,Staten Island,50112031011,107,54,53,14.12
2020,CB2020,085,5,Staten Island,50112031012,58,30,28,2.67
2020,CB2020,085,5,Staten Island,50112031013,47,32,15,2.74
2020,CB2020,085,5,Staten Island,50112031014,77,43,34,2.89
2020,CB2020,085,5,Staten Island,50112031015,90,49,41,2.73
2020,CB2020,085,5,Staten Island,50112031016,0,0,0,2.69
2020,CB2020,085,5,Staten Island,50112031017,64,32,32,2.25
2020,CB2020,085,5,Staten Island,50112031018,0,0,0,2.17
2020,CB2020,085,5,Staten Island,50112031019,28,1,27,6.08
2020,CB2020,085,5,Staten Island,50112031020,30,17,13,1.99
2020,CB2020,085,5,Staten Island,50112031021,78,38,40,2.69
2020,CB2020,085,5,Staten Island,50112031022,69,37,32,2.68
2020,CB2020,085,5,Staten Island,50112031023,82,37,45,2.8
2020,CB2020,085,5,Staten Island,50112031024,142,87,55,2.82
2020,CB2020,085,5,Staten Island,50112031025,98,46,52,2.87
2020,CB2020,085,5,Staten Island,50112031026,136,68,68,2.68
2020,CB2020,085,5,Staten Island,50112031027,89,31,58,2.76
2020,CB2020,085,5,Staten Island,50112032000,66,39,27,4.21
2020,CB2020,085,5,Staten Island,50112032001,145,82,63,3.16
2020,CB2020,085,5,Staten Island,50112032002,102,42,60,3.13
2020,CB2020,085,5,Staten Island,50112032003,82,46,36,3.27
2020,CB2020,085,5,Staten Island,50112032004,47,19,28,2.14
2020,CB2020,085,5,Staten Island,50112032005,113,68,45,4.07
2020,CB2020,085,5,Staten Island,50112032006,119,84,35,2.94
2020,CB2020,085,5,Staten Island,50112032007,74,28,46,2.92
2020,CB2020,085,5,Staten Island,50112032008,122,69,53,2.95
2020,CB2020,085,5,Staten Island,50112032009,82,40,42,2.4
2020,CB2020,085,5,Staten Island,50112032010,73,31,42,2.17
2020,CB2020,085,5,Staten Island,50112032011,92,66,26,2.18
2020,CB2020,085,5,Staten Island,50112032012,69,33,36,2.17
2020,CB2020,085,5,Staten Island,50112032013,76,30,46,2.19
2020,CB2020,085,5,Staten Island,50112032014,80,48,32,2.68
2020,CB2020,085,5,Staten Island,50112032015,139,54,85,2.67
2020,CB2020,085,5,Staten Island,50112032016,99,36,63,2.73
2020,CB2020,085,5,Staten Island,50112032017,83,31,52,2.7
2020,CB2020,085,5,Staten Island,50112032018,78,51,27,2.66
2020,CB2020,085,5,Staten Island,50112032019,87,21,66,2.67
2020,CB2020,085,5,Staten Island,50112032020,54,27,27,2.68
2020,CB2020,085,5,Staten Island,50112032021,89,28,61,2.68
2020,CB2020,085,5,Staten Island,50112032022,93,58,35,2.63
2020,CB2020,085,5,Staten Island,50112032023,106,56,50,2.66
2020,CB2020,085,5,Staten Island,50112033000,77,44,33,2.1
2020,CB2020,085,5,Staten Island,50112033001,78,38,40,2.21
2020,CB2020,085,5,Staten Island,50112033002,105,27,78,2.18
2020,CB2020,085,5,Staten Island,50112033003,102,48,54,2.22
2020,CB2020,085,5,Staten Island,50112033004,88,45,43,3.16
2020,CB2020,085,5,Staten Island,50112033005,61,26,35,1.44
2020,CB2020,085,5,Staten Island,50112033006,125,60,65,2.59
2020,CB2020,085,5,Staten Island,50112033007,94,39,55,2.57
2020,CB2020,085,5,Staten Island,50112033008,68,30,38,2.57
2020,CB2020,085,5,Staten Island,50112033009,84,47,37,2.47
2020,CB2020,085,5,Staten Island,50112033010,54,16,38,1.68
2020,CB2020,085,5,Staten Island,50112033011,79,57,22,2.18
2020,CB2020,085,5,Staten Island,50112033012,64,29,35,2.16
2020,CB2020,085,5,Staten Island,50112033013,41,13,28,1.56
2020,CB2020,085,5,Staten Island,50112033014,73,38,35,1.52
2020,CB2020,085,5,Staten Island,50112033015,26,20,6,1.55
2020,CB2020,085,5,Staten Island,50112033016,149,79,70,3.59
2020,CB2020,085,5,Staten Island,50112033017,146,55,91,2.69
2020,CB2020,085,5,Staten Island,50112033018,63,38,25,2.17
2020,CB2020,085,5,Staten Island,50112033019,47,27,20,2.17
2020,CB2020,085,5,Staten Island,50112033020,82,38,44,2.68
2020,CB2020,085,5,Staten Island,50112033021,67,31,36,2.67
2020,CB2020,085,5,Staten Island,50112033022,46,20,26,2.67
2020,CB2020,085,5,Staten Island,50112033023,119,64,55,2.6
2020,CB2020,085,5,Staten Island,50112033024,161,78,83,5.12
2020,CB2020,085,5,Staten Island,50112033025,85,25,60,2.48
2020,CB2020,085,5,Staten Island,50112033026,103,59,44,2.61
2020,CB2020,085,5,Staten Island,50112033027,90,43,47,3.31
2020,CB2020,085,5,Staten Island,50112033028,93,55,38,2.89
2020,CB2020,085,5,Staten Island,50112040001,0,0,0,0
2020,CB2020,085,5,Staten Island,50112040002,0,0,0,0
2020,CB2020,085,5,Staten Island,50112041000,21,12,9,3.2
2020,CB2020,085,5,Staten Island,50112041001,25,16,9,191.11
2020,CB2020,085,5,Staten Island,50112042000,0,0,0,46.84
2020,CB2020,085,5,Staten Island,50114011000,56,19,37,1.53
2020,CB2020,085,5,Staten Island,50114011001,33,29,4,1.18
2020,CB2020,085,5,Staten Island,50114011002,100,52,48,3.95
2020,CB2020,085,5,Staten Island,50114011003,136,58,78,6.39
2020,CB2020,085,5,Staten Island,50114011004,101,54,47,4.66
2020,CB2020,085,5,Staten Island,50114011005,88,62,26,2.8
2020,CB2020,085,5,Staten Island,50114011006,60,18,42,1.63
2020,CB2020,085,5,Staten Island,50114011007,67,47,20,1.64
2020,CB2020,085,5,Staten Island,50114011008,42,29,13,1.66
2020,CB2020,085,5,Staten Island,50114011009,54,18,36,3.62
2020,CB2020,085,5,Staten Island,50114011010,0,0,0,3.95
2020,CB2020,085,5,Staten Island,50114011011,0,0,0,3.45
2020,CB2020,085,5,Staten Island,50114011012,180,84,96,3.08
2020,CB2020,085,5,Staten Island,50114012000,74,46,28,5.08
2020,CB2020,085,5,Staten Island,50114012001,56,26,30,3.33
2020,CB2020,085,5,Staten Island,50114012002,82,40,42,2.2
2020,CB2020,085,5,Staten Island,50114012003,72,40,32,2.6
2020,CB2020,085,5,Staten Island,50114012004,51,25,26,1.35
2020,CB2020,085,5,Staten Island,50114012005,980,379,601,14.41
2020,CB2020,085,5,Staten Island,50114012006,0,0,0,9.09
2020,CB2020,085,5,Staten Island,50114012007,136,79,57,2.65
2020,CB2020,085,5,Staten Island,50114012008,148,61,87,4.55
2020,CB2020,085,5,Staten Island,50114012009,0,0,0,2.91
2020,CB2020,085,5,Staten Island,50114012010,0,0,0,3.22
2020,CB2020,085,5,Staten Island,50114012011,41,19,22,17.81
2020,CB2020,085,5,Staten Island,50114012012,128,66,62,4.08
2020,CB2020,085,5,Staten Island,50114012013,174,78,96,5.37
2020,CB2020,085,5,Staten Island,50114012014,200,112,88,6.15
2020,CB2020,085,5,Staten Island,50114012015,190,79,111,5.86
2020,CB2020,085,5,Staten Island,50114021000,122,78,44,4.21
2020,CB2020,085,5,Staten Island,50114021001,93,28,65,4.39
2020,CB2020,085,5,Staten Island,50114021002,61,33,28,2.41
2020,CB2020,085,5,Staten Island,50114021003,65,33,32,2.45
2020,CB2020,085,5,Staten Island,50114021004,44,18,26,2.27
2020,CB2020,085,5,Staten Island,50114021005,90,40,50,4.74
2020,CB2020,085,5,Staten Island,50114021006,121,62,59,4.76
2020,CB2020,085,5,Staten Island,50114021007,98,38,60,5.61
2020,CB2020,085,5,Staten Island,50114021008,113,60,53,4.58
2020,CB2020,085,5,Staten Island,50114021009,119,66,53,4.8
2020,CB2020,085,5,Staten Island,50114021010,124,64,60,5
2020,CB2020,085,5,Staten Island,50114021011,81,36,45,4.38
2020,CB2020,085,5,Staten Island,50114022000,64,35,29,3.29
2020,CB2020,085,5,Staten Island,50114022001,80,20,60,3.25
2020,CB2020,085,5,Staten Island,50114022002,88,55,33,3.47
2020,CB2020,085,5,Staten Island,50114022003,45,27,18,3.28
2020,CB2020,085,5,Staten Island,50114022004,530,237,293,3.85
2020,CB2020,085,5,Staten Island,50114022005,115,69,46,4
2020,CB2020,085,5,Staten Island,50114022006,157,52,105,3.61
2020,CB2020,085,5,Staten Island,50114022007,75,47,28,5.16
2020,CB2020,085,5,Staten Island,50114022008,120,56,64,6.34
2020,CB2020,085,5,Staten Island,50114023000,192,76,116,5.39
2020,CB2020,085,5,Staten Island,50114023001,146,75,71,5.15
2020,CB2020,085,5,Staten Island,50114023002,163,89,74,5.61
2020,CB2020,085,5,Staten Island,50114023003,118,66,52,5.16
2020,CB2020,085,5,Staten Island,50114023004,108,60,48,3.06
2020,CB2020,085,5,Staten Island,50114023005,74,30,44,3.7
2020,CB2020,085,5,Staten Island,50114023006,92,53,39,3.26
2020,CB2020,085,5,Staten Island,50114023007,53,15,38,3.19
2020,CB2020,085,5,Staten Island,50114023008,0,0,0,4.13
2020,CB2020,085,5,Staten Island,50114023009,0,0,0,0.76
2020,CB2020,085,5,Staten Island,50114023010,102,53,49,3.11
2020,CB2020,085,5,Staten Island,50114023011,73,26,47,2.54
2020,CB2020,085,5,Staten Island,50114023012,64,34,30,3.73
2020,CB2020,085,5,Staten Island,50114023013,101,45,56,4.78
2020,CB2020,085,5,Staten Island,50114023014,47,11,36,2.39
2020,CB2020,085,5,Staten Island,50114023015,0,0,0,1.36
2020,CB2020,085,5,Staten Island,50121001000,69,31,38,3.95
2020,CB2020,085,5,Staten Island,50121001001,96,50,46,8.05
2020,CB2020,085,5,Staten Island,50121001002,111,80,31,8.07
2020,CB2020,085,5,Staten Island,50121001003,64,39,25,3.34
2020,CB2020,085,5,Staten Island,50121001004,66,23,43,3.59
2020,CB2020,085,5,Staten Island,50121001005,73,27,46,3.14
2020,CB2020,085,5,Staten Island,50121001006,90,46,44,3.13
2020,CB2020,085,5,Staten Island,50121001007,171,100,71,8.04
2020,CB2020,085,5,Staten Island,50121001008,67,28,39,3.65
2020,CB2020,085,5,Staten Island,50121001009,98,49,49,4.79
2020,CB2020,085,5,Staten Island,50121001010,22,12,10,1.87
2020,CB2020,085,5,Staten Island,50121001011,55,25,30,3.61
2020,CB2020,085,5,Staten Island,50121001012,43,8,35,3.57
2020,CB2020,085,5,Staten Island,50121002000,34,21,13,4.02
2020,CB2020,085,5,Staten Island,50121002001,49,18,31,4.8
2020,CB2020,085,5,Staten Island,50121002002,112,61,51,4.48
2020,CB2020,085,5,Staten Island,50121002003,89,48,41,3.47
2020,CB2020,085,5,Staten Island,50121002004,92,41,51,3.44
2020,CB2020,085,5,Staten Island,50121002005,63,20,43,4.09
2020,CB2020,085,5,Staten Island,50121002006,271,122,149,18.04
2020,CB2020,085,5,Staten Island,50121002007,72,22,50,3.16
2020,CB2020,085,5,Staten Island,50121002008,110,57,53,7
2020,CB2020,085,5,Staten Island,50121002009,26,9,17,11.25
2020,CB2020,085,5,Staten Island,50121002010,58,41,17,3.41
2020,CB2020,085,5,Staten Island,50121003000,89,26,63,5.35
2020,CB2020,085,5,Staten Island,50121003001,63,40,23,2.61
2020,CB2020,085,5,Staten Island,50121003002,58,20,38,2.62
2020,CB2020,085,5,Staten Island,50121003003,66,31,35,2.62
2020,CB2020,085,5,Staten Island,50121003004,59,9,50,3.51
2020,CB2020,085,5,Staten Island,50121003005,95,29,66,4.22
2020,CB2020,085,5,Staten Island,50121003006,64,19,45,2.78
2020,CB2020,085,5,Staten Island,50121003007,53,15,38,2.66
2020,CB2020,085,5,Staten Island,50121003008,0,0,0,2.58
2020,CB2020,085,5,Staten Island,50121003009,85,43,42,2.6
2020,CB2020,085,5,Staten Island,50121003010,61,41,20,2.69
2020,CB2020,085,5,Staten Island,50121003011,77,45,32,3.69
2020,CB2020,085,5,Staten Island,50121003012,85,67,18,3.42
2020,CB2020,085,5,Staten Island,50121003013,84,50,34,3.35
2020,CB2020,085,5,Staten Island,50121003014,67,35,32,3.35
2020,CB2020,085,5,Staten Island,50121003015,80,22,58,3.55
2020,CB2020,085,5,Staten Island,50121003016,63,46,17,2.84
2020,CB2020,085,5,Staten Island,50121003017,62,34,28,2.96
2020,CB2020,085,5,Staten Island,50122001000,69,29,40,3
2020,CB2020,085,5,Staten Island,50122001001,61,32,29,2.56
2020,CB2020,085,5,Staten Island,50122001002,87,44,43,3.41
2020,CB2020,085,5,Staten Island,50122001003,86,50,36,3.5
2020,CB2020,085,5,Staten Island,50122001004,42,14,28,3.75
2020,CB2020,085,5,Staten Island,50122001005,82,49,33,4.54
2020,CB2020,085,5,Staten Island,50122001006,96,55,41,4.08
2020,CB2020,085,5,Staten Island,50122001007,85,44,41,3.6
2020,CB2020,085,5,Staten Island,50122001008,88,43,45,3.68
2020,CB2020,085,5,Staten Island,50122001009,73,27,46,3.65
2020,CB2020,085,5,Staten Island,50122001010,76,23,53,3.92
2020,CB2020,085,5,Staten Island,50122001011,83,39,44,3.95
2020,CB2020,085,5,Staten Island,50122001012,82,40,42,4.22
2020,CB2020,085,5,Staten Island,50122001013,75,47,28,4.18
2020,CB2020,085,5,Staten Island,50122002000,119,84,35,3.78
2020,CB2020,085,5,Staten Island,50122002001,92,42,50,4.1
2020,CB2020,085,5,Staten Island,50122002002,116,59,57,4.36
2020,CB2020,085,5,Staten Island,50122002003,92,42,50,4.69
2020,CB2020,085,5,Staten Island,50122002004,66,26,40,5.3
2020,CB2020,085,5,Staten Island,50122002005,25,11,14,3.87
2020,CB2020,085,5,Staten Island,50122002006,77,41,36,3.73
2020,CB2020,085,5,Staten Island,50122002007,69,33,36,3.72
2020,CB2020,085,5,Staten Island,50122002008,83,47,36,3.74
2020,CB2020,085,5,Staten Island,50122002009,84,27,57,3.71
2020,CB2020,085,5,Staten Island,50122002010,0,0,0,3.97
2020,CB2020,085,5,Staten Island,50122002011,70,46,24,3.89
2020,CB2020,085,5,Staten Island,50122002012,92,47,45,3.84
2020,CB2020,085,5,Staten Island,50122002013,77,36,41,3.77
2020,CB2020,085,5,Staten Island,50122002014,45,15,30,3.88
2020,CB2020,085,5,Staten Island,50122003000,59,18,41,3.11
2020,CB2020,085,5,Staten Island,50122003001,67,38,29,3.7
2020,CB2020,085,5,Staten Island,50122003002,61,28,33,2.73
2020,CB2020,085,5,Staten Island,50122003003,70,36,34,3.45
2020,CB2020,085,5,Staten Island,50122003004,45,26,19,2.19
2020,CB2020,085,5,Staten Island,50122003005,142,45,97,5.9
2020,CB2020,085,5,Staten Island,50122003006,45,28,17,2.29
2020,CB2020,085,5,Staten Island,50122003007,0,0,0,3.01
2020,CB2020,085,5,Staten Island,50122003008,0,0,0,3.56
2020,CB2020,085,5,Staten Island,50122003009,44,27,17,2.64
2020,CB2020,085,5,Staten Island,50122003010,12,4,8,2.21
2020,CB2020,085,5,Staten Island,50122003011,19,1,18,2.22
2020,CB2020,085,5,Staten Island,50122003012,56,34,22,2.18
2020,CB2020,085,5,Staten Island,50122003013,61,23,38,3.55
2020,CB2020,085,5,Staten Island,50122003014,92,58,34,3.76
2020,CB2020,085,5,Staten Island,50122003015,45,36,9,3.33
2020,CB2020,085,5,Staten Island,50122004000,156,75,81,6.33
2020,CB2020,085,5,Staten Island,50122004001,68,43,25,2.76
2020,CB2020,085,5,Staten Island,50122004002,0,0,0,3.24
2020,CB2020,085,5,Staten Island,50122004003,86,26,60,3.39
2020,CB2020,085,5,Staten Island,50122004004,113,64,49,3.44
2020,CB2020,085,5,Staten Island,50122004005,94,37,57,3.51
2020,CB2020,085,5,Staten Island,50122004006,85,47,38,3.6
2020,CB2020,085,5,Staten Island,50122004007,73,39,34,2.95
2020,CB2020,085,5,Staten Island,50122004008,51,20,31,3.04
2020,CB2020,085,5,Staten Island,50122004009,75,28,47,3.35
2020,CB2020,085,5,Staten Island,50122004010,82,36,46,3.66
2020,CB2020,085,5,Staten Island,50122004011,45,17,28,3.02
2020,CB2020,085,5,Staten Island,50125001000,635,338,297,16.04
2020,CB2020,085,5,Staten Island,50125001001,266,138,128,6.34
2020,CB2020,085,5,Staten Island,50125001002,198,101,97,7.2
2020,CB2020,085,5,Staten Island,50125001003,271,136,135,8.72
2020,CB2020,085,5,Staten Island,50125001004,182,103,79,7.66
2020,CB2020,085,5,Staten Island,50125002000,273,146,127,6.91
2020,CB2020,085,5,Staten Island,50125002001,207,86,121,5.62
2020,CB2020,085,5,Staten Island,50125002002,177,75,102,4.84
2020,CB2020,085,5,Staten Island,50125002003,69,29,40,4.49
2020,CB2020,085,5,Staten Island,50125002004,28,11,17,5.05
2020,CB2020,085,5,Staten Island,50125002005,104,59,45,3.38
2020,CB2020,085,5,Staten Island,50125003000,188,85,103,5.81
2020,CB2020,085,5,Staten Island,50125003001,33,15,18,1.75
2020,CB2020,085,5,Staten Island,50125003002,102,55,47,1.62
2020,CB2020,085,5,Staten Island,50125003003,104,49,55,17.2
2020,CB2020,085,5,Staten Island,50125003004,102,47,55,4.84
2020,CB2020,085,5,Staten Island,50125003005,82,33,49,3.01
2020,CB2020,085,5,Staten Island,50125003006,66,26,40,3.48
2020,CB2020,085,5,Staten Island,50128040001,0,0,0,0
2020,CB2020,085,5,Staten Island,50128040002,0,0,0,0
2020,CB2020,085,5,Staten Island,50128041000,81,18,63,48.04
2020,CB2020,085,5,Staten Island,50128041001,232,124,108,2.42
2020,CB2020,085,5,Staten Island,50128041002,349,171,178,9.37
2020,CB2020,085,5,Staten Island,50128041003,210,103,107,7.44
2020,CB2020,085,5,Staten Island,50128041004,194,106,88,5.14
2020,CB2020,085,5,Staten Island,50128041005,158,72,86,5.21
2020,CB2020,085,5,Staten Island,50128041006,420,214,206,13.77
2020,CB2020,085,5,Staten Island,50128041007,186,98,88,4.57
2020,CB2020,085,5,Staten Island,50128041008,203,107,96,4.6
2020,CB2020,085,5,Staten Island,50128041009,125,76,49,4.02
2020,CB2020,085,5,Staten Island,50128041010,111,41,70,4.33
2020,CB2020,085,5,Staten Island,50128041011,83,41,42,1.83
2020,CB2020,085,5,Staten Island,50128041012,78,44,34,1.74
2020,CB2020,085,5,Staten Island,50128042000,65,29,36,2.17
2020,CB2020,085,5,Staten Island,50128042001,85,47,38,3.08
2020,CB2020,085,5,Staten Island,50128042002,95,53,42,3.14
2020,CB2020,085,5,Staten Island,50128042003,209,98,111,6.05
2020,CB2020,085,5,Staten Island,50128042004,80,42,38,2.25
2020,CB2020,085,5,Staten Island,50128042005,64,29,35,2.24
2020,CB2020,085,5,Staten Island,50128042006,43,23,20,1.48
2020,CB2020,085,5,Staten Island,50128042007,20,17,3,1.39
2020,CB2020,085,5,Staten Island,50128042008,103,57,46,3.18
2020,CB2020,085,5,Staten Island,50128042009,112,48,64,3.16
2020,CB2020,085,5,Staten Island,50128042010,67,36,31,2.3
2020,CB2020,085,5,Staten Island,50128042011,107,45,62,3.9
2020,CB2020,085,5,Staten Island,50128042012,176,91,85,5.02
2020,CB2020,085,5,Staten Island,50128042013,179,93,86,5.07
2020,CB2020,085,5,Staten Island,50128042014,79,19,60,2.73
2020,CB2020,085,5,Staten Island,50128042015,79,25,54,2.51
2020,CB2020,085,5,Staten Island,50128042016,94,51,43,2.26
2020,CB2020,085,5,Staten Island,50128042017,76,51,25,2.31
2020,CB2020,085,5,Staten Island,50128042018,445,224,221,13.5
2020,CB2020,085,5,Staten Island,50128043000,36,18,18,41.48
2020,CB2020,085,5,Staten Island,50128050001,0,0,0,0
2020,CB2020,085,5,Staten Island,50128050002,0,0,0,0
2020,CB2020,085,5,Staten Island,50128051000,392,181,211,17.65
2020,CB2020,085,5,Staten Island,50128051001,46,24,22,1.02
2020,CB2020,085,5,Staten Island,50128051002,390,208,182,10.52
2020,CB2020,085,5,Staten Island,50128051003,124,77,47,2.89
2020,CB2020,085,5,Staten Island,50128051004,169,80,89,3.29
2020,CB2020,085,5,Staten Island,50128051005,96,55,41,3.3
2020,CB2020,085,5,Staten Island,50128051006,118,50,68,3.35
2020,CB2020,085,5,Staten Island,50128051007,74,30,44,3.34
2020,CB2020,085,5,Staten Island,50128051008,116,41,75,20.98
2020,CB2020,085,5,Staten Island,50128051009,90,65,25,2.4
2020,CB2020,085,5,Staten Island,50128051010,83,15,68,2.48
2020,CB2020,085,5,Staten Island,50128051011,61,33,28,2.47
2020,CB2020,085,5,Staten Island,50128051012,127,74,53,3.67
2020,CB2020,085,5,Staten Island,50128051013,89,35,54,3.94
2020,CB2020,085,5,Staten Island,50128051014,61,25,36,3.32
2020,CB2020,085,5,Staten Island,50128051015,14,2,12,2.47
2020,CB2020,085,5,Staten Island,50128051016,87,41,46,2.43
2020,CB2020,085,5,Staten Island,50128052000,85,43,42,2.75
2020,CB2020,085,5,Staten Island,50128052001,61,35,26,2.78
2020,CB2020,085,5,Staten Island,50128052002,6,4,2,3.91
2020,CB2020,085,5,Staten Island,50128052003,74,48,26,34
2020,CB2020,085,5,Staten Island,50128053000,0,0,0,16.41
2020,CB2020,085,5,Staten Island,50128054000,2,1,1,52.86
2020,CB2020,085,5,Staten Island,50128054001,8,0,8,3.96
2020,CB2020,085,5,Staten Island,50128054002,9,4,5,6.02
2020,CB2020,085,5,Staten Island,50128054003,0,0,0,8.43
2020,CB2020,085,5,Staten Island,50128054004,0,0,0,0.62
2020,CB2020,085,5,Staten Island,50128054005,0,0,0,26.04
2020,CB2020,085,5,Staten Island,50128054006,8,3,5,1.44
2020,CB2020,085,5,Staten Island,50128054007,0,0,0,0
2020,CB2020,085,5,Staten Island,50128060001,0,0,0,0
2020,CB2020,085,5,Staten Island,50128060002,0,0,0,0
2020,CB2020,085,5,Staten Island,50128061000,139,63,76,6.75
2020,CB2020,085,5,Staten Island,50128061001,54,21,33,2.33
2020,CB2020,085,5,Staten Island,50128061002,26,14,12,2.27
2020,CB2020,085,5,Staten Island,50128061003,66,38,28,2.06
2020,CB2020,085,5,Staten Island,50128061004,47,24,23,2.16
2020,CB2020,085,5,Staten Island,50128061005,88,53,35,2.28
2020,CB2020,085,5,Staten Island,50128061006,39,25,14,2.48
2020,CB2020,085,5,Staten Island,50128061007,25,16,9,2.48
2020,CB2020,085,5,Staten Island,50128061008,41,18,23,2.52
2020,CB2020,085,5,Staten Island,50128061009,65,38,27,2.45
2020,CB2020,085,5,Staten Island,50128061010,32,9,23,2.05
2020,CB2020,085,5,Staten Island,50128061011,42,11,31,2.29
2020,CB2020,085,5,Staten Island,50128061012,51,29,22,2.36
2020,CB2020,085,5,Staten Island,50128061013,323,156,167,12.09
2020,CB2020,085,5,Staten Island,50128061014,13,4,9,0.83
2020,CB2020,085,5,Staten Island,50128061015,50,23,27,0.72
2020,CB2020,085,5,Staten Island,50128061016,83,41,42,2.1
2020,CB2020,085,5,Staten Island,50128061017,53,23,30,2.51
2020,CB2020,085,5,Staten Island,50128061018,63,33,30,2.45
2020,CB2020,085,5,Staten Island,50128062000,225,95,130,5.55
2020,CB2020,085,5,Staten Island,50128062001,195,111,84,5.74
2020,CB2020,085,5,Staten Island,50128062002,151,84,67,3.37
2020,CB2020,085,5,Staten Island,50128062003,152,67,85,4.75
2020,CB2020,085,5,Staten Island,50128062004,69,24,45,4.69
2020,CB2020,085,5,Staten Island,50128062005,172,75,97,4.95
2020,CB2020,085,5,Staten Island,50128062006,139,75,64,5.53
2020,CB2020,085,5,Staten Island,50128063000,1981,899,1082,37.01
2020,CB2020,085,5,Staten Island,50128064000,0,0,0,1.41
2020,CB2020,085,5,Staten Island,50128064001,0,0,0,43.73
2020,CB2020,085,5,Staten Island,50128064002,0,0,0,3.56
2020,CB2020,085,5,Staten Island,50128065000,130,58,72,4.14
2020,CB2020,085,5,Staten Island,50128065001,156,87,69,4.32
2020,CB2020,085,5,Staten Island,50128065002,145,65,80,4.33
2020,CB2020,085,5,Staten Island,50128065003,99,48,51,3.75
2020,CB2020,085,5,Staten Island,50128065004,223,103,120,5.8
2020,CB2020,085,5,Staten Island,50128065005,138,66,72,4.14
2020,CB2020,085,5,Staten Island,50128065006,222,120,102,4.86
2020,CB2020,085,5,Staten Island,50128065007,57,15,42,0.62
2020,CB2020,085,5,Staten Island,50128065008,179,68,111,4.11
2020,CB2020,085,5,Staten Island,50128065009,115,59,56,2.92
2020,CB2020,085,5,Staten Island,50128065010,277,130,147,95.03
2020,CB2020,085,5,Staten Island,50128065011,127,65,62,2.26
2020,CB2020,085,5,Staten Island,50128065012,114,62,52,2.32
2020,CB2020,085,5,Staten Island,50128065013,45,8,37,1.96
2020,CB2020,085,5,Staten Island,50128065014,154,70,84,7.35
2020,CB2020,085,5,Staten Island,50128065015,94,46,48,2.67
2020,CB2020,085,5,Staten Island,50132011000,182,89,93,23.62
2020,CB2020,085,5,Staten Island,50132011001,0,0,0,3.27
2020,CB2020,085,5,Staten Island,50132011002,79,40,39,3.16
2020,CB2020,085,5,Staten Island,50132011003,71,35,36,3.16
2020,CB2020,085,5,Staten Island,50132011004,53,8,45,3.02
2020,CB2020,085,5,Staten Island,50132011005,58,23,35,3.07
2020,CB2020,085,5,Staten Island,50132011006,119,60,59,4.77
2020,CB2020,085,5,Staten Island,50132011007,120,77,43,4.63
2020,CB2020,085,5,Staten Island,50132011008,6,4,2,3.45
2020,CB2020,085,5,Staten Island,50132011009,80,36,44,3.64
2020,CB2020,085,5,Staten Island,50132012000,48,35,13,3.3
2020,CB2020,085,5,Staten Island,50132012001,227,92,135,13.63
2020,CB2020,085,5,Staten Island,50132012002,35,19,16,2.22
2020,CB2020,085,5,Staten Island,50132012003,28,4,24,2.35
2020,CB2020,085,5,Staten Island,50132012004,42,20,22,2.51
2020,CB2020,085,5,Staten Island,50132012005,96,49,47,5.45
2020,CB2020,085,5,Staten Island,50132012006,27,9,18,2.48
2020,CB2020,085,5,Staten Island,50132012007,42,22,20,2.44
2020,CB2020,085,5,Staten Island,50132012008,38,20,18,2.48
2020,CB2020,085,5,Staten Island,50132012009,41,18,23,2.43
2020,CB2020,085,5,Staten Island,50132012010,39,30,9,2.32
2020,CB2020,085,5,Staten Island,50132012011,22,4,18,2.32
2020,CB2020,085,5,Staten Island,50132012012,30,29,1,2.5
2020,CB2020,085,5,Staten Island,50132012013,37,25,12,2.5
2020,CB2020,085,5,Staten Island,50132012014,22,4,18,2.06
2020,CB2020,085,5,Staten Island,50132012015,62,27,35,3.98
2020,CB2020,085,5,Staten Island,50132012016,21,20,1,2.63
2020,CB2020,085,5,Staten Island,50132012017,34,18,16,2.65
2020,CB2020,085,5,Staten Island,50132031000,259,109,150,8.35
2020,CB2020,085,5,Staten Island,50132031001,191,75,116,6.48
2020,CB2020,085,5,Staten Island,50132031002,124,60,64,2.99
2020,CB2020,085,5,Staten Island,50132031003,65,29,36,1.86
2020,CB2020,085,5,Staten Island,50132031004,39,9,30,1.16
2020,CB2020,085,5,Staten Island,50132031005,80,28,52,3.21
2020,CB2020,085,5,Staten Island,50132031006,106,55,51,2.89
2020,CB2020,085,5,Staten Island,50132031007,109,71,38,3.95
2020,CB2020,085,5,Staten Island,50132031008,109,48,61,3.41
2020,CB2020,085,5,Staten Island,50132031009,111,83,28,3.01
2020,CB2020,085,5,Staten Island,50132031010,89,62,27,2.98
2020,CB2020,085,5,Staten Island,50132031011,70,36,34,1.42
2020,CB2020,085,5,Staten Island,50132031012,102,46,56,2.9
2020,CB2020,085,5,Staten Island,50132031013,63,19,44,1.51
2020,CB2020,085,5,Staten Island,50132032000,214,105,109,6.43
2020,CB2020,085,5,Staten Island,50132032001,0,0,0,6.27
2020,CB2020,085,5,Staten Island,50132032002,88,35,53,3.08
2020,CB2020,085,5,Staten Island,50132032003,90,48,42,2.97
2020,CB2020,085,5,Staten Island,50132032004,123,55,68,3.31
2020,CB2020,085,5,Staten Island,50132032005,53,35,18,1.26
2020,CB2020,085,5,Staten Island,50132032006,75,35,40,2.08
2020,CB2020,085,5,Staten Island,50132032007,140,64,76,4.98
2020,CB2020,085,5,Staten Island,50132032008,178,101,77,5.6
2020,CB2020,085,5,Staten Island,50132032009,70,34,36,2.94
2020,CB2020,085,5,Staten Island,50132032010,101,26,75,3.41
2020,CB2020,085,5,Staten Island,50132032011,135,57,78,4.56
2020,CB2020,085,5,Staten Island,50132032012,66,35,31,1.32
2020,CB2020,085,5,Staten Island,50132032013,75,45,30,4.19
2020,CB2020,085,5,Staten Island,50132032014,74,62,12,5.13
2020,CB2020,085,5,Staten Island,50132032015,122,55,67,10.74
2020,CB2020,085,5,Staten Island,50132032016,77,32,45,4.16
2020,CB2020,085,5,Staten Island,50132032017,83,49,34,3.74
2020,CB2020,085,5,Staten Island,50132032018,108,58,50,3.24
2020,CB2020,085,5,Staten Island,50132032019,233,111,122,8.86
2020,CB2020,085,5,Staten Island,50132032020,37,10,27,2.55
2020,CB2020,085,5,Staten Island,50132032021,86,57,29,3.83
2020,CB2020,085,5,Staten Island,50132033000,114,60,54,4.17
2020,CB2020,085,5,Staten Island,50132033001,102,45,57,3.85
2020,CB2020,085,5,Staten Island,50132033002,129,45,84,4.24
2020,CB2020,085,5,Staten Island,50132033003,105,39,66,4.61
2020,CB2020,085,5,Staten Island,50132033004,142,44,98,5.19
2020,CB2020,085,5,Staten Island,50132033005,287,159,128,9.97
2020,CB2020,085,5,Staten Island,50132033006,92,67,25,4.79
2020,CB2020,085,5,Staten Island,50132033007,49,19,30,1.67
2020,CB2020,085,5,Staten Island,50132033008,133,85,48,4.09
2020,CB2020,085,5,Staten Island,50132033009,145,89,56,12.86
2020,CB2020,085,5,Staten Island,50132033010,51,33,18,3.62
2020,CB2020,085,5,Staten Island,50132033011,25,24,1,2.1
2020,CB2020,085,5,Staten Island,50132033012,48,21,27,3.38
2020,CB2020,085,5,Staten Island,50132033013,119,58,61,9.71
2020,CB2020,085,5,Staten Island,50132033014,39,29,10,7.44
2020,CB2020,085,5,Staten Island,50132033015,51,36,15,4.31
2020,CB2020,085,5,Staten Island,50132033016,49,6,43,2.65
2020,CB2020,085,5,Staten Island,50132033017,63,28,35,6.44
2020,CB2020,085,5,Staten Island,50132033018,111,42,69,6.38
2020,CB2020,085,5,Staten Island,50132033019,77,10,67,4.46
2020,CB2020,085,5,Staten Island,50132033020,50,40,10,3.25
2020,CB2020,085,5,Staten Island,50132033021,64,25,39,3.99
2020,CB2020,085,5,Staten Island,50132041000,125,60,65,4.63
2020,CB2020,085,5,Staten Island,50132041001,116,62,54,8.27
2020,CB2020,085,5,Staten Island,50132041002,40,21,19,2.56
2020,CB2020,085,5,Staten Island,50132041003,44,30,14,2.6
2020,CB2020,085,5,Staten Island,50132041004,45,29,16,2.5
2020,CB2020,085,5,Staten Island,50132041005,36,10,26,2.48
2020,CB2020,085,5,Staten Island,50132041006,40,16,24,2.47
2020,CB2020,085,5,Staten Island,50132041007,46,21,25,2.47
2020,CB2020,085,5,Staten Island,50132041008,52,26,26,2.47
2020,CB2020,085,5,Staten Island,50132041009,47,23,24,2.56
2020,CB2020,085,5,Staten Island,50132041010,12,1,11,0.83
2020,CB2020,085,5,Staten Island,50132041011,28,1,27,1.23
2020,CB2020,085,5,Staten Island,50132041012,78,53,25,10.78
2020,CB2020,085,5,Staten Island,50132041013,110,56,54,5.38
2020,CB2020,085,5,Staten Island,50132041014,56,33,23,4.15
2020,CB2020,085,5,Staten Island,50132041015,49,17,32,4.28
2020,CB2020,085,5,Staten Island,50132041016,61,27,34,3.47
2020,CB2020,085,5,Staten Island,50132041017,0,0,0,12.42
2020,CB2020,085,5,Staten Island,50132041018,22,3,19,1.58
2020,CB2020,085,5,Staten Island,50132041019,70,41,29,4.26
2020,CB2020,085,5,Staten Island,50132041020,86,47,39,4.72
2020,CB2020,085,5,Staten Island,50132041021,75,12,63,4.73
2020,CB2020,085,5,Staten Island,50132041022,85,45,40,4.81
2020,CB2020,085,5,Staten Island,50132042000,24,18,6,3.27
2020,CB2020,085,5,Staten Island,50132042001,49,30,19,2.46
2020,CB2020,085,5,Staten Island,50132042002,30,26,4,1.62
2020,CB2020,085,5,Staten Island,50132042003,0,0,0,0.67
2020,CB2020,085,5,Staten Island,50132042004,0,0,0,0.64
2020,CB2020,085,5,Staten Island,50132042005,0,0,0,1.76
2020,CB2020,085,5,Staten Island,50132042006,58,14,44,2.07
2020,CB2020,085,5,Staten Island,50132042007,35,14,21,2.06
2020,CB2020,085,5,Staten Island,50132042008,57,10,47,2.01
2020,CB2020,085,5,Staten Island,50132042009,53,22,31,2.08
2020,CB2020,085,5,Staten Island,50132042010,76,44,32,2.07
2020,CB2020,085,5,Staten Island,50132042011,26,8,18,1.37
2020,CB2020,085,5,Staten Island,50132042012,15,11,4,0.31
2020,CB2020,085,5,Staten Island,50132042013,71,28,43,1.9
2020,CB2020,085,5,Staten Island,50132042014,6,2,4,3.97
2020,CB2020,085,5,Staten Island,50132042015,109,55,54,4.11
2020,CB2020,085,5,Staten Island,50132042016,67,33,34,2.07
2020,CB2020,085,5,Staten Island,50132042017,47,18,29,2.08
2020,CB2020,085,5,Staten Island,50132042018,40,33,7,2.09
2020,CB2020,085,5,Staten Island,50132042019,63,19,44,1.92
2020,CB2020,085,5,Staten Island,50132042020,0,0,0,0.58
2020,CB2020,085,5,Staten Island,50132042021,0,0,0,0.91
2020,CB2020,085,5,Staten Island,50132042022,73,17,56,3.76
2020,CB2020,085,5,Staten Island,50132042023,82,57,25,3.79
2020,CB2020,085,5,Staten Island,50132042024,58,32,26,3.92
2020,CB2020,085,5,Staten Island,50132042025,100,43,57,3.75
2020,CB2020,085,5,Staten Island,50132042026,149,82,67,4.66
2020,CB2020,085,5,Staten Island,50132042027,76,34,42,2.7
2020,CB2020,085,5,Staten Island,50132042028,0,0,0,1.74
2020,CB2020,085,5,Staten Island,50132042029,103,48,55,2.88
2020,CB2020,085,5,Staten Island,50132042030,115,47,68,3.1
2020,CB2020,085,5,Staten Island,50132042031,136,59,77,3.48
2020,CB2020,085,5,Staten Island,50132042032,121,55,66,3.01
2020,CB2020,085,5,Staten Island,50132042033,282,126,156,9.23
2020,CB2020,085,5,Staten Island,50132042034,57,35,22,2.45
2020,CB2020,085,5,Staten Island,50132042035,100,42,58,2.5
2020,CB2020,085,5,Staten Island,50132043000,127,51,76,4.8
2020,CB2020,085,5,Staten Island,50132043001,71,34,37,4.98
2020,CB2020,085,5,Staten Island,50132043002,0,0,0,1.36
2020,CB2020,085,5,Staten Island,50132043003,37,26,11,8.16
2020,CB2020,085,5,Staten Island,50132043004,16,11,5,1.82
2020,CB2020,085,5,Staten Island,50132043005,0,0,0,1.98
2020,CB2020,085,5,Staten Island,50132043006,155,69,86,4.03
2020,CB2020,085,5,Staten Island,50132043007,94,46,48,3.68
2020,CB2020,085,5,Staten Island,50132043008,68,34,34,3.2
2020,CB2020,085,5,Staten Island,50132043009,90,42,48,2.82
2020,CB2020,085,5,Staten Island,50132043010,68,26,42,3.18
2020,CB2020,085,5,Staten Island,50132043011,149,99,50,4.76
2020,CB2020,085,5,Staten Island,50132043012,39,23,16,2.26
2020,CB2020,085,5,Staten Island,50132043013,0,0,0,0.57
2020,CB2020,085,5,Staten Island,50132043014,0,0,0,0.59
2020,CB2020,085,5,Staten Island,50132043015,50,4,46,2.18
2020,CB2020,085,5,Staten Island,50132043016,38,28,10,2.14
2020,CB2020,085,5,Staten Island,50132043017,11,3,8,1.03
2020,CB2020,085,5,Staten Island,50132043018,50,22,28,2.05
2020,CB2020,085,5,Staten Island,50132043019,0,0,0,0.58
2020,CB2020,085,5,Staten Island,50132043020,0,0,0,0.93
2020,CB2020,085,5,Staten Island,50132043021,107,62,45,2.42
2020,CB2020,085,5,Staten Island,50132043022,95,34,61,2.51
2020,CB2020,085,5,Staten Island,50132043023,189,103,86,7.59
2020,CB2020,085,5,Staten Island,50133011000,1631,685,946,16.64
2020,CB2020,085,5,Staten Island,50133021000,222,120,102,4.83
2020,CB2020,085,5,Staten Island,50133021001,175,75,100,4.91
2020,CB2020,085,5,Staten Island,50133021002,47,29,18,13.65
2020,CB2020,085,5,Staten Island,50133021003,38,27,11,1.81
2020,CB2020,085,5,Staten Island,50133021004,69,42,27,5.18
2020,CB2020,085,5,Staten Island,50133021005,128,54,74,3.33
2020,CB2020,085,5,Staten Island,50133021006,96,58,38,3.58
2020,CB2020,085,5,Staten Island,50133021007,113,39,74,2.96
2020,CB2020,085,5,Staten Island,50133022000,0,0,0,37.23
2020,CB2020,085,5,Staten Island,50133022001,30,9,21,2.1
2020,CB2020,085,5,Staten Island,50133022002,128,68,60,26.86
2020,CB2020,085,5,Staten Island,50133022003,160,79,81,5.62
2020,CB2020,085,5,Staten Island,50133022004,84,39,45,6.87
2020,CB2020,085,5,Staten Island,50133022005,320,168,152,7.42
2020,CB2020,085,5,Staten Island,50133022006,0,0,0,1.92
2020,CB2020,085,5,Staten Island,50133022007,372,179,193,13.05
2020,CB2020,085,5,Staten Island,50133023000,53,13,40,1.1
2020,CB2020,085,5,Staten Island,50133023001,222,115,107,4.74
2020,CB2020,085,5,Staten Island,50133023002,174,82,92,4.6
2020,CB2020,085,5,Staten Island,50133023003,179,111,68,5.82
2020,CB2020,085,5,Staten Island,50133023004,195,84,111,6.2
2020,CB2020,085,5,Staten Island,50133023005,166,102,64,5.42
2020,CB2020,085,5,Staten Island,50133023006,207,87,120,5.39
2020,CB2020,085,5,Staten Island,50133023007,63,35,28,4.82
2020,CB2020,085,5,Staten Island,50133023008,167,116,51,15.79
2020,CB2020,085,5,Staten Island,50133023009,0,0,0,4.67
2020,CB2020,085,5,Staten Island,50133023010,121,53,68,2.04
2020,CB2020,085,5,Staten Island,50133023011,76,27,49,1.43
2020,CB2020,085,5,Staten Island,50133023012,63,32,31,3.76
2020,CB2020,085,5,Staten Island,50133023013,65,39,26,2.76
2020,CB2020,085,5,Staten Island,50134001000,25,9,16,0.94
2020,CB2020,085,5,Staten Island,50134001001,27,13,14,2.38
2020,CB2020,085,5,Staten Island,50134001002,33,18,15,2.4
2020,CB2020,085,5,Staten Island,50134001003,23,3,20,2.43
2020,CB2020,085,5,Staten Island,50134001004,33,26,7,2.55
2020,CB2020,085,5,Staten Island,50134001005,0,0,0,1.29
2020,CB2020,085,5,Staten Island,50134001006,147,89,58,3
2020,CB2020,085,5,Staten Island,50134001007,53,33,20,2.54
2020,CB2020,085,5,Staten Island,50134001008,55,28,27,2.71
2020,CB2020,085,5,Staten Island,50134001009,63,37,26,4.37
2020,CB2020,085,5,Staten Island,50134001010,82,52,30,4.34
2020,CB2020,085,5,Staten Island,50134001011,59,39,20,2.37
2020,CB2020,085,5,Staten Island,50134001012,83,61,22,2.3
2020,CB2020,085,5,Staten Island,50134001013,48,15,33,3.42
2020,CB2020,085,5,Staten Island,50134001014,0,0,0,1.17
2020,CB2020,085,5,Staten Island,50134001015,37,23,14,1.71
2020,CB2020,085,5,Staten Island,50134001016,31,9,22,2.28
2020,CB2020,085,5,Staten Island,50134001017,57,34,23,2.29
2020,CB2020,085,5,Staten Island,50134001018,57,21,36,2.3
2020,CB2020,085,5,Staten Island,50134001019,25,11,14,2.22
2020,CB2020,085,5,Staten Island,50134001020,80,23,57,4.38
2020,CB2020,085,5,Staten Island,50134001021,80,32,48,4.2
2020,CB2020,085,5,Staten Island,50134001022,68,29,39,4.27
2020,CB2020,085,5,Staten Island,50134001023,50,19,31,4.42
2020,CB2020,085,5,Staten Island,50134002000,78,33,45,4.41
2020,CB2020,085,5,Staten Island,50134002001,72,36,36,4.13
2020,CB2020,085,5,Staten Island,50134002002,68,27,41,4.03
2020,CB2020,085,5,Staten Island,50134002003,63,42,21,4.44
2020,CB2020,085,5,Staten Island,50134002004,112,46,66,4.48
2020,CB2020,085,5,Staten Island,50134002005,0,0,0,10.15
2020,CB2020,085,5,Staten Island,50134002006,35,19,16,1.82
2020,CB2020,085,5,Staten Island,50134002007,102,41,61,4
2020,CB2020,085,5,Staten Island,50134002008,89,34,55,3.91
2020,CB2020,085,5,Staten Island,50134002009,48,22,26,3.92
2020,CB2020,085,5,Staten Island,50134002010,76,46,30,3.87
2020,CB2020,085,5,Staten Island,50134002011,41,25,16,1.82
2020,CB2020,085,5,Staten Island,50134002012,88,57,31,4.6
2020,CB2020,085,5,Staten Island,50134002013,28,14,14,2
2020,CB2020,085,5,Staten Island,50134002014,45,21,24,1.96
2020,CB2020,085,5,Staten Island,50134002015,63,37,26,2.07
2020,CB2020,085,5,Staten Island,50134002016,63,19,44,2.5
2020,CB2020,085,5,Staten Island,50134002017,77,30,47,3.68
2020,CB2020,085,5,Staten Island,50134002018,38,20,18,2.73
2020,CB2020,085,5,Staten Island,50134003000,17,3,14,1.11
2020,CB2020,085,5,Staten Island,50134003001,32,11,21,2.22
2020,CB2020,085,5,Staten Island,50134003002,120,77,43,4.75
2020,CB2020,085,5,Staten Island,50134003003,0,0,0,1.66
2020,CB2020,085,5,Staten Island,50134003004,85,43,42,2.42
2020,CB2020,085,5,Staten Island,50134003005,64,37,27,3.18
2020,CB2020,085,5,Staten Island,50134003006,83,48,35,3.17
2020,CB2020,085,5,Staten Island,50134003007,73,22,51,3.27
2020,CB2020,085,5,Staten Island,50134003008,83,36,47,4.83
2020,CB2020,085,5,Staten Island,50134003009,91,48,43,4.36
2020,CB2020,085,5,Staten Island,50134003010,249,107,142,9.24
2020,CB2020,085,5,Staten Island,50134003011,70,38,32,3.02
2020,CB2020,085,5,Staten Island,50134003012,104,36,68,2.28
2020,CB2020,085,5,Staten Island,50134003013,144,88,56,3.1
2020,CB2020,085,5,Staten Island,50134003014,55,17,38,2.99
2020,CB2020,085,5,Staten Island,50134003015,54,16,38,3.12
2020,CB2020,085,5,Staten Island,50134003016,66,19,47,3.12
2020,CB2020,085,5,Staten Island,50134003017,63,36,27,3.03
2020,CB2020,085,5,Staten Island,50134003018,71,38,33,2.97
2020,CB2020,085,5,Staten Island,50134003019,102,66,36,3.67
2020,CB2020,085,5,Staten Island,50134003020,64,26,38,3.72
2020,CB2020,085,5,Staten Island,50134003021,112,50,62,2.23
2020,CB2020,085,5,Staten Island,50138001000,29,7,22,2.54
2020,CB2020,085,5,Staten Island,50138001001,0,0,0,3.18
2020,CB2020,085,5,Staten Island,50138001002,32,12,20,2.84
2020,CB2020,085,5,Staten Island,50138001003,36,17,19,4.14
2020,CB2020,085,5,Staten Island,50138001004,78,43,35,7.33
2020,CB2020,085,5,Staten Island,50138001005,23,20,3,2.78
2020,CB2020,085,5,Staten Island,50138001006,36,12,24,3.14
2020,CB2020,085,5,Staten Island,50138001007,23,16,7,2.48
2020,CB2020,085,5,Staten Island,50138001008,23,6,17,2.26
2020,CB2020,085,5,Staten Island,50138001009,35,17,18,2.86
2020,CB2020,085,5,Staten Island,50138001010,45,27,18,3.21
2020,CB2020,085,5,Staten Island,50138001011,52,24,28,2.82
2020,CB2020,085,5,Staten Island,50138001012,14,12,2,1.35
2020,CB2020,085,5,Staten Island,50138001013,33,18,15,2.62
2020,CB2020,085,5,Staten Island,50138001014,18,3,15,2.19
2020,CB2020,085,5,Staten Island,50138001015,66,32,34,2.92
2020,CB2020,085,5,Staten Island,50138001016,23,8,15,2.77
2020,CB2020,085,5,Staten Island,50138001017,45,10,35,2.89
2020,CB2020,085,5,Staten Island,50138001018,35,13,22,2.9
2020,CB2020,085,5,Staten Island,50138001019,38,29,9,2.82
2020,CB2020,085,5,Staten Island,50138001020,70,43,27,4.12
2020,CB2020,085,5,Staten Island,50138001021,112,57,55,4.61
2020,CB2020,085,5,Staten Island,50138001022,70,33,37,3.68
2020,CB2020,085,5,Staten Island,50138001023,8,8,0,0.65
2020,CB2020,085,5,Staten Island,50138001024,82,42,40,4.11
2020,CB2020,085,5,Staten Island,50138002000,81,36,45,31.82
2020,CB2020,085,5,Staten Island,50138002001,140,63,77,9.86
2020,CB2020,085,5,Staten Island,50138002002,43,8,35,3.36
2020,CB2020,085,5,Staten Island,50138002003,56,14,42,3.25
2020,CB2020,085,5,Staten Island,50138002004,78,18,60,3.3
2020,CB2020,085,5,Staten Island,50138002005,0,0,0,3.32
2020,CB2020,085,5,Staten Island,50138002006,53,11,42,3.22
2020,CB2020,085,5,Staten Island,50138002007,96,61,35,12.37
2020,CB2020,085,5,Staten Island,50138002008,58,31,27,2.23
2020,CB2020,085,5,Staten Island,50138002009,37,23,14,1.75
2020,CB2020,085,5,Staten Island,50138002010,90,48,42,4.04
2020,CB2020,085,5,Staten Island,50138002011,58,36,22,3.43
2020,CB2020,085,5,Staten Island,50138002012,74,42,32,3.7
2020,CB2020,085,5,Staten Island,50138002013,113,82,31,6.25
2020,CB2020,085,5,Staten Island,50138002014,53,30,23,3.18
2020,CB2020,085,5,Staten Island,50138002015,70,19,51,2.96
2020,CB2020,085,5,Staten Island,50138002016,39,5,34,2.23
2020,CB2020,085,5,Staten Island,50138002017,91,49,42,4.18
2020,CB2020,085,5,Staten Island,50138002018,50,35,15,3.54
2020,CB2020,085,5,Staten Island,50138002019,47,25,22,2.13
2020,CB2020,085,5,Staten Island,50138002020,32,0,32,2.86
2020,CB2020,085,5,Staten Island,50138002021,85,42,43,5.28
2020,CB2020,085,5,Staten Island,50138003000,264,134,130,6.44
2020,CB2020,085,5,Staten Island,50138003001,76,37,39,2.53
2020,CB2020,085,5,Staten Island,50138003002,115,59,56,4.12
2020,CB2020,085,5,Staten Island,50138003003,146,79,67,4.14
2020,CB2020,085,5,Staten Island,50138003004,116,69,47,3.89
2020,CB2020,085,5,Staten Island,50138003005,71,21,50,2.29
2020,CB2020,085,5,Staten Island,50138003006,99,49,50,3.14
2020,CB2020,085,5,Staten Island,50138003007,85,38,47,3.07
2020,CB2020,085,5,Staten Island,50138003008,65,36,29,2.49
2020,CB2020,085,5,Staten Island,50138003009,175,64,111,4.89
2020,CB2020,085,5,Staten Island,50138003010,205,99,106,5.88
2020,CB2020,085,5,Staten Island,50138003011,141,64,77,4.76
2020,CB2020,085,5,Staten Island,50138003012,123,56,67,3.08
2020,CB2020,085,5,Staten Island,50138003013,45,30,15,1.55
2020,CB2020,085,5,Staten Island,50138004000,109,60,49,3.54
2020,CB2020,085,5,Staten Island,50138004001,99,60,39,3.79
2020,CB2020,085,5,Staten Island,50138004002,107,50,57,3.79
2020,CB2020,085,5,Staten Island,50138004003,180,76,104,6.1
2020,CB2020,085,5,Staten Island,50138004004,43,17,26,1.57
2020,CB2020,085,5,Staten Island,50138004005,86,36,50,4.18
2020,CB2020,085,5,Staten Island,50138004006,126,53,73,4.61
2020,CB2020,085,5,Staten Island,50138004007,197,82,115,7.45
2020,CB2020,085,5,Staten Island,50138004008,53,23,30,3.51
2020,CB2020,085,5,Staten Island,50138004009,73,41,32,3.27
2020,CB2020,085,5,Staten Island,50138004010,68,31,37,2.91
2020,CB2020,085,5,Staten Island,50138004011,171,99,72,3.98
2020,CB2020,085,5,Staten Island,50138005000,159,85,74,7.91
2020,CB2020,085,5,Staten Island,50138005001,72,33,39,3.63
2020,CB2020,085,5,Staten Island,50138005002,45,8,37,2.45
2020,CB2020,085,5,Staten Island,50138005003,106,47,59,3.88
2020,CB2020,085,5,Staten Island,50138005004,136,95,41,5.15
2020,CB2020,085,5,Staten Island,50138005005,65,33,32,2.72
2020,CB2020,085,5,Staten Island,50138005006,61,24,37,2.29
2020,CB2020,085,5,Staten Island,50138005007,33,14,19,2.2
2020,CB2020,085,5,Staten Island,50138005008,174,80,94,9.18
2020,CB2020,085,5,Staten Island,50138005009,85,22,63,2.74
2020,CB2020,085,5,Staten Island,50138005010,137,56,81,6.7
2020,CB2020,085,5,Staten Island,50138005011,44,29,15,2.45
2020,CB2020,085,5,Staten Island,50141001000,271,139,132,9.84
2020,CB2020,085,5,Staten Island,50141001001,76,38,38,2.09
2020,CB2020,085,5,Staten Island,50141001002,201,82,119,5.11
2020,CB2020,085,5,Staten Island,50141001003,103,55,48,1.07
2020,CB2020,085,5,Staten Island,50141001004,64,39,25,2.71
2020,CB2020,085,5,Staten Island,50141001005,443,215,228,9.3
2020,CB2020,085,5,Staten Island,50141001006,93,57,36,2.6
2020,CB2020,085,5,Staten Island,50141001007,151,88,63,3.38
2020,CB2020,085,5,Staten Island,50141001008,3,1,2,4.19
2020,CB2020,085,5,Staten Island,50141002000,257,127,130,7.02
2020,CB2020,085,5,Staten Island,50141002001,408,180,228,9.99
2020,CB2020,085,5,Staten Island,50141002002,116,65,51,2.38
2020,CB2020,085,5,Staten Island,50141002003,241,120,121,4.68
2020,CB2020,085,5,Staten Island,50141002004,95,48,47,3.1
2020,CB2020,085,5,Staten Island,50141002005,144,79,65,4.46
2020,CB2020,085,5,Staten Island,50141002006,97,50,47,2.55
2020,CB2020,085,5,Staten Island,50141002007,105,40,65,2.46
2020,CB2020,085,5,Staten Island,50146041000,160,87,73,8.35
2020,CB2020,085,5,Staten Island,50146041001,123,51,72,4.68
2020,CB2020,085,5,Staten Island,50146041002,126,59,67,4.77
2020,CB2020,085,5,Staten Island,50146041003,138,66,72,4.6
2020,CB2020,085,5,Staten Island,50146041004,157,74,83,4.7
2020,CB2020,085,5,Staten Island,50146041005,161,67,94,5.43
2020,CB2020,085,5,Staten Island,50146041006,126,81,45,4.14
2020,CB2020,085,5,Staten Island,50146041007,117,53,64,4.95
2020,CB2020,085,5,Staten Island,50146041008,87,47,40,4.59
2020,CB2020,085,5,Staten Island,50146041009,37,17,20,0.59
2020,CB2020,085,5,Staten Island,50146041010,132,80,52,4.69
2020,CB2020,085,5,Staten Island,50146041011,53,16,37,3.98
2020,CB2020,085,5,Staten Island,50146041012,26,19,7,0.5
2020,CB2020,085,5,Staten Island,50146041013,28,10,18,0.52
2020,CB2020,085,5,Staten Island,50146041014,71,12,59,2.96
2020,CB2020,085,5,Staten Island,50146042000,42,18,24,1.65
2020,CB2020,085,5,Staten Island,50146042001,149,68,81,4.64
2020,CB2020,085,5,Staten Island,50146042002,65,34,31,3.05
2020,CB2020,085,5,Staten Island,50146042003,104,62,42,3.16
2020,CB2020,085,5,Staten Island,50146042004,68,26,42,3.27
2020,CB2020,085,5,Staten Island,50146042005,319,165,154,12.29
2020,CB2020,085,5,Staten Island,50146042006,102,45,57,3.15
2020,CB2020,085,5,Staten Island,50146042007,80,39,41,3.69
2020,CB2020,085,5,Staten Island,50146042008,98,48,50,3.26
2020,CB2020,085,5,Staten Island,50146042009,50,25,25,1.56
2020,CB2020,085,5,Staten Island,50146042010,29,13,16,1.58
2020,CB2020,085,5,Staten Island,50146042011,55,32,23,3.2
2020,CB2020,085,5,Staten Island,50146042012,130,52,78,4.11
2020,CB2020,085,5,Staten Island,50146042013,350,156,194,18.38
2020,CB2020,085,5,Staten Island,50146042014,0,0,0,2.27
2020,CB2020,085,5,Staten Island,50146042015,0,0,0,1.6
2020,CB2020,085,5,Staten Island,50146042016,31,21,10,2.01
2020,CB2020,085,5,Staten Island,50146042017,0,0,0,1.31
2020,CB2020,085,5,Staten Island,50146043000,269,132,137,8.49
2020,CB2020,085,5,Staten Island,50146043001,46,27,19,1.99
2020,CB2020,085,5,Staten Island,50146043002,492,233,259,12.69
2020,CB2020,085,5,Staten Island,50146043003,139,78,61,4.67
2020,CB2020,085,5,Staten Island,50146043004,139,78,61,4.76
2020,CB2020,085,5,Staten Island,50146043005,155,71,84,9.6
2020,CB2020,085,5,Staten Island,50146043006,134,51,83,4.06
2020,CB2020,085,5,Staten Island,50146043007,134,58,76,4.53
2020,CB2020,085,5,Staten Island,50146043008,124,33,91,4.77
2020,CB2020,085,5,Staten Island,50146043009,137,69,68,4.55
2020,CB2020,085,5,Staten Island,50146043010,106,48,58,4.82
2020,CB2020,085,5,Staten Island,50146043011,61,37,24,2.12
2020,CB2020,085,5,Staten Island,50146043012,80,56,24,2.73
2020,CB2020,085,5,Staten Island,50146043013,188,103,85,5.73
2020,CB2020,085,5,Staten Island,50146043014,65,30,35,2.02
2020,CB2020,085,5,Staten Island,50146044000,148,61,87,4.39
2020,CB2020,085,5,Staten Island,50146044001,89,31,58,2.2
2020,CB2020,085,5,Staten Island,50146044002,70,40,30,2.34
2020,CB2020,085,5,Staten Island,50146044003,198,116,82,6.59
2020,CB2020,085,5,Staten Island,50146044004,285,137,148,11.59
2020,CB2020,085,5,Staten Island,50146044005,132,50,82,8.24
2020,CB2020,085,5,Staten Island,50146044006,16,9,7,2.59
2020,CB2020,085,5,Staten Island,50146044007,141,73,68,7.8
2020,CB2020,085,5,Staten Island,50146044008,89,31,58,3.25
2020,CB2020,085,5,Staten Island,50146044009,0,0,0,18.31
2020,CB2020,085,5,Staten Island,50146044010,0,0,0,0.55
2020,CB2020,085,5,Staten Island,50146051000,53,20,33,3.67
2020,CB2020,085,5,Staten Island,50146051001,64,41,23,3.24
2020,CB2020,085,5,Staten Island,50146051002,60,30,30,2.8
2020,CB2020,085,5,Staten Island,50146051003,114,47,67,3.07
2020,CB2020,085,5,Staten Island,50146051004,0,0,0,3.06
2020,CB2020,085,5,Staten Island,50146051005,42,36,6,26.49
2020,CB2020,085,5,Staten Island,50146051006,47,19,28,2.91
2020,CB2020,085,5,Staten Island,50146051007,64,31,33,2.56
2020,CB2020,085,5,Staten Island,50146051008,47,25,22,2.48
2020,CB2020,085,5,Staten Island,50146051009,48,41,7,2.51
2020,CB2020,085,5,Staten Island,50146051010,47,20,27,2.7
2020,CB2020,085,5,Staten Island,50146051011,60,17,43,3.01
2020,CB2020,085,5,Staten Island,50146051012,56,17,39,3.22
2020,CB2020,085,5,Staten Island,50146051013,58,22,36,3.35
2020,CB2020,085,5,Staten Island,50146051014,58,22,36,3.72
2020,CB2020,085,5,Staten Island,50146051015,101,31,70,3.99
2020,CB2020,085,5,Staten Island,50146051016,116,61,55,4.2
2020,CB2020,085,5,Staten Island,50146051017,102,43,59,3.58
2020,CB2020,085,5,Staten Island,50146051018,142,73,69,3.88
2020,CB2020,085,5,Staten Island,50146051019,158,78,80,4.45
2020,CB2020,085,5,Staten Island,50146051020,149,79,70,4.81
2020,CB2020,085,5,Staten Island,50146051021,0,0,0,7.96
2020,CB2020,085,5,Staten Island,50146051022,89,41,48,3.9
2020,CB2020,085,5,Staten Island,50146051023,114,57,57,5.59
2020,CB2020,085,5,Staten Island,50146051024,63,31,32,2.81
2020,CB2020,085,5,Staten Island,50146052000,91,57,34,3.83
2020,CB2020,085,5,Staten Island,50146052001,111,39,72,3.99
2020,CB2020,085,5,Staten Island,50146052002,83,35,48,5.07
2020,CB2020,085,5,Staten Island,50146052003,41,18,23,1.9
2020,CB2020,085,5,Staten Island,50146052004,193,84,109,9.56
2020,CB2020,085,5,Staten Island,50146052005,44,31,13,1.79
2020,CB2020,085,5,Staten Island,50146052006,38,16,22,2.08
2020,CB2020,085,5,Staten Island,50146052007,46,12,34,2.18
2020,CB2020,085,5,Staten Island,50146052008,138,66,72,8.22
2020,CB2020,085,5,Staten Island,50146052009,79,35,44,1.77
2020,CB2020,085,5,Staten Island,50146052010,67,27,40,3.02
2020,CB2020,085,5,Staten Island,50146052011,38,15,23,6.31
2020,CB2020,085,5,Staten Island,50146052012,83,36,47,3.1
2020,CB2020,085,5,Staten Island,50146052013,87,51,36,3.23
2020,CB2020,085,5,Staten Island,50146052014,58,26,32,2.34
2020,CB2020,085,5,Staten Island,50146052015,51,41,10,2.82
2020,CB2020,085,5,Staten Island,50146052016,7,6,1,0.47
2020,CB2020,085,5,Staten Island,50146052017,48,29,19,2.18
2020,CB2020,085,5,Staten Island,50146052018,59,28,31,2.28
2020,CB2020,085,5,Staten Island,50146052019,41,14,27,2.35
2020,CB2020,085,5,Staten Island,50146052020,61,27,34,2.99
2020,CB2020,085,5,Staten Island,50146052021,65,29,36,3.04
2020,CB2020,085,5,Staten Island,50146052022,53,38,15,3.11
2020,CB2020,085,5,Staten Island,50146052023,87,49,38,8.57
2020,CB2020,085,5,Staten Island,50146052024,66,27,39,4.17
2020,CB2020,085,5,Staten Island,50146052025,77,31,46,2.37
2020,CB2020,085,5,Staten Island,50146052026,121,54,67,9.7
2020,CB2020,085,5,Staten Island,50146061000,541,239,302,18.63
2020,CB2020,085,5,Staten Island,50146061001,217,96,121,3.47
2020,CB2020,085,5,Staten Island,50146061002,419,205,214,18.15
2020,CB2020,085,5,Staten Island,50146061003,142,99,43,3.7
2020,CB2020,085,5,Staten Island,50146061004,278,155,123,6.9
2020,CB2020,085,5,Staten Island,50146061005,144,66,78,2.74
2020,CB2020,085,5,Staten Island,50146062000,292,120,172,11.84
2020,CB2020,085,5,Staten Island,50146062001,66,39,27,0.78
2020,CB2020,085,5,Staten Island,50146062002,423,209,214,33.57
2020,CB2020,085,5,Staten Island,50146062003,92,56,36,2.18
2020,CB2020,085,5,Staten Island,50146062004,189,82,107,6.54
2020,CB2020,085,5,Staten Island,50146062005,294,152,142,13.86
2020,CB2020,085,5,Staten Island,50146062006,64,49,15,1.05
2020,CB2020,085,5,Staten Island,50146062007,57,27,30,1.17
2020,CB2020,085,5,Staten Island,50146062008,83,27,56,1.73
2020,CB2020,085,5,Staten Island,50146062009,91,38,53,2.14
2020,CB2020,085,5,Staten Island,50146062010,126,58,68,1.84
2020,CB2020,085,5,Staten Island,50146062011,164,80,84,5.82
2020,CB2020,085,5,Staten Island,50146062012,154,84,70,8.41
2020,CB2020,085,5,Staten Island,50146063000,0,0,0,6.42
2020,CB2020,085,5,Staten Island,50146063001,1198,552,646,254.7
2020,CB2020,085,5,Staten Island,50146063002,34,21,13,0.48
2020,CB2020,085,5,Staten Island,50146063003,33,8,25,1.09
2020,CB2020,085,5,Staten Island,50146063004,26,16,10,0.36
2020,CB2020,085,5,Staten Island,50146064000,23,9,14,2.61
2020,CB2020,085,5,Staten Island,50146064001,207,104,103,4.41
2020,CB2020,085,5,Staten Island,50146064002,92,64,28,2.47
2020,CB2020,085,5,Staten Island,50146064003,343,158,185,10.01
2020,CB2020,085,5,Staten Island,50146064004,222,84,138,3.85
2020,CB2020,085,5,Staten Island,50146064005,235,109,126,5.24
2020,CB2020,085,5,Staten Island,50146064006,39,19,20,0.92
2020,CB2020,085,5,Staten Island,50146071000,277,130,147,5.9
2020,CB2020,085,5,Staten Island,50146071001,59,22,37,3.14
2020,CB2020,085,5,Staten Island,50146071002,0,0,0,9.81
2020,CB2020,085,5,Staten Island,50146071003,218,126,92,4.7
2020,CB2020,085,5,Staten Island,50146071004,170,84,86,4.84
2020,CB2020,085,5,Staten Island,50146071005,120,62,58,3.31
2020,CB2020,085,5,Staten Island,50146071006,287,131,156,15.54
2020,CB2020,085,5,Staten Island,50146071007,119,56,63,4.62
2020,CB2020,085,5,Staten Island,50146071008,173,101,72,4.64
2020,CB2020,085,5,Staten Island,50146071009,100,37,63,4.94
2020,CB2020,085,5,Staten Island,50146071010,358,167,191,11.74
2020,CB2020,085,5,Staten Island,50146071011,110,64,46,3.47
2020,CB2020,085,5,Staten Island,50146071012,114,43,71,4.85
2020,CB2020,085,5,Staten Island,50146071013,149,63,86,4.84
2020,CB2020,085,5,Staten Island,50146071014,330,152,178,12.84
2020,CB2020,085,5,Staten Island,50146072000,10,7,3,0.64
2020,CB2020,085,5,Staten Island,50146072001,27,20,7,0.49
2020,CB2020,085,5,Staten Island,50146072002,166,75,91,3.52
2020,CB2020,085,5,Staten Island,50146072003,0,0,0,7.01
2020,CB2020,085,5,Staten Island,50146072004,123,52,71,3.48
2020,CB2020,085,5,Staten Island,50146072005,133,64,69,3.55
2020,CB2020,085,5,Staten Island,50146072006,122,55,67,4.21
2020,CB2020,085,5,Staten Island,50146072007,133,46,87,4.41
2020,CB2020,085,5,Staten Island,50146072008,143,70,73,3.72
2020,CB2020,085,5,Staten Island,50146072009,94,41,53,1.9
2020,CB2020,085,5,Staten Island,50146072010,48,17,31,2.02
2020,CB2020,085,5,Staten Island,50146072011,19,7,12,3.81
2020,CB2020,085,5,Staten Island,50146072012,289,123,166,9.56
2020,CB2020,085,5,Staten Island,50146072013,113,43,70,2.87
2020,CB2020,085,5,Staten Island,50146072014,59,39,20,1.5
2020,CB2020,085,5,Staten Island,50146072015,165,80,85,4.06
2020,CB2020,085,5,Staten Island,50146072016,149,71,78,4.22
2020,CB2020,085,5,Staten Island,50146072017,133,87,46,4.28
2020,CB2020,085,5,Staten Island,50146072018,140,84,56,4.47
2020,CB2020,085,5,Staten Island,50146081000,356,162,194,9.19
2020,CB2020,085,5,Staten Island,50146081001,132,67,65,3.44
2020,CB2020,085,5,Staten Island,50146081002,73,39,34,3.37
2020,CB2020,085,5,Staten Island,50146081003,137,87,50,3.13
2020,CB2020,085,5,Staten Island,50146081004,110,45,65,2.91
2020,CB2020,085,5,Staten Island,50146081005,206,92,114,4.94
2020,CB2020,085,5,Staten Island,50146081006,206,118,88,4.87
2020,CB2020,085,5,Staten Island,50146081007,127,56,71,4.85
2020,CB2020,085,5,Staten Island,50146081008,145,77,68,4.71
2020,CB2020,085,5,Staten Island,50146081009,45,14,31,1.35
2020,CB2020,085,5,Staten Island,50146081010,61,19,42,1.46
2020,CB2020,085,5,Staten Island,50146081011,139,50,89,3.28
2020,CB2020,085,5,Staten Island,50146081012,35,23,12,0.66
2020,CB2020,085,5,Staten Island,50146081013,98,27,71,3.34
2020,CB2020,085,5,Staten Island,50146082000,196,83,113,5.36
2020,CB2020,085,5,Staten Island,50146082001,0,0,0,4.73
2020,CB2020,085,5,Staten Island,50146082002,111,60,51,4.71
2020,CB2020,085,5,Staten Island,50146082003,161,80,81,4.85
2020,CB2020,085,5,Staten Island,50146082004,177,83,94,4.85
2020,CB2020,085,5,Staten Island,50146082005,212,113,99,4.94
2020,CB2020,085,5,Staten Island,50146082006,126,54,72,4.78
2020,CB2020,085,5,Staten Island,50146082007,110,65,45,4.74
2020,CB2020,085,5,Staten Island,50146082008,677,336,341,20.4
2020,CB2020,085,5,Staten Island,50147001000,67,24,43,20.59
2020,CB2020,085,5,Staten Island,50147001001,45,31,14,24.28
2020,CB2020,085,5,Staten Island,50147001002,86,57,29,6.97
2020,CB2020,085,5,Staten Island,50147001003,66,23,43,3.96
2020,CB2020,085,5,Staten Island,50147001004,106,43,63,4.29
2020,CB2020,085,5,Staten Island,50147001005,33,16,17,2.51
2020,CB2020,085,5,Staten Island,50147001006,29,6,23,1.84
2020,CB2020,085,5,Staten Island,50147001007,58,36,22,4.78
2020,CB2020,085,5,Staten Island,50147001008,58,29,29,4.73
2020,CB2020,085,5,Staten Island,50147001009,65,39,26,6.18
2020,CB2020,085,5,Staten Island,50147002000,622,282,340,200.34
2020,CB2020,085,5,Staten Island,50147002001,60,21,39,2.41
2020,CB2020,085,5,Staten Island,50147002002,20,5,15,0.82
2020,CB2020,085,5,Staten Island,50147002003,76,46,30,4.82
2020,CB2020,085,5,Staten Island,50147002004,77,31,46,5.82
2020,CB2020,085,5,Staten Island,50147002005,77,63,14,5.51
2020,CB2020,085,5,Staten Island,50147002006,80,27,53,4.33
2020,CB2020,085,5,Staten Island,50147002007,0,0,0,20.28
2020,CB2020,085,5,Staten Island,50147002008,110,60,50,5.27
2020,CB2020,085,5,Staten Island,50147002009,37,22,15,1.9
2020,CB2020,085,5,Staten Island,50147002010,89,34,55,4.3
2020,CB2020,085,5,Staten Island,50147002011,53,30,23,2.09
2020,CB2020,085,5,Staten Island,50147002012,46,26,20,3.25
2020,CB2020,085,5,Staten Island,50147002013,44,17,27,5.55
2020,CB2020,085,5,Staten Island,50147002014,54,16,38,2.11
2020,CB2020,085,5,Staten Island,50147002015,84,44,40,4.31
2020,CB2020,085,5,Staten Island,50147002016,91,41,50,4.31
2020,CB2020,085,5,Staten Island,50147002017,51,30,21,2.63
2020,CB2020,085,5,Staten Island,50147002018,48,30,18,2.47
2020,CB2020,085,5,Staten Island,50147003000,98,30,68,4.64
2020,CB2020,085,5,Staten Island,50147003001,218,101,117,11.32
2020,CB2020,085,5,Staten Island,50147003002,74,29,45,3.86
2020,CB2020,085,5,Staten Island,50147003003,107,36,71,3.43
2020,CB2020,085,5,Staten Island,50147003004,149,78,71,7.59
2020,CB2020,085,5,Staten Island,50147003005,51,5,46,2.27
2020,CB2020,085,5,Staten Island,50147003006,49,22,27,2.38
2020,CB2020,085,5,Staten Island,50147003007,24,13,11,2.4
2020,CB2020,085,5,Staten Island,50147003008,133,74,59,4
2020,CB2020,085,5,Staten Island,50147003009,127,58,69,3.48
2020,CB2020,085,5,Staten Island,50147003010,89,58,31,3.92
2020,CB2020,085,5,Staten Island,50151001000,122,64,58,7.46
2020,CB2020,085,5,Staten Island,50151001001,256,150,106,5.49
2020,CB2020,085,5,Staten Island,50151001002,155,85,70,4.21
2020,CB2020,085,5,Staten Island,50151001003,96,54,42,4.1
2020,CB2020,085,5,Staten Island,50151001004,177,79,98,5.61
2020,CB2020,085,5,Staten Island,50151001005,18,13,5,0.36
2020,CB2020,085,5,Staten Island,50151001006,40,6,34,1.11
2020,CB2020,085,5,Staten Island,50151001007,24,4,20,0.73
2020,CB2020,085,5,Staten Island,50151001008,97,41,56,3.82
2020,CB2020,085,5,Staten Island,50151001009,126,61,65,3.63
2020,CB2020,085,5,Staten Island,50151001010,190,81,109,9.55
2020,CB2020,085,5,Staten Island,50151001011,56,23,33,2.06
2020,CB2020,085,5,Staten Island,50151001012,32,6,26,1.99
2020,CB2020,085,5,Staten Island,50151001013,48,28,20,3.23
2020,CB2020,085,5,Staten Island,50151001014,72,41,31,3.48
2020,CB2020,085,5,Staten Island,50151001015,201,101,100,10.84
2020,CB2020,085,5,Staten Island,50151001016,51,40,11,2.25
2020,CB2020,085,5,Staten Island,50151001017,29,8,21,2.1
2020,CB2020,085,5,Staten Island,50151001018,95,36,59,3.36
2020,CB2020,085,5,Staten Island,50151001019,81,26,55,2.83
2020,CB2020,085,5,Staten Island,50151002000,81,49,32,3.16
2020,CB2020,085,5,Staten Island,50151002001,68,27,41,4.76
2020,CB2020,085,5,Staten Island,50151002002,122,45,77,4
2020,CB2020,085,5,Staten Island,50151002003,17,9,8,1.38
2020,CB2020,085,5,Staten Island,50151002004,53,32,21,2.62
2020,CB2020,085,5,Staten Island,50151002005,54,24,30,2.87
2020,CB2020,085,5,Staten Island,50151002006,89,35,54,4.58
2020,CB2020,085,5,Staten Island,50151002007,46,26,20,1.46
2020,CB2020,085,5,Staten Island,50151002008,78,47,31,3.15
2020,CB2020,085,5,Staten Island,50151002009,111,58,53,4.39
2020,CB2020,085,5,Staten Island,50151003000,71,33,38,2.42
2020,CB2020,085,5,Staten Island,50151003001,110,76,34,5.35
2020,CB2020,085,5,Staten Island,50151003002,123,59,64,5.65
2020,CB2020,085,5,Staten Island,50151003003,88,27,61,5.82
2020,CB2020,085,5,Staten Island,50151003004,133,89,44,5.79
2020,CB2020,085,5,Staten Island,50151003005,56,28,28,2.76
2020,CB2020,085,5,Staten Island,50151003006,37,16,21,1.36
2020,CB2020,085,5,Staten Island,50151003007,115,51,64,3.22
2020,CB2020,085,5,Staten Island,50151004000,86,49,37,4.06
2020,CB2020,085,5,Staten Island,50151004001,79,42,37,4.09
2020,CB2020,085,5,Staten Island,50151004002,131,89,42,5.81
2020,CB2020,085,5,Staten Island,50151004003,104,43,61,5.99
2020,CB2020,085,5,Staten Island,50151004004,93,49,44,4.27
2020,CB2020,085,5,Staten Island,50151004005,80,55,25,4.26
2020,CB2020,085,5,Staten Island,50151004006,122,54,68,5.79
2020,CB2020,085,5,Staten Island,50151004007,69,37,32,4.24
2020,CB2020,085,5,Staten Island,50151004008,131,36,95,5.94
2020,CB2020,085,5,Staten Island,50151004009,114,40,74,5.86
2020,CB2020,085,5,Staten Island,50151005000,95,47,48,11.58
2020,CB2020,085,5,Staten Island,50151005001,95,63,32,4.21
2020,CB2020,085,5,Staten Island,50151005002,126,63,63,5.77
2020,CB2020,085,5,Staten Island,50151005003,149,60,89,5.91
2020,CB2020,085,5,Staten Island,50151005004,110,50,60,4.13
2020,CB2020,085,5,Staten Island,50151005005,37,21,16,2.55
2020,CB2020,085,5,Staten Island,50151005006,115,46,69,4.17
2020,CB2020,085,5,Staten Island,50151005007,154,73,81,5.86
2020,CB2020,085,5,Staten Island,50151005008,78,52,26,6.47
2020,CB2020,085,5,Staten Island,50151005009,63,26,37,4.39
2020,CB2020,085,5,Staten Island,50154000001,0,0,0,0
2020,CB2020,085,5,Staten Island,50154000002,0,0,0,0
2020,CB2020,085,5,Staten Island,50154000003,0,0,0,0
2020,CB2020,085,5,Staten Island,50154000004,0,0,0,0
2020,CB2020,085,5,Staten Island,50154000005,0,0,0,0
2020,CB2020,085,5,Staten Island,50154001000,0,0,0,25.36
2020,CB2020,085,5,Staten Island,50154001001,5,3,2,19.66
2020,CB2020,085,5,Staten Island,50154001002,0,0,0,330.12
2020,CB2020,085,5,Staten Island,50154001003,0,0,0,167.57
2020,CB2020,085,5,Staten Island,50154001004,0,0,0,0
2020,CB2020,085,5,Staten Island,50154001005,0,0,0,0
2020,CB2020,085,5,Staten Island,50154001006,0,0,0,0.35
2020,CB2020,085,5,Staten Island,50154001007,0,0,0,5.69
2020,CB2020,085,5,Staten Island,50156011000,204,98,106,17.01
2020,CB2020,085,5,Staten Island,50156011001,36,17,19,1.17
2020,CB2020,085,5,Staten Island,50156011002,310,142,168,27.93
2020,CB2020,085,5,Staten Island,50156011003,71,26,45,2.15
2020,CB2020,085,5,Staten Island,50156011004,54,30,24,1.2
2020,CB2020,085,5,Staten Island,50156011005,99,50,49,4.14
2020,CB2020,085,5,Staten Island,50156011006,107,58,49,4.16
2020,CB2020,085,5,Staten Island,50156011007,61,22,39,4.13
2020,CB2020,085,5,Staten Island,50156011008,139,73,66,5.55
2020,CB2020,085,5,Staten Island,50156011009,49,9,40,5.88
2020,CB2020,085,5,Staten Island,50156011010,0,0,0,0.38
2020,CB2020,085,5,Staten Island,50156011011,92,78,14,4.12
2020,CB2020,085,5,Staten Island,50156011012,65,28,37,4.19
2020,CB2020,085,5,Staten Island,50156012000,78,41,37,3.76
2020,CB2020,085,5,Staten Island,50156012001,63,29,34,3.3
2020,CB2020,085,5,Staten Island,50156012002,40,31,9,1.51
2020,CB2020,085,5,Staten Island,50156012003,30,19,11,2.37
2020,CB2020,085,5,Staten Island,50156012004,83,40,43,3.51
2020,CB2020,085,5,Staten Island,50156012005,100,65,35,3.89
2020,CB2020,085,5,Staten Island,50156012006,78,46,32,4.11
2020,CB2020,085,5,Staten Island,50156012007,92,46,46,4.33
2020,CB2020,085,5,Staten Island,50156012008,120,45,75,4.54
2020,CB2020,085,5,Staten Island,50156012009,161,65,96,9.35
2020,CB2020,085,5,Staten Island,50156012010,87,41,46,3.68
2020,CB2020,085,5,Staten Island,50156012011,86,36,50,3.13
2020,CB2020,085,5,Staten Island,50156012012,28,4,24,1.42
2020,CB2020,085,5,Staten Island,50156013000,60,27,33,2.91
2020,CB2020,085,5,Staten Island,50156013001,47,35,12,4.11
2020,CB2020,085,5,Staten Island,50156013002,40,19,21,3.82
2020,CB2020,085,5,Staten Island,50156013003,88,32,56,3.48
2020,CB2020,085,5,Staten Island,50156013004,124,62,62,4.06
2020,CB2020,085,5,Staten Island,50156013005,85,40,45,3.96
2020,CB2020,085,5,Staten Island,50156013006,65,41,24,3.15
2020,CB2020,085,5,Staten Island,50156013007,58,34,24,3.17
2020,CB2020,085,5,Staten Island,50156013008,110,56,54,3.23
2020,CB2020,085,5,Staten Island,50156013009,68,26,42,2.56
2020,CB2020,085,5,Staten Island,50156013010,82,27,55,3.44
2020,CB2020,085,5,Staten Island,50156013011,65,24,41,4.01
2020,CB2020,085,5,Staten Island,50156013012,161,82,79,8.07
2020,CB2020,085,5,Staten Island,50156014000,39,15,24,2.45
2020,CB2020,085,5,Staten Island,50156014001,29,17,12,1.82
2020,CB2020,085,5,Staten Island,50156014002,124,53,71,4.29
2020,CB2020,085,5,Staten Island,50156014003,92,39,53,3.92
2020,CB2020,085,5,Staten Island,50156014004,97,49,48,4.79
2020,CB2020,085,5,Staten Island,50156014005,98,42,56,5.2
2020,CB2020,085,5,Staten Island,50156014006,80,38,42,3.94
2020,CB2020,085,5,Staten Island,50156014007,88,43,45,4.38
2020,CB2020,085,5,Staten Island,50156014008,12,6,6,0.69
2020,CB2020,085,5,Staten Island,50156014009,112,47,65,4.48
2020,CB2020,085,5,Staten Island,50156014010,44,15,29,1.33
2020,CB2020,085,5,Staten Island,50156014011,43,32,11,2.97
2020,CB2020,085,5,Staten Island,50156014012,81,63,18,4.93
2020,CB2020,085,5,Staten Island,50156014013,67,23,44,4.19
2020,CB2020,085,5,Staten Island,50156015000,33,9,24,1.88
2020,CB2020,085,5,Staten Island,50156015001,48,33,15,3.36
2020,CB2020,085,5,Staten Island,50156015002,23,10,13,1.47
2020,CB2020,085,5,Staten Island,50156015003,34,23,11,1.17
2020,CB2020,085,5,Staten Island,50156015004,58,44,14,1.83
2020,CB2020,085,5,Staten Island,50156015005,70,29,41,2.96
2020,CB2020,085,5,Staten Island,50156015006,45,25,20,2.98
2020,CB2020,085,5,Staten Island,50156015007,69,38,31,3.37
2020,CB2020,085,5,Staten Island,50156015008,116,46,70,6.32
2020,CB2020,085,5,Staten Island,50156015009,129,74,55,6.33
2020,CB2020,085,5,Staten Island,50156015010,257,127,130,15.02
2020,CB2020,085,5,Staten Island,50156015011,133,52,81,5.1
2020,CB2020,085,5,Staten Island,50156015012,16,11,5,0.39
2020,CB2020,085,5,Staten Island,50156015013,102,38,64,5.81
2020,CB2020,085,5,Staten Island,50156015014,49,32,17,2.4
2020,CB2020,085,5,Staten Island,50156016000,68,24,44,2.68
2020,CB2020,085,5,Staten Island,50156016001,27,20,7,1.09
2020,CB2020,085,5,Staten Island,50156016002,0,0,0,6.79
2020,CB2020,085,5,Staten Island,50156016003,72,32,40,2.96
2020,CB2020,085,5,Staten Island,50156016004,89,42,47,2.78
2020,CB2020,085,5,Staten Island,50156016005,88,38,50,6.65
2020,CB2020,085,5,Staten Island,50156016006,150,75,75,4.46
2020,CB2020,085,5,Staten Island,50156016007,0,0,0,5.27
2020,CB2020,085,5,Staten Island,50156016008,99,41,58,5
2020,CB2020,085,5,Staten Island,50156016009,82,24,58,4.32
2020,CB2020,085,5,Staten Island,50156016010,68,35,33,4.15
2020,CB2020,085,5,Staten Island,50156016011,100,50,50,4.12
2020,CB2020,085,5,Staten Island,50156016012,86,54,32,4.15
2020,CB2020,085,5,Staten Island,50156016013,71,36,35,4.13
2020,CB2020,085,5,Staten Island,50156016014,57,29,28,2.7
2020,CB2020,085,5,Staten Island,50156016015,32,17,15,1.47
2020,CB2020,085,5,Staten Island,50156021000,32,18,14,1.45
2020,CB2020,085,5,Staten Island,50156021001,45,16,29,3.76
2020,CB2020,085,5,Staten Island,50156021002,38,25,13,2.89
2020,CB2020,085,5,Staten Island,50156021003,70,48,22,4.31
2020,CB2020,085,5,Staten Island,50156021004,67,44,23,4.49
2020,CB2020,085,5,Staten Island,50156021005,60,16,44,4.84
2020,CB2020,085,5,Staten Island,50156021006,71,29,42,3.49
2020,CB2020,085,5,Staten Island,50156021007,89,27,62,4.36
2020,CB2020,085,5,Staten Island,50156021008,68,26,42,4.32
2020,CB2020,085,5,Staten Island,50156021009,51,33,18,3.39
2020,CB2020,085,5,Staten Island,50156021010,65,31,34,3.73
2020,CB2020,085,5,Staten Island,50156021011,87,44,43,4.36
2020,CB2020,085,5,Staten Island,50156021012,74,36,38,4.64
2020,CB2020,085,5,Staten Island,50156022000,69,31,38,5.95
2020,CB2020,085,5,Staten Island,50156022001,68,21,47,5.41
2020,CB2020,085,5,Staten Island,50156022002,97,46,51,5.32
2020,CB2020,085,5,Staten Island,50156022003,77,21,56,5.45
2020,CB2020,085,5,Staten Island,50156022004,37,20,17,2.34
2020,CB2020,085,5,Staten Island,50156022005,102,40,62,4.28
2020,CB2020,085,5,Staten Island,50156022006,67,50,17,3.79
2020,CB2020,085,5,Staten Island,50156022007,62,34,28,3.74
2020,CB2020,085,5,Staten Island,50156022008,80,41,39,3.89
2020,CB2020,085,5,Staten Island,50156022009,59,40,19,3.87
2020,CB2020,085,5,Staten Island,50156022010,50,26,24,3.9
2020,CB2020,085,5,Staten Island,50156022011,61,24,37,3.91
2020,CB2020,085,5,Staten Island,50156022012,91,44,47,11.98
2020,CB2020,085,5,Staten Island,50156023000,116,47,69,6.2
2020,CB2020,085,5,Staten Island,50156023001,43,23,20,2.68
2020,CB2020,085,5,Staten Island,50156023002,42,15,27,2.55
2020,CB2020,085,5,Staten Island,50156023003,41,24,17,3.66
2020,CB2020,085,5,Staten Island,50156023004,58,33,25,3.46
2020,CB2020,085,5,Staten Island,50156023005,70,37,33,3.78
2020,CB2020,085,5,Staten Island,50156023006,72,49,23,3.93
2020,CB2020,085,5,Staten Island,50156023007,92,44,48,3.92
2020,CB2020,085,5,Staten Island,50156023008,0,0,0,4.06
2020,CB2020,085,5,Staten Island,50156023009,60,20,40,4.77
2020,CB2020,085,5,Staten Island,50156023010,61,29,32,2.83
2020,CB2020,085,5,Staten Island,50156023011,61,22,39,2.81
2020,CB2020,085,5,Staten Island,50156023012,41,10,31,3.01
2020,CB2020,085,5,Staten Island,50156024000,102,57,45,4.66
2020,CB2020,085,5,Staten Island,50156024001,81,32,49,4.72
2020,CB2020,085,5,Staten Island,50156024002,90,42,48,5.81
2020,CB2020,085,5,Staten Island,50156024003,120,69,51,5.29
2020,CB2020,085,5,Staten Island,50156024004,82,40,42,4.98
2020,CB2020,085,5,Staten Island,50156024005,76,29,47,4.84
2020,CB2020,085,5,Staten Island,50156024006,53,23,30,4.11
2020,CB2020,085,5,Staten Island,50156024007,67,31,36,3.7
2020,CB2020,085,5,Staten Island,50156024008,47,23,24,4.14
2020,CB2020,085,5,Staten Island,50156024009,53,26,27,4.57
2020,CB2020,085,5,Staten Island,50156024010,74,38,36,4.66
2020,CB2020,085,5,Staten Island,50156024011,57,33,24,4.71
2020,CB2020,085,5,Staten Island,50156030001,0,0,0,0
2020,CB2020,085,5,Staten Island,50156030002,0,0,0,0
2020,CB2020,085,5,Staten Island,50156030003,0,0,0,0
2020,CB2020,085,5,Staten Island,50156031000,123,68,55,3.77
2020,CB2020,085,5,Staten Island,50156031001,107,53,54,3.6
2020,CB2020,085,5,Staten Island,50156031002,47,18,29,2.38
2020,CB2020,085,5,Staten Island,50156031003,130,60,70,5.79
2020,CB2020,085,5,Staten Island,50156031004,61,23,38,1.62
2020,CB2020,085,5,Staten Island,50156031005,202,99,103,34.47
2020,CB2020,085,5,Staten Island,50156031006,105,53,52,2.22
2020,CB2020,085,5,Staten Island,50156031007,185,105,80,5.16
2020,CB2020,085,5,Staten Island,50156031008,198,92,106,7.21
2020,CB2020,085,5,Staten Island,50156032000,256,150,106,9.8
2020,CB2020,085,5,Staten Island,50156032001,275,126,149,9.04
2020,CB2020,085,5,Staten Island,50156032002,182,80,102,5.59
2020,CB2020,085,5,Staten Island,50156032003,142,75,67,4.99
2020,CB2020,085,5,Staten Island,50156032004,77,32,45,2.99
2020,CB2020,085,5,Staten Island,50156032005,88,47,41,3.2
2020,CB2020,085,5,Staten Island,50156032006,126,80,46,5.1
2020,CB2020,085,5,Staten Island,50156032007,84,66,18,2.04
2020,CB2020,085,5,Staten Island,50156032008,34,10,24,4.74
2020,CB2020,085,5,Staten Island,50156032009,32,8,24,12.93
2020,CB2020,085,5,Staten Island,50156032010,85,49,36,1.6
2020,CB2020,085,5,Staten Island,50156032011,32,13,19,1.1
2020,CB2020,085,5,Staten Island,50156032012,25,8,17,1.13
2020,CB2020,085,5,Staten Island,50156032013,124,30,94,3.99
2020,CB2020,085,5,Staten Island,50156032014,145,76,69,3.69
2020,CB2020,085,5,Staten Island,50156032015,139,57,82,4.04
2020,CB2020,085,5,Staten Island,50156033000,142,42,100,5.11
2020,CB2020,085,5,Staten Island,50156033001,66,4,62,1.19
2020,CB2020,085,5,Staten Island,50156033002,270,145,125,9.53
2020,CB2020,085,5,Staten Island,50156033003,174,79,95,38.29
2020,CB2020,085,5,Staten Island,50156033004,107,28,79,5.22
2020,CB2020,085,5,Staten Island,50156033005,36,16,20,2.32
2020,CB2020,085,5,Staten Island,50156033006,88,57,31,3.71
2020,CB2020,085,5,Staten Island,50156033007,86,45,41,3.69
2020,CB2020,085,5,Staten Island,50156033008,96,38,58,3.53
2020,CB2020,085,5,Staten Island,50156033009,80,43,37,2.24
2020,CB2020,085,5,Staten Island,50156033010,39,36,3,1.95
2020,CB2020,085,5,Staten Island,50156033011,90,24,66,3.55
2020,CB2020,085,5,Staten Island,50156033012,60,26,34,4.59
2020,CB2020,085,5,Staten Island,50156033013,294,171,123,8.02
2020,CB2020,085,5,Staten Island,50156033014,71,44,27,1.82
2020,CB2020,085,5,Staten Island,50156033015,73,56,17,2.56
2020,CB2020,085,5,Staten Island,50169011000,114,38,76,4.67
2020,CB2020,085,5,Staten Island,50169011001,77,37,40,5.15
2020,CB2020,085,5,Staten Island,50169011002,56,24,32,3.34
2020,CB2020,085,5,Staten Island,50169011003,35,24,11,3.43
2020,CB2020,085,5,Staten Island,50169011004,173,97,76,11.39
2020,CB2020,085,5,Staten Island,50169011005,47,28,19,7.14
2020,CB2020,085,5,Staten Island,50169011006,45,30,15,4.67
2020,CB2020,085,5,Staten Island,50169011007,58,47,11,2.25
2020,CB2020,085,5,Staten Island,50169011008,42,28,14,3.12
2020,CB2020,085,5,Staten Island,50169011009,26,5,21,3.38
2020,CB2020,085,5,Staten Island,50169011010,42,22,20,3.93
2020,CB2020,085,5,Staten Island,50169011011,40,14,26,2.66
2020,CB2020,085,5,Staten Island,50169011012,15,4,11,1.45
2020,CB2020,085,5,Staten Island,50169011013,113,45,68,9.76
2020,CB2020,085,5,Staten Island,50169011014,65,44,21,21.37
2020,CB2020,085,5,Staten Island,50169011015,60,38,22,2.59
2020,CB2020,085,5,Staten Island,50169011016,53,21,32,2.45
2020,CB2020,085,5,Staten Island,50169011017,33,5,28,4.5
2020,CB2020,085,5,Staten Island,50169011018,95,29,66,4.15
2020,CB2020,085,5,Staten Island,50169011019,0,0,0,4.28
2020,CB2020,085,5,Staten Island,50169011020,0,0,0,2.6
2020,CB2020,085,5,Staten Island,50169011021,0,0,0,6.29
2020,CB2020,085,5,Staten Island,50169011022,60,20,40,2.24
2020,CB2020,085,5,Staten Island,50169011023,49,30,19,3.25
2020,CB2020,085,5,Staten Island,50169011024,39,23,16,2.25
2020,CB2020,085,5,Staten Island,50169011025,0,0,0,1.16
2020,CB2020,085,5,Staten Island,50169012000,28,5,23,2.05
2020,CB2020,085,5,Staten Island,50169012001,37,16,21,2.12
2020,CB2020,085,5,Staten Island,50169012002,70,21,49,4.23
2020,CB2020,085,5,Staten Island,50169012003,124,48,76,7.36
2020,CB2020,085,5,Staten Island,50169012004,240,134,106,7.1
2020,CB2020,085,5,Staten Island,50169012005,46,21,25,3.67
2020,CB2020,085,5,Staten Island,50169012006,112,79,33,3.63
2020,CB2020,085,5,Staten Island,50169012007,62,30,32,1.68
2020,CB2020,085,5,Staten Island,50169012008,67,21,46,2.75
2020,CB2020,085,5,Staten Island,50169012009,137,69,68,3.07
2020,CB2020,085,5,Staten Island,50169012010,172,94,78,3.09
2020,CB2020,085,5,Staten Island,50169012011,89,51,38,2.85
2020,CB2020,085,5,Staten Island,50169012012,70,35,35,2.92
2020,CB2020,085,5,Staten Island,50169012013,48,15,33,2.28
2020,CB2020,085,5,Staten Island,50169012014,95,52,43,2.88
2020,CB2020,085,5,Staten Island,50169012015,30,16,14,2.26
2020,CB2020,085,5,Staten Island,50169012016,119,69,50,3.05
2020,CB2020,085,5,Staten Island,50169012017,126,57,69,3.13
2020,CB2020,085,5,Staten Island,50169012018,77,29,48,1.79
2020,CB2020,085,5,Staten Island,50169012019,41,23,18,2.41
2020,CB2020,085,5,Staten Island,50169012020,57,32,25,2.86
2020,CB2020,085,5,Staten Island,50169012021,0,0,0,0.91
2020,CB2020,085,5,Staten Island,50169012022,0,0,0,6.66
2020,CB2020,085,5,Staten Island,50169012023,0,0,0,0.33
2020,CB2020,085,5,Staten Island,50169012024,29,14,15,1.06
2020,CB2020,085,5,Staten Island,50169012025,0,0,0,3.86
2020,CB2020,085,5,Staten Island,50170051000,0,0,0,1.36
2020,CB2020,085,5,Staten Island,50170051001,80,24,56,9.45
2020,CB2020,085,5,Staten Island,50170051002,76,35,41,4.95
2020,CB2020,085,5,Staten Island,50170051003,87,49,38,4.94
2020,CB2020,085,5,Staten Island,50170051004,151,85,66,10.22
2020,CB2020,085,5,Staten Island,50170051005,0,0,0,0.42
2020,CB2020,085,5,Staten Island,50170051006,98,69,29,17.39
2020,CB2020,085,5,Staten Island,50170051007,129,55,74,10.78
2020,CB2020,085,5,Staten Island,50170051008,86,31,55,4.53
2020,CB2020,085,5,Staten Island,50170051009,80,57,23,9.09
2020,CB2020,085,5,Staten Island,50170051010,0,0,0,3.31
2020,CB2020,085,5,Staten Island,50170051011,0,0,0,10.57
2020,CB2020,085,5,Staten Island,50170051012,0,0,0,2.84
2020,CB2020,085,5,Staten Island,50170051013,0,0,0,0.7
2020,CB2020,085,5,Staten Island,50170051014,0,0,0,1.2
2020,CB2020,085,5,Staten Island,50170051015,75,15,60,3.43
2020,CB2020,085,5,Staten Island,50170051016,119,76,43,5.57
2020,CB2020,085,5,Staten Island,50170051017,37,12,25,17.17
2020,CB2020,085,5,Staten Island,50170051018,96,44,52,8.06
2020,CB2020,085,5,Staten Island,50170051019,65,42,23,6.19
2020,CB2020,085,5,Staten Island,50170051020,77,45,32,2.59
2020,CB2020,085,5,Staten Island,50170051021,73,28,45,3.82
2020,CB2020,085,5,Staten Island,50170051022,90,44,46,4.8
2020,CB2020,085,5,Staten Island,50170051023,95,29,66,4.41
2020,CB2020,085,5,Staten Island,50170051024,13,10,3,1.11
2020,CB2020,085,5,Staten Island,50170051025,16,6,10,1.72
2020,CB2020,085,5,Staten Island,50170051026,122,62,60,4.43
2020,CB2020,085,5,Staten Island,50170051027,88,32,56,2.67
2020,CB2020,085,5,Staten Island,50170051028,107,45,62,4.65
2020,CB2020,085,5,Staten Island,50170051029,76,47,29,4.29
2020,CB2020,085,5,Staten Island,50170051030,33,22,11,3.41
2020,CB2020,085,5,Staten Island,50170051031,156,82,74,31.17
2020,CB2020,085,5,Staten Island,50170051032,69,29,40,4.08
2020,CB2020,085,5,Staten Island,50170051033,70,42,28,4.4
2020,CB2020,085,5,Staten Island,50170051034,44,35,9,4.13
2020,CB2020,085,5,Staten Island,50170051035,100,38,62,2.84
2020,CB2020,085,5,Staten Island,50170051036,64,30,34,3.69
2020,CB2020,085,5,Staten Island,50170051037,36,22,14,2.44
2020,CB2020,085,5,Staten Island,50170051038,77,16,61,4.36
2020,CB2020,085,5,Staten Island,50170051039,40,28,12,2.32
2020,CB2020,085,5,Staten Island,50170051040,48,25,23,2.54
2020,CB2020,085,5,Staten Island,50170051041,49,12,37,3.53
2020,CB2020,085,5,Staten Island,50170051042,39,26,13,2.7
2020,CB2020,085,5,Staten Island,50170052000,121,71,50,4.23
2020,CB2020,085,5,Staten Island,50170052001,99,54,45,3.6
2020,CB2020,085,5,Staten Island,50170052002,157,66,91,3.51
2020,CB2020,085,5,Staten Island,50170052003,81,33,48,7.93
2020,CB2020,085,5,Staten Island,50170052004,68,28,40,1.97
2020,CB2020,085,5,Staten Island,50170052005,98,48,50,3.96
2020,CB2020,085,5,Staten Island,50170052006,49,20,29,3.3
2020,CB2020,085,5,Staten Island,50170052007,21,19,2,0.48
2020,CB2020,085,5,Staten Island,50170052008,97,37,60,5.83
2020,CB2020,085,5,Staten Island,50170052009,181,88,93,12.48
2020,CB2020,085,5,Staten Island,50170052010,135,52,83,3.54
2020,CB2020,085,5,Staten Island,50170052011,172,84,88,4.23
2020,CB2020,085,5,Staten Island,50170052012,71,12,59,4.23
2020,CB2020,085,5,Staten Island,50170052013,80,43,37,2.57
2020,CB2020,085,5,Staten Island,50170052014,64,29,35,2.93
2020,CB2020,085,5,Staten Island,50170052015,8,2,6,3.04
2020,CB2020,085,5,Staten Island,50170052016,63,38,25,4.31
2020,CB2020,085,5,Staten Island,50170052017,85,64,21,5.13
2020,CB2020,085,5,Staten Island,50170052018,129,55,74,4.97
2020,CB2020,085,5,Staten Island,50170052019,67,33,34,3.87
2020,CB2020,085,5,Staten Island,50170052020,32,15,17,2.41
2020,CB2020,085,5,Staten Island,50170052021,27,13,14,2.54
2020,CB2020,085,5,Staten Island,50170052022,34,23,11,2.17
2020,CB2020,085,5,Staten Island,50170052023,124,54,70,8.89
2020,CB2020,085,5,Staten Island,50170052024,21,15,6,2.99
2020,CB2020,085,5,Staten Island,50170071000,1259,602,657,273.42
2020,CB2020,085,5,Staten Island,50170071001,105,56,49,1.39
2020,CB2020,085,5,Staten Island,50170071002,52,38,14,0.77
2020,CB2020,085,5,Staten Island,50170071003,145,49,96,2.73
2020,CB2020,085,5,Staten Island,50170071004,110,67,43,1.06
2020,CB2020,085,5,Staten Island,50170071005,74,47,27,3.81
2020,CB2020,085,5,Staten Island,50170071006,88,24,64,1.86
2020,CB2020,085,5,Staten Island,50170071007,104,42,62,5.75
2020,CB2020,085,5,Staten Island,50170071008,130,65,65,2.56
2020,CB2020,085,5,Staten Island,50170071009,96,61,35,1.98
2020,CB2020,085,5,Staten Island,50170072000,157,74,83,3.12
2020,CB2020,085,5,Staten Island,50170072001,168,69,99,3.06
2020,CB2020,085,5,Staten Island,50170072002,890,461,429,17.11
2020,CB2020,085,5,Staten Island,50170072003,201,92,109,3.12
2020,CB2020,085,5,Staten Island,50170072004,147,73,74,3.41
2020,CB2020,085,5,Staten Island,50170072005,115,70,45,3.22
2020,CB2020,085,5,Staten Island,50170072006,109,44,65,3.19
2020,CB2020,085,5,Staten Island,50170073000,732,348,384,16.99
2020,CB2020,085,5,Staten Island,50170073001,418,215,203,6.53
2020,CB2020,085,5,Staten Island,50170073002,426,207,219,5.79
2020,CB2020,085,5,Staten Island,50170091000,64,31,33,5.45
2020,CB2020,085,5,Staten Island,50170091001,44,19,25,4.66
2020,CB2020,085,5,Staten Island,50170091002,38,20,18,3.23
2020,CB2020,085,5,Staten Island,50170091003,96,44,52,4.68
2020,CB2020,085,5,Staten Island,50170091004,72,46,26,4.63
2020,CB2020,085,5,Staten Island,50170091005,91,49,42,4.57
2020,CB2020,085,5,Staten Island,50170091006,108,46,62,13.96
2020,CB2020,085,5,Staten Island,50170091007,112,50,62,4.72
2020,CB2020,085,5,Staten Island,50170091008,62,14,48,4.58
2020,CB2020,085,5,Staten Island,50170091009,87,61,26,4.65
2020,CB2020,085,5,Staten Island,50170091010,44,25,19,2.78
2020,CB2020,085,5,Staten Island,50170091011,38,18,20,4.65
2020,CB2020,085,5,Staten Island,50170091012,75,44,31,4.46
2020,CB2020,085,5,Staten Island,50170091013,121,48,73,4.55
2020,CB2020,085,5,Staten Island,50170091014,106,55,51,4.61
2020,CB2020,085,5,Staten Island,50170092000,78,73,5,4.64
2020,CB2020,085,5,Staten Island,50170092001,100,58,42,4.62
2020,CB2020,085,5,Staten Island,50170092002,97,55,42,4.68
2020,CB2020,085,5,Staten Island,50170092003,108,37,71,4.64
2020,CB2020,085,5,Staten Island,50170092004,87,47,40,4.5
2020,CB2020,085,5,Staten Island,50170092005,98,47,51,4.53
2020,CB2020,085,5,Staten Island,50170092006,80,53,27,4.56
2020,CB2020,085,5,Staten Island,50170092007,110,49,61,4.64
2020,CB2020,085,5,Staten Island,50170092008,76,28,48,4.6
2020,CB2020,085,5,Staten Island,50170092009,96,40,56,4.49
2020,CB2020,085,5,Staten Island,50170092010,101,43,58,4.67
2020,CB2020,085,5,Staten Island,50170092011,91,23,68,4.43
2020,CB2020,085,5,Staten Island,50170092012,116,43,73,4.47
2020,CB2020,085,5,Staten Island,50170092013,111,56,55,4.63
2020,CB2020,085,5,Staten Island,50170092014,57,17,40,2.85
2020,CB2020,085,5,Staten Island,50170092015,0,0,0,3.42
2020,CB2020,085,5,Staten Island,50170092016,0,0,0,0.6
2020,CB2020,085,5,Staten Island,50170092017,0,0,0,5.68
2020,CB2020,085,5,Staten Island,50170092018,0,0,0,4.35
2020,CB2020,085,5,Staten Island,50170092019,71,43,28,4.1
2020,CB2020,085,5,Staten Island,50170092020,106,62,44,4.35
2020,CB2020,085,5,Staten Island,50170092021,110,49,61,4.46
2020,CB2020,085,5,Staten Island,50170092022,8,0,8,1.53
2020,CB2020,085,5,Staten Island,50170093000,81,44,37,5.61
2020,CB2020,085,5,Staten Island,50170093001,86,45,41,4.74
2020,CB2020,085,5,Staten Island,50170093002,99,48,51,4.76
2020,CB2020,085,5,Staten Island,50170093003,97,44,53,4.67
2020,CB2020,085,5,Staten Island,50170093004,80,38,42,4.73
2020,CB2020,085,5,Staten Island,50170093005,122,68,54,4.73
2020,CB2020,085,5,Staten Island,50170093006,99,49,50,4.7
2020,CB2020,085,5,Staten Island,50170093007,82,46,36,4.35
2020,CB2020,085,5,Staten Island,50170093008,0,0,0,5.65
2020,CB2020,085,5,Staten Island,50170093009,0,0,0,4.04
2020,CB2020,085,5,Staten Island,50170093010,0,0,0,1.45
2020,CB2020,085,5,Staten Island,50170093011,0,0,0,2.01
2020,CB2020,085,5,Staten Island,50170093012,27,12,15,2.44
2020,CB2020,085,5,Staten Island,50170093013,515,258,257,46.17
2020,CB2020,085,5,Staten Island,50170093014,179,68,111,11.71
2020,CB2020,085,5,Staten Island,50170093015,48,18,30,2.34
2020,CB2020,085,5,Staten Island,50170093016,38,30,8,2.8
2020,CB2020,085,5,Staten Island,50170093017,61,25,36,3.21
2020,CB2020,085,5,Staten Island,50170093018,0,0,0,0.41
2020,CB2020,085,5,Staten Island,50170111000,115,63,52,3.52
2020,CB2020,085,5,Staten Island,50170111001,105,53,52,4.03
2020,CB2020,085,5,Staten Island,50170111002,154,65,89,4.43
2020,CB2020,085,5,Staten Island,50170111003,202,94,108,9.86
2020,CB2020,085,5,Staten Island,50170111004,81,30,51,2.78
2020,CB2020,085,5,Staten Island,50170111005,148,76,72,4.06
2020,CB2020,085,5,Staten Island,50170111006,106,39,67,3.58
2020,CB2020,085,5,Staten Island,50170111007,83,62,21,3.65
2020,CB2020,085,5,Staten Island,50170111008,151,55,96,4.21
2020,CB2020,085,5,Staten Island,50170111009,113,76,37,3.63
2020,CB2020,085,5,Staten Island,50170111010,137,35,102,4.03
2020,CB2020,085,5,Staten Island,50170111011,117,59,58,4.42
2020,CB2020,085,5,Staten Island,50170111012,80,37,43,3.52
2020,CB2020,085,5,Staten Island,50170111013,110,60,50,4.38
2020,CB2020,085,5,Staten Island,50170111014,91,25,66,3.99
2020,CB2020,085,5,Staten Island,50170111015,133,51,82,4.07
2020,CB2020,085,5,Staten Island,50170111016,178,83,95,4.44
2020,CB2020,085,5,Staten Island,50170111017,167,87,80,5.92
2020,CB2020,085,5,Staten Island,50170111018,120,69,51,5.19
2020,CB2020,085,5,Staten Island,50170111019,96,69,27,4.76
2020,CB2020,085,5,Staten Island,50170111020,44,25,19,1.68
2020,CB2020,085,5,Staten Island,50170112000,98,67,31,4.7
2020,CB2020,085,5,Staten Island,50170112001,52,27,25,3.02
2020,CB2020,085,5,Staten Island,50170112002,73,39,34,4.08
2020,CB2020,085,5,Staten Island,50170112003,98,56,42,3.42
2020,CB2020,085,5,Staten Island,50170112004,328,156,172,9.93
2020,CB2020,085,5,Staten Island,50170112005,54,34,20,1.92
2020,CB2020,085,5,Staten Island,50170112006,194,89,105,5.79
2020,CB2020,085,5,Staten Island,50170112007,98,38,60,3.41
2020,CB2020,085,5,Staten Island,50170112008,102,54,48,3.54
2020,CB2020,085,5,Staten Island,50170112009,109,37,72,3.45
2020,CB2020,085,5,Staten Island,50170112010,126,77,49,6.89
2020,CB2020,085,5,Staten Island,50170112011,197,66,131,10.2
2020,CB2020,085,5,Staten Island,50170112012,196,84,112,9.22
2020,CB2020,085,5,Staten Island,50170112013,96,36,60,5.43
2020,CB2020,085,5,Staten Island,50170112014,64,34,30,3.02
2020,CB2020,085,5,Staten Island,50170112015,54,28,26,3.66
2020,CB2020,085,5,Staten Island,50170112016,57,29,28,2.82
2020,CB2020,085,5,Staten Island,50170112017,31,15,16,0.84
2020,CB2020,085,5,Staten Island,50170112018,29,19,10,2.25
2020,CB2020,085,5,Staten Island,50170121000,0,0,0,19.85
2020,CB2020,085,5,Staten Island,50170121001,148,59,89,3.56
2020,CB2020,085,5,Staten Island,50170121002,95,41,54,2.57
2020,CB2020,085,5,Staten Island,50170121003,61,19,42,1.89
2020,CB2020,085,5,Staten Island,50170121004,78,27,51,2.87
2020,CB2020,085,5,Staten Island,50170121005,171,87,84,5.27
2020,CB2020,085,5,Staten Island,50170121006,0,0,0,0.26
2020,CB2020,085,5,Staten Island,50170121007,0,0,0,2.91
2020,CB2020,085,5,Staten Island,50170121008,72,43,29,4.55
2020,CB2020,085,5,Staten Island,50170121009,280,137,143,12.41
2020,CB2020,085,5,Staten Island,50170121010,74,45,29,3.57
2020,CB2020,085,5,Staten Island,50170121011,80,38,42,3.64
2020,CB2020,085,5,Staten Island,50170121012,78,21,57,3.54
2020,CB2020,085,5,Staten Island,50170121013,83,45,38,3.64
2020,CB2020,085,5,Staten Island,50170121014,166,80,86,4.71
2020,CB2020,085,5,Staten Island,50170121015,83,49,34,3.63
2020,CB2020,085,5,Staten Island,50170121016,105,63,42,3.54
2020,CB2020,085,5,Staten Island,50170121017,41,16,25,0.56
2020,CB2020,085,5,Staten Island,50170122000,92,56,36,3.6
2020,CB2020,085,5,Staten Island,50170122001,81,40,41,4.1
2020,CB2020,085,5,Staten Island,50170122002,101,68,33,2.94
2020,CB2020,085,5,Staten Island,50170122003,146,64,82,4.94
2020,CB2020,085,5,Staten Island,50170122004,74,23,51,2.98
2020,CB2020,085,5,Staten Island,50170122005,108,53,55,4.04
2020,CB2020,085,5,Staten Island,50170122006,103,42,61,3.53
2020,CB2020,085,5,Staten Island,50170122007,84,48,36,3.62
2020,CB2020,085,5,Staten Island,50170122008,124,63,61,4.15
2020,CB2020,085,5,Staten Island,50170122009,83,46,37,3.11
2020,CB2020,085,5,Staten Island,50170122010,89,52,37,3.14
2020,CB2020,085,5,Staten Island,50170122011,104,48,56,4.12
2020,CB2020,085,5,Staten Island,50170122012,0,0,0,3.6
2020,CB2020,085,5,Staten Island,50170122013,69,23,46,3.58
2020,CB2020,085,5,Staten Island,50170122014,84,34,50,4.08
2020,CB2020,085,5,Staten Island,50170122015,84,31,53,3.14
2020,CB2020,085,5,Staten Island,50170122016,90,43,47,3.27
2020,CB2020,085,5,Staten Island,50170122017,139,59,80,4.51
2020,CB2020,085,5,Staten Island,50170122018,99,51,48,4.12
2020,CB2020,085,5,Staten Island,50170122019,82,42,40,3.61
2020,CB2020,085,5,Staten Island,50170123000,0,0,0,6.2
2020,CB2020,085,5,Staten Island,50170123001,0,0,0,0.7
2020,CB2020,085,5,Staten Island,50170123002,0,0,0,4.75
2020,CB2020,085,5,Staten Island,50170123003,120,76,44,4.01
2020,CB2020,085,5,Staten Island,50170123004,158,67,91,10
2020,CB2020,085,5,Staten Island,50170123005,23,17,6,2.86
2020,CB2020,085,5,Staten Island,50170123006,119,62,57,7.17
2020,CB2020,085,5,Staten Island,50170123007,0,0,0,0.86
2020,CB2020,085,5,Staten Island,50170123008,0,0,0,2.22
2020,CB2020,085,5,Staten Island,50170123009,206,103,103,16.95
2020,CB2020,085,5,Staten Island,50170123010,63,18,45,2.3
2020,CB2020,085,5,Staten Island,50170123011,83,27,56,3.76
2020,CB2020,085,5,Staten Island,50170123012,250,126,124,9.04
2020,CB2020,085,5,Staten Island,50170131000,1032,452,580,40.94
2020,CB2020,085,5,Staten Island,50170131001,54,42,12,0.98
2020,CB2020,085,5,Staten Island,50170131002,95,41,54,2.61
2020,CB2020,085,5,Staten Island,50170131003,155,72,83,2.89
2020,CB2020,085,5,Staten Island,50170131004,38,12,26,0.99
2020,CB2020,085,5,Staten Island,50170131005,108,57,51,3.83
2020,CB2020,085,5,Staten Island,50170131006,204,96,108,3.48
2020,CB2020,085,5,Staten Island,50170131007,146,81,65,3.3
2020,CB2020,085,5,Staten Island,50170131008,43,17,26,2.14
2020,CB2020,085,5,Staten Island,50170131009,62,34,28,1.35
2020,CB2020,085,5,Staten Island,50170131010,98,39,59,1.8
2020,CB2020,085,5,Staten Island,50170131011,0,0,0,0.44
2020,CB2020,085,5,Staten Island,50170131012,91,69,22,2.67
2020,CB2020,085,5,Staten Island,50170132000,1276,624,652,47.62
2020,CB2020,085,5,Staten Island,50170132001,175,75,100,4.71
2020,CB2020,085,5,Staten Island,50170132002,179,108,71,3.54
2020,CB2020,085,5,Staten Island,50170132003,261,152,109,6.78
2020,CB2020,085,5,Staten Island,50170132004,316,141,175,7.48
2020,CB2020,085,5,Staten Island,50170141000,1219,572,647,31.81
2020,CB2020,085,5,Staten Island,50170141001,156,70,86,3.09
2020,CB2020,085,5,Staten Island,50170141002,180,93,87,5.9
2020,CB2020,085,5,Staten Island,50170141003,141,54,87,1.94
2020,CB2020,085,5,Staten Island,50170141004,198,105,93,3.38
2020,CB2020,085,5,Staten Island,50170141005,238,111,127,3.25
2020,CB2020,085,5,Staten Island,50170141006,306,146,160,7.59
2020,CB2020,085,5,Staten Island,50170141007,132,73,59,1.68
2020,CB2020,085,5,Staten Island,50170141008,113,67,46,2.84
2020,CB2020,085,5,Staten Island,50170142000,101,46,55,5.97
2020,CB2020,085,5,Staten Island,50170142001,182,85,97,11.8
2020,CB2020,085,5,Staten Island,50170142002,87,48,39,5.47
2020,CB2020,085,5,Staten Island,50170142003,112,65,47,4.91
2020,CB2020,085,5,Staten Island,50170142004,124,47,77,4.86
2020,CB2020,085,5,Staten Island,50170142005,94,46,48,5.11
2020,CB2020,085,5,Staten Island,50170142006,184,87,97,4.01
2020,CB2020,085,5,Staten Island,50170142007,72,39,33,2.88
2020,CB2020,085,5,Staten Island,50170142008,103,58,45,3.04
2020,CB2020,085,5,Staten Island,50170142009,79,29,50,2.57
2020,CB2020,085,5,Staten Island,50170142010,33,7,26,0.74
2020,CB2020,085,5,Staten Island,50170142011,17,2,15,8.63
2020,CB2020,085,5,Staten Island,50170142012,103,65,38,3.29
2020,CB2020,085,5,Staten Island,50170142013,94,41,53,2.64
2020,CB2020,085,5,Staten Island,50170142014,53,35,18,2.85
2020,CB2020,085,5,Staten Island,50170142015,105,40,65,3.46
2020,CB2020,085,5,Staten Island,50170142016,101,52,49,3.14
2020,CB2020,085,5,Staten Island,50170151000,171,76,95,5.69
2020,CB2020,085,5,Staten Island,50170151001,187,110,77,8.3
2020,CB2020,085,5,Staten Island,50170151002,146,57,89,3.71
2020,CB2020,085,5,Staten Island,50170151003,96,62,34,2.76
2020,CB2020,085,5,Staten Island,50170151004,225,103,122,7.42
2020,CB2020,085,5,Staten Island,50170151005,111,37,74,3.37
2020,CB2020,085,5,Staten Island,50170151006,188,87,101,6.08
2020,CB2020,085,5,Staten Island,50170151007,152,82,70,5.58
2020,CB2020,085,5,Staten Island,50170151008,110,71,39,2.98
2020,CB2020,085,5,Staten Island,50170151009,78,41,37,3.04
2020,CB2020,085,5,Staten Island,50170151010,49,25,24,2.89
2020,CB2020,085,5,Staten Island,50170151011,0,0,0,0.98
2020,CB2020,085,5,Staten Island,50170151012,0,0,0,1.09
2020,CB2020,085,5,Staten Island,50170151013,0,0,0,1.83
2020,CB2020,085,5,Staten Island,50170151014,0,0,0,3.48
2020,CB2020,085,5,Staten Island,50170151015,0,0,0,1.33
2020,CB2020,085,5,Staten Island,50170151016,62,26,36,2.32
2020,CB2020,085,5,Staten Island,50170151017,51,19,32,2.13
2020,CB2020,085,5,Staten Island,50170151018,45,13,32,2.06
2020,CB2020,085,5,Staten Island,50170151019,48,13,35,2.9
2020,CB2020,085,5,Staten Island,50170151020,121,75,46,4.11
2020,CB2020,085,5,Staten Island,50170151021,130,64,66,4.57
2020,CB2020,085,5,Staten Island,50170151022,94,32,62,4.64
2020,CB2020,085,5,Staten Island,50170151023,17,15,2,0.45
2020,CB2020,085,5,Staten Island,50170151024,117,48,69,1.69
2020,CB2020,085,5,Staten Island,50170151025,116,57,59,5.23
2020,CB2020,085,5,Staten Island,50170151026,84,33,51,4.62
2020,CB2020,085,5,Staten Island,50170151027,88,40,48,4.65
2020,CB2020,085,5,Staten Island,50170151028,86,43,43,4.6
2020,CB2020,085,5,Staten Island,50170151029,76,48,28,4.7
2020,CB2020,085,5,Staten Island,50170151030,65,34,31,3.89
2020,CB2020,085,5,Staten Island,50170161000,136,82,54,3.88
2020,CB2020,085,5,Staten Island,50170161001,45,25,20,2.06
2020,CB2020,085,5,Staten Island,50170161002,112,60,52,2.89
2020,CB2020,085,5,Staten Island,50170161003,106,47,59,3.89
2020,CB2020,085,5,Staten Island,50170161004,355,186,169,14.58
2020,CB2020,085,5,Staten Island,50170161005,88,51,37,3.65
2020,CB2020,085,5,Staten Island,50170161006,387,192,195,11.76
2020,CB2020,085,5,Staten Island,50170161007,111,42,69,3.84
2020,CB2020,085,5,Staten Island,50170161008,97,34,63,3.85
2020,CB2020,085,5,Staten Island,50170161009,35,23,12,0.84
2020,CB2020,085,5,Staten Island,50170161010,124,51,73,4.02
2020,CB2020,085,5,Staten Island,50170161011,119,34,85,3.56
2020,CB2020,085,5,Staten Island,50170161012,117,69,48,3.49
2020,CB2020,085,5,Staten Island,50170161013,89,47,42,3.22
2020,CB2020,085,5,Staten Island,50170161014,87,52,35,3.67
2020,CB2020,085,5,Staten Island,50170161015,83,27,56,3.37
2020,CB2020,085,5,Staten Island,50170161016,86,63,23,2.94
2020,CB2020,085,5,Staten Island,50170161017,0,0,0,5.6
2020,CB2020,085,5,Staten Island,50170161018,197,78,119,5.64
2020,CB2020,085,5,Staten Island,50170161019,111,59,52,3.27
2020,CB2020,085,5,Staten Island,50170162000,90,50,40,2.24
2020,CB2020,085,5,Staten Island,50170162001,163,99,64,4.39
2020,CB2020,085,5,Staten Island,50170162002,714,299,415,21.72
2020,CB2020,085,5,Staten Island,50170162003,118,61,57,4.78
2020,CB2020,085,5,Staten Island,50170162004,97,56,41,2.88
2020,CB2020,085,5,Staten Island,50170162005,113,57,56,3.04
2020,CB2020,085,5,Staten Island,50170162006,118,56,62,2.88
2020,CB2020,085,5,Staten Island,50170162007,176,87,89,4.75
2020,CB2020,085,5,Staten Island,50170162008,157,72,85,4.39
2020,CB2020,085,5,Staten Island,50170162009,105,43,62,4.47
2020,CB2020,085,5,Staten Island,50170162010,0,0,0,4.54
2020,CB2020,085,5,Staten Island,50170162011,127,46,81,5.57
2020,CB2020,085,5,Staten Island,50170162012,174,118,56,4.99
2020,CB2020,085,5,Staten Island,50170162013,0,0,0,2.78
2020,CB2020,085,5,Staten Island,50173001000,70,31,39,2.71
2020,CB2020,085,5,Staten Island,50173001001,70,22,48,2.49
2020,CB2020,085,5,Staten Island,50173001002,118,47,71,4
2020,CB2020,085,5,Staten Island,50173001003,76,37,39,3.93
2020,CB2020,085,5,Staten Island,50173001004,111,70,41,3.05
2020,CB2020,085,5,Staten Island,50173001005,68,22,46,2.61
2020,CB2020,085,5,Staten Island,50173001006,89,50,39,2.42
2020,CB2020,085,5,Staten Island,50173001007,52,36,16,1.97
2020,CB2020,085,5,Staten Island,50173001008,68,37,31,2.52
2020,CB2020,085,5,Staten Island,50173001009,56,34,22,4.07
2020,CB2020,085,5,Staten Island,50173001010,48,42,6,3.97
2020,CB2020,085,5,Staten Island,50173001011,112,42,70,3.07
2020,CB2020,085,5,Staten Island,50173001012,30,19,11,1.39
2020,CB2020,085,5,Staten Island,50173001013,0,0,0,1.48
2020,CB2020,085,5,Staten Island,50173001014,83,38,45,3.09
2020,CB2020,085,5,Staten Island,50173001015,62,20,42,3.63
2020,CB2020,085,5,Staten Island,50173001016,64,35,29,4.1
2020,CB2020,085,5,Staten Island,50173001017,117,69,48,4.4
2020,CB2020,085,5,Staten Island,50173001018,56,26,30,2.7
2020,CB2020,085,5,Staten Island,50173001019,46,24,22,6.36
2020,CB2020,085,5,Staten Island,50173001020,90,49,41,4.42
2020,CB2020,085,5,Staten Island,50173002000,1049,378,671,16.41
2020,CB2020,085,5,Staten Island,50176000001,0,0,0,0
2020,CB2020,085,5,Staten Island,50176001000,514,272,242,119.79
2020,CB2020,085,5,Staten Island,50176001001,22,15,7,3.28
2020,CB2020,085,5,Staten Island,50176001002,40,11,29,1.85
2020,CB2020,085,5,Staten Island,50176001003,262,116,146,81.25
2020,CB2020,085,5,Staten Island,50176001004,0,0,0,3.83
2020,CB2020,085,5,Staten Island,50176001005,53,21,32,3.88
2020,CB2020,085,5,Staten Island,50176001006,91,68,23,3.82
2020,CB2020,085,5,Staten Island,50176001007,55,21,34,3.88
2020,CB2020,085,5,Staten Island,50176001008,60,36,24,4.33
2020,CB2020,085,5,Staten Island,50176001009,57,29,28,3.02
2020,CB2020,085,5,Staten Island,50176001010,20,10,10,2.98
2020,CB2020,085,5,Staten Island,50176001011,65,44,21,3.09
2020,CB2020,085,5,Staten Island,50176001012,24,15,9,3.06
2020,CB2020,085,5,Staten Island,50176001013,53,20,33,2.78
2020,CB2020,085,5,Staten Island,50176001014,24,6,18,1.81
2020,CB2020,085,5,Staten Island,50176001015,17,3,14,3.63
2020,CB2020,085,5,Staten Island,50176001016,31,11,20,9.24
2020,CB2020,085,5,Staten Island,50176001017,64,23,41,3.47
2020,CB2020,085,5,Staten Island,50176001018,43,18,25,3.51
2020,CB2020,085,5,Staten Island,50176001019,14,5,9,14.93
2020,CB2020,085,5,Staten Island,50176002000,30,9,21,2.59
2020,CB2020,085,5,Staten Island,50176002001,29,12,17,3.2
2020,CB2020,085,5,Staten Island,50176002002,33,14,19,3.24
2020,CB2020,085,5,Staten Island,50176002003,27,6,21,2.65
2020,CB2020,085,5,Staten Island,50176002004,31,7,24,2.69
2020,CB2020,085,5,Staten Island,50176002005,43,20,23,3.24
2020,CB2020,085,5,Staten Island,50176002006,47,26,21,3.26
2020,CB2020,085,5,Staten Island,50176002007,22,10,12,2.81
2020,CB2020,085,5,Staten Island,50176002008,66,30,36,4.91
2020,CB2020,085,5,Staten Island,50176002009,27,5,22,2.89
2020,CB2020,085,5,Staten Island,50176002010,21,7,14,2.32
2020,CB2020,085,5,Staten Island,50176002011,44,35,9,2.33
2020,CB2020,085,5,Staten Island,50176002012,107,50,57,4.33
2020,CB2020,085,5,Staten Island,50176002013,97,62,35,5.34
2020,CB2020,085,5,Staten Island,50176002014,60,46,14,3.02
2020,CB2020,085,5,Staten Island,50176002015,64,20,44,3.03
2020,CB2020,085,5,Staten Island,50176002016,84,29,55,2.8
2020,CB2020,085,5,Staten Island,50176002017,66,38,28,3.51
2020,CB2020,085,5,Staten Island,50176002018,45,38,7,3.06
2020,CB2020,085,5,Staten Island,50176003000,57,28,29,2.28
2020,CB2020,085,5,Staten Island,50176003001,34,17,17,2.08
2020,CB2020,085,5,Staten Island,50176003002,105,50,55,50.16
2020,CB2020,085,5,Staten Island,50176003003,28,26,2,2.24
2020,CB2020,085,5,Staten Island,50176003004,22,1,21,2.11
2020,CB2020,085,5,Staten Island,50176003005,13,6,7,2.21
2020,CB2020,085,5,Staten Island,50176003006,104,46,58,5.35
2020,CB2020,085,5,Staten Island,50176003007,312,160,152,132.76
2020,CB2020,085,5,Staten Island,50176003008,50,34,16,2.88
2020,CB2020,085,5,Staten Island,50176003009,82,33,49,48.63
2020,CB2020,085,5,Staten Island,50176003010,28,17,11,2.3
2020,CB2020,085,5,Staten Island,50176003011,14,12,2,1.62
2020,CB2020,085,5,Staten Island,50176003012,16,13,3,2.66
2020,CB2020,085,5,Staten Island,50176003013,24,18,6,2.4
2020,CB2020,085,5,Staten Island,50176003014,0,0,0,1.41
2020,CB2020,085,5,Staten Island,50176003015,53,23,30,3.58
2020,CB2020,085,5,Staten Island,50176003016,0,0,0,1.36
2020,CB2020,085,5,Staten Island,50176003017,1,1,0,2.2
2020,CB2020,085,5,Staten Island,50176003018,79,34,45,40.71
2020,CB2020,085,5,Staten Island,50176003019,64,38,26,37.8
2020,CB2020,085,5,Staten Island,50176003020,47,28,19,4.79
2020,CB2020,085,5,Staten Island,50176003021,45,34,11,2.47
2020,CB2020,085,5,Staten Island,50176003022,27,3,24,2.43
2020,CB2020,085,5,Staten Island,50176003023,21,1,20,2.39
2020,CB2020,085,5,Staten Island,50176003024,16,1,15,2.29
2020,CB2020,085,5,Staten Island,50176003025,57,30,27,3.6
2020,CB2020,085,5,Staten Island,50176003026,58,29,29,5.21
2020,CB2020,085,5,Staten Island,50176004000,51,30,21,4.36
2020,CB2020,085,5,Staten Island,50176004001,50,23,27,4.37
2020,CB2020,085,5,Staten Island,50176004002,15,8,7,8.76
2020,CB2020,085,5,Staten Island,50176004003,65,31,34,4.3
2020,CB2020,085,5,Staten Island,50176004004,57,9,48,4.37
2020,CB2020,085,5,Staten Island,50176004005,69,36,33,4.32
2020,CB2020,085,5,Staten Island,50176004006,47,20,27,4.72
2020,CB2020,085,5,Staten Island,50176004007,17,12,5,1.08
2020,CB2020,085,5,Staten Island,50176004008,60,20,40,5.92
2020,CB2020,085,5,Staten Island,50176004009,34,14,20,2.94
2020,CB2020,085,5,Staten Island,50176004010,54,22,32,3.73
2020,CB2020,085,5,Staten Island,50176004011,97,47,50,4.24
2020,CB2020,085,5,Staten Island,50176004012,74,34,40,4.43
2020,CB2020,085,5,Staten Island,50176004013,102,48,54,4.05
2020,CB2020,085,5,Staten Island,50176004014,0,0,0,4.42
2020,CB2020,085,5,Staten Island,50176004015,35,32,3,2.57
2020,CB2020,085,5,Staten Island,50176004016,25,18,7,2.61
2020,CB2020,085,5,Staten Island,50176004017,29,19,10,7.84
2020,CB2020,085,5,Staten Island,50176004018,95,29,66,10.52
2020,CB2020,085,5,Staten Island,50176004019,40,17,23,2.6
2020,CB2020,085,5,Staten Island,50176004020,37,12,25,2.37
2020,CB2020,085,5,Staten Island,50176004021,39,34,5,2.07
2020,CB2020,085,5,Staten Island,50176004022,31,19,12,1.72
2020,CB2020,085,5,Staten Island,50177011000,0,0,0,4.18
2020,CB2020,085,5,Staten Island,50177011001,0,0,0,4.96
2020,CB2020,085,5,Staten Island,50177011002,516,246,270,25.51
2020,CB2020,085,5,Staten Island,50177011003,40,21,19,1.87
2020,CB2020,085,5,Staten Island,50177011004,23,1,22,3.6
2020,CB2020,085,5,Staten Island,50177011005,34,18,16,1.22
2020,CB2020,085,5,Staten Island,50177011006,30,19,11,3.95
2020,CB2020,085,5,Staten Island,50177011007,62,11,51,16.31
2020,CB2020,085,5,Staten Island,50177011008,20,1,19,1.85
2020,CB2020,085,5,Staten Island,50177011009,24,10,14,4.4
2020,CB2020,085,5,Staten Island,50177011010,35,26,9,2.98
2020,CB2020,085,5,Staten Island,50177011011,0,0,0,2.02
2020,CB2020,085,5,Staten Island,50177011012,128,66,62,17.27
2020,CB2020,085,5,Staten Island,50177011013,23,9,14,3.17
2020,CB2020,085,5,Staten Island,50177011014,35,4,31,2.27
2020,CB2020,085,5,Staten Island,50177011015,121,63,58,5.35
2020,CB2020,085,5,Staten Island,50177012000,0,0,0,26.31
2020,CB2020,085,5,Staten Island,50177012001,283,126,157,65.13
2020,CB2020,085,5,Staten Island,50177012002,63,37,26,3.38
2020,CB2020,085,5,Staten Island,50177012003,60,38,22,2.51
2020,CB2020,085,5,Staten Island,50177012004,61,33,28,3.58
2020,CB2020,085,5,Staten Island,50177012005,58,16,42,3.52
2020,CB2020,085,5,Staten Island,50177012006,46,12,34,3.15
2020,CB2020,085,5,Staten Island,50177012007,52,20,32,2.73
2020,CB2020,085,5,Staten Island,50177012008,21,15,6,1.95
2020,CB2020,085,5,Staten Island,50177012009,7,4,3,11.05
2020,CB2020,085,5,Staten Island,50177012010,23,13,10,1.77
2020,CB2020,085,5,Staten Island,50177012011,62,37,25,3.49
2020,CB2020,085,5,Staten Island,50177012012,218,109,109,88.84
2020,CB2020,085,5,Staten Island,50177012013,41,28,13,4.57
2020,CB2020,085,5,Staten Island,50177012014,54,7,47,6.66
2020,CB2020,085,5,Staten Island,50177012015,20,0,20,1.2
2020,CB2020,085,5,Staten Island,50177012016,59,42,17,5.43
2020,CB2020,085,5,Staten Island,50177012017,38,20,18,4.95
2020,CB2020,085,5,Staten Island,50177013000,49,23,26,10.2
2020,CB2020,085,5,Staten Island,50177013001,50,20,30,5.56
2020,CB2020,085,5,Staten Island,50177013002,64,36,28,11.14
2020,CB2020,085,5,Staten Island,50177013003,31,18,13,4.58
2020,CB2020,085,5,Staten Island,50177013004,35,12,23,4.78
2020,CB2020,085,5,Staten Island,50177013005,68,46,22,15.47
2020,CB2020,085,5,Staten Island,50177013006,15,8,7,12.91
2020,CB2020,085,5,Staten Island,50177013007,17,11,6,3.86
2020,CB2020,085,5,Staten Island,50177013008,13,2,11,2.73
2020,CB2020,085,5,Staten Island,50177013009,72,42,30,12.19
2020,CB2020,085,5,Staten Island,50177013010,131,60,71,21.21
2020,CB2020,085,5,Staten Island,50177013011,67,26,41,11.18
2020,CB2020,085,5,Staten Island,50177013012,151,78,73,19.99
2020,CB2020,085,5,Staten Island,50177014000,125,54,71,5.77
2020,CB2020,085,5,Staten Island,50177014001,763,364,399,128.21
2020,CB2020,085,5,Staten Island,50177014002,41,17,24,4.09
2020,CB2020,085,5,Staten Island,50177014003,81,59,22,11.34
2020,CB2020,085,5,Staten Island,50177014004,18,0,18,4.12
2020,CB2020,085,5,Staten Island,50177014005,33,15,18,3.88
2020,CB2020,085,5,Staten Island,50177014006,42,21,21,9.19
2020,CB2020,085,5,Staten Island,50177014007,77,44,33,4.85
2020,CB2020,085,5,Staten Island,50177014008,44,31,13,3.88
2020,CB2020,085,5,Staten Island,50177014009,36,20,16,2.62
2020,CB2020,085,5,Staten Island,50177014010,35,23,12,2.45
2020,CB2020,085,5,Staten Island,50177014011,64,14,50,3.03
2020,CB2020,085,5,Staten Island,50177014012,162,62,100,7.47
2020,CB2020,085,5,Staten Island,50177014013,153,79,74,55.74
2020,CB2020,085,5,Staten Island,50177014014,30,20,10,1.71
2020,CB2020,085,5,Staten Island,50177021000,57,23,34,3.19
2020,CB2020,085,5,Staten Island,50177021001,45,28,17,3.21
2020,CB2020,085,5,Staten Island,50177021002,41,33,8,2.31
2020,CB2020,085,5,Staten Island,50177021003,27,6,21,3.77
2020,CB2020,085,5,Staten Island,50177021004,112,55,57,3.57
2020,CB2020,085,5,Staten Island,50177021005,77,53,24,2.94
2020,CB2020,085,5,Staten Island,50177021006,55,22,33,2.36
2020,CB2020,085,5,Staten Island,50177021007,25,5,20,1.71
2020,CB2020,085,5,Staten Island,50177021008,77,36,41,6.18
2020,CB2020,085,5,Staten Island,50177021009,182,87,95,12.17
2020,CB2020,085,5,Staten Island,50177021010,114,56,58,6.32
2020,CB2020,085,5,Staten Island,50177021011,84,36,48,5.37
2020,CB2020,085,5,Staten Island,50177021012,37,14,23,2.57
2020,CB2020,085,5,Staten Island,50177021013,52,38,14,5.46
2020,CB2020,085,5,Staten Island,50177021014,181,99,82,12.26
2020,CB2020,085,5,Staten Island,50177021015,37,11,26,1.71
2020,CB2020,085,5,Staten Island,50177021016,12,0,12,0.52
2020,CB2020,085,5,Staten Island,50177021017,24,8,16,1.48
2020,CB2020,085,5,Staten Island,50177022000,208,101,107,14.32
2020,CB2020,085,5,Staten Island,50177022001,98,38,60,7.6
2020,CB2020,085,5,Staten Island,50177022002,132,52,80,6.18
2020,CB2020,085,5,Staten Island,50177022003,47,21,26,2.59
2020,CB2020,085,5,Staten Island,50177022004,56,29,27,3.19
2020,CB2020,085,5,Staten Island,50177022005,88,50,38,6.18
2020,CB2020,085,5,Staten Island,50177022006,56,32,24,2.41
2020,CB2020,085,5,Staten Island,50177022007,32,16,16,2.34
2020,CB2020,085,5,Staten Island,50177022008,67,44,23,3.51
2020,CB2020,085,5,Staten Island,50177022009,57,26,31,3.93
2020,CB2020,085,5,Staten Island,50177022010,90,63,27,3.91
2020,CB2020,085,5,Staten Island,50177022011,61,31,30,3.39
2020,CB2020,085,5,Staten Island,50177022012,61,48,13,3.83
2020,CB2020,085,5,Staten Island,50177022013,44,5,39,3.67
2020,CB2020,085,5,Staten Island,50177022014,17,8,9,0.89
2020,CB2020,085,5,Staten Island,50181001000,466,182,284,272.41
2020,CB2020,085,5,Staten Island,50181001001,0,0,0,2.05
2020,CB2020,085,5,Staten Island,50181001002,370,157,213,20.44
2020,CB2020,085,5,Staten Island,50181002000,445,215,230,425.92
2020,CB2020,085,5,Staten Island,50181002001,43,21,22,2.71
2020,CB2020,085,5,Staten Island,50181002002,7,2,5,1.73
2020,CB2020,085,5,Staten Island,50181002003,37,10,27,1.85
2020,CB2020,085,5,Staten Island,50181002004,25,10,15,1.85
2020,CB2020,085,5,Staten Island,50181002005,36,24,12,2.71
2020,CB2020,085,5,Staten Island,50181002006,35,23,12,2.72
2020,CB2020,085,5,Staten Island,50181002007,69,33,36,4.04
2020,CB2020,085,5,Staten Island,50181002008,48,27,21,2.76
2020,CB2020,085,5,Staten Island,50181002009,32,20,12,2.37
2020,CB2020,085,5,Staten Island,50181002010,19,16,3,1.87
2020,CB2020,085,5,Staten Island,50181002011,24,18,6,1.92
2020,CB2020,085,5,Staten Island,50181002012,4,0,4,5.18
2020,CB2020,085,5,Staten Island,50181002013,164,95,69,8.51
2020,CB2020,085,5,Staten Island,50181002014,161,54,107,8.77
2020,CB2020,085,5,Staten Island,50181002015,29,13,16,1.85
2020,CB2020,085,5,Staten Island,50181002016,57,35,22,2.78
2020,CB2020,085,5,Staten Island,50181002017,52,19,33,3.69
2020,CB2020,085,5,Staten Island,50181002018,60,23,37,3.78
2020,CB2020,085,5,Staten Island,50181002019,82,46,36,3.62
2020,CB2020,085,5,Staten Island,50181002020,156,72,84,8.32
2020,CB2020,085,5,Staten Island,50181002021,70,26,44,3.36
2020,CB2020,085,5,Staten Island,50181002022,91,41,50,20.77
2020,CB2020,085,5,Staten Island,50181002023,47,38,9,2.26
2020,CB2020,085,5,Staten Island,50181003000,12,10,2,5.43
2020,CB2020,085,5,Staten Island,50181003001,74,24,50,312.44
2020,CB2020,085,5,Staten Island,50181003002,133,60,73,19.5
2020,CB2020,085,5,Staten Island,50181003003,43,9,34,9.23
2020,CB2020,085,5,Staten Island,50181003004,30,16,14,7.38
2020,CB2020,085,5,Staten Island,50181003005,45,32,13,7.31
2020,CB2020,085,5,Staten Island,50181003006,66,35,31,12.5
2020,CB2020,085,5,Staten Island,50181003007,225,126,99,39.65
2020,CB2020,085,5,Staten Island,50181003008,10,3,7,1.47
2020,CB2020,085,5,Staten Island,50181003009,0,0,0,2.1
2020,CB2020,085,5,Staten Island,50181003010,32,14,18,3.62
2020,CB2020,085,5,Staten Island,50181003011,29,4,25,3.54
2020,CB2020,085,5,Staten Island,50181003012,17,14,3,2.31
2020,CB2020,085,5,Staten Island,50181003013,64,36,28,9.86
2020,CB2020,085,5,Staten Island,50181003014,26,19,7,2.54
2020,CB2020,085,5,Staten Island,50181003015,52,12,40,7.06
2020,CB2020,085,5,Staten Island,50181003016,60,39,21,15.07
2020,CB2020,085,5,Staten Island,50181003017,22,19,3,3.39
2020,CB2020,085,5,Staten Island,50187011000,114,55,59,3.89
2020,CB2020,085,5,Staten Island,50187011001,95,52,43,5.19
2020,CB2020,085,5,Staten Island,50187011002,135,78,57,5.48
2020,CB2020,085,5,Staten Island,50187011003,149,35,114,5.59
2020,CB2020,085,5,Staten Island,50187011004,96,31,65,4.77
2020,CB2020,085,5,Staten Island,50187011005,96,42,54,4.42
2020,CB2020,085,5,Staten Island,50187011006,72,56,16,4.34
2020,CB2020,085,5,Staten Island,50187011007,106,51,55,3.48
2020,CB2020,085,5,Staten Island,50187011008,0,0,0,0.83
2020,CB2020,085,5,Staten Island,50187011009,0,0,0,2.22
2020,CB2020,085,5,Staten Island,50187012000,60,38,22,3.78
2020,CB2020,085,5,Staten Island,50187012001,109,56,53,3.93
2020,CB2020,085,5,Staten Island,50187012002,250,146,104,19.16
2020,CB2020,085,5,Staten Island,50187012003,107,46,61,4.53
2020,CB2020,085,5,Staten Island,50187012004,48,18,30,2.78
2020,CB2020,085,5,Staten Island,50187012005,48,17,31,2.28
2020,CB2020,085,5,Staten Island,50187012006,85,25,60,3.72
2020,CB2020,085,5,Staten Island,50187012007,0,0,0,4.49
2020,CB2020,085,5,Staten Island,50187012008,0,0,0,0.29
2020,CB2020,085,5,Staten Island,50187012009,94,39,55,4.98
2020,CB2020,085,5,Staten Island,50187012010,88,51,37,3.06
2020,CB2020,085,5,Staten Island,50187012011,84,38,46,1.97
2020,CB2020,085,5,Staten Island,50187031000,0,0,0,0.68
2020,CB2020,085,5,Staten Island,50187031001,0,0,0,1.64
2020,CB2020,085,5,Staten Island,50187031002,0,0,0,2.39
2020,CB2020,085,5,Staten Island,50187031003,0,0,0,1.09
2020,CB2020,085,5,Staten Island,50187031004,174,84,90,4.78
2020,CB2020,085,5,Staten Island,50187031005,85,50,35,2.88
2020,CB2020,085,5,Staten Island,50187031006,106,43,63,5.66
2020,CB2020,085,5,Staten Island,50187031007,122,70,52,3.63
2020,CB2020,085,5,Staten Island,50187031008,133,58,75,5.4
2020,CB2020,085,5,Staten Island,50187031009,160,82,78,5.76
2020,CB2020,085,5,Staten Island,50187031010,377,144,233,4.74
2020,CB2020,085,5,Staten Island,50187031011,39,25,14,0.46
2020,CB2020,085,5,Staten Island,50187031012,165,90,75,4.38
2020,CB2020,085,5,Staten Island,50187031013,98,56,42,2.39
2020,CB2020,085,5,Staten Island,50187031014,31,18,13,4.04
2020,CB2020,085,5,Staten Island,50187031015,161,79,82,3.54
2020,CB2020,085,5,Staten Island,50187031016,100,27,73,3.73
2020,CB2020,085,5,Staten Island,50187032000,105,20,85,2.59
2020,CB2020,085,5,Staten Island,50187032001,0,0,0,2.6
2020,CB2020,085,5,Staten Island,50187032002,102,52,50,2.7
2020,CB2020,085,5,Staten Island,50187032003,113,40,73,2.75
2020,CB2020,085,5,Staten Island,50187032004,91,28,63,2.6
2020,CB2020,085,5,Staten Island,50187032005,79,44,35,2.53
2020,CB2020,085,5,Staten Island,50187032006,115,55,60,2.34
2020,CB2020,085,5,Staten Island,50187032007,128,56,72,2.91
2020,CB2020,085,5,Staten Island,50187032008,62,28,34,1.43
2020,CB2020,085,5,Staten Island,50187032009,55,31,24,1.39
2020,CB2020,085,5,Staten Island,50187032010,88,63,25,2.31
2020,CB2020,085,5,Staten Island,50187032011,109,53,56,2.56
2020,CB2020,085,5,Staten Island,50187032012,147,74,73,2.57
2020,CB2020,085,5,Staten Island,50187032013,118,41,77,2.98
2020,CB2020,085,5,Staten Island,50187032014,108,54,54,3.36
2020,CB2020,085,5,Staten Island,50187032015,120,72,48,3.47
2020,CB2020,085,5,Staten Island,50187032016,138,74,64,3.83
2020,CB2020,085,5,Staten Island,50187032017,158,89,69,3.83
2020,CB2020,085,5,Staten Island,50187032018,84,42,42,2.57
2020,CB2020,085,5,Staten Island,50187032019,115,75,40,2.95
2020,CB2020,085,5,Staten Island,50187032020,90,47,43,2.57
2020,CB2020,085,5,Staten Island,50187032021,100,45,55,3.24
2020,CB2020,085,5,Staten Island,50187041000,0,0,0,2.98
2020,CB2020,085,5,Staten Island,50187041001,0,0,0,4.31
2020,CB2020,085,5,Staten Island,50187041002,527,190,337,12.83
2020,CB2020,085,5,Staten Island,50187041003,191,75,116,5.77
2020,CB2020,085,5,Staten Island,50187041004,149,78,71,5.46
2020,CB2020,085,5,Staten Island,50187041005,180,94,86,6.27
2020,CB2020,085,5,Staten Island,50187041006,107,40,67,5.03
2020,CB2020,085,5,Staten Island,50187041007,77,40,37,3.96
2020,CB2020,085,5,Staten Island,50187041008,121,50,71,4.41
2020,CB2020,085,5,Staten Island,50187041009,96,61,35,4.12
2020,CB2020,085,5,Staten Island,50187041010,85,56,29,4.11
2020,CB2020,085,5,Staten Island,50187041011,88,28,60,4.12
2020,CB2020,085,5,Staten Island,50187041012,67,27,40,4.26
2020,CB2020,085,5,Staten Island,50187041013,96,52,44,3.27
2020,CB2020,085,5,Staten Island,50187041014,97,37,60,3.18
2020,CB2020,085,5,Staten Island,50187041015,129,68,61,3.17
2020,CB2020,085,5,Staten Island,50187042000,93,59,34,3.09
2020,CB2020,085,5,Staten Island,50187042001,111,54,57,3.54
2020,CB2020,085,5,Staten Island,50187042002,86,33,53,2.99
2020,CB2020,085,5,Staten Island,50187042003,80,27,53,2.7
2020,CB2020,085,5,Staten Island,50187042004,104,23,81,2.95
2020,CB2020,085,5,Staten Island,50187042005,62,23,39,2.48
2020,CB2020,085,5,Staten Island,50187042006,86,40,46,2.56
2020,CB2020,085,5,Staten Island,50187042007,66,20,46,2.5
2020,CB2020,085,5,Staten Island,50187042008,80,44,36,2.63
2020,CB2020,085,5,Staten Island,50187042009,124,75,49,2.31
2020,CB2020,085,5,Staten Island,50187042010,128,70,58,2.5
2020,CB2020,085,5,Staten Island,50187042011,70,31,39,2.54
2020,CB2020,085,5,Staten Island,50187042012,126,61,65,4.68
2020,CB2020,085,5,Staten Island,50187042013,66,44,22,2.59
2020,CB2020,085,5,Staten Island,50187042014,133,72,61,5.06
2020,CB2020,085,5,Staten Island,50187042015,195,90,105,6.26
2020,CB2020,085,5,Staten Island,50187042016,76,48,28,2.68
2020,CB2020,085,5,Staten Island,50187042017,84,42,42,1.83
2020,CB2020,085,5,Staten Island,50189011000,30,15,15,5.46
2020,CB2020,085,5,Staten Island,50189011001,137,67,70,6.54
2020,CB2020,085,5,Staten Island,50189011002,160,78,82,6.42
2020,CB2020,085,5,Staten Island,50189011003,117,68,49,6.26
2020,CB2020,085,5,Staten Island,50189011004,165,110,55,6
2020,CB2020,085,5,Staten Island,50189011005,110,74,36,4.77
2020,CB2020,085,5,Staten Island,50189011006,87,37,50,4.8
2020,CB2020,085,5,Staten Island,50189011007,95,46,49,4.88
2020,CB2020,085,5,Staten Island,50189011008,93,42,51,4.93
2020,CB2020,085,5,Staten Island,50189011009,64,22,42,3.44
2020,CB2020,085,5,Staten Island,50189011010,76,37,39,4.33
2020,CB2020,085,5,Staten Island,50189011011,55,26,29,3.6
2020,CB2020,085,5,Staten Island,50189011012,52,19,33,2.23
2020,CB2020,085,5,Staten Island,50189011013,47,7,40,3.16
2020,CB2020,085,5,Staten Island,50189011014,58,18,40,3.77
2020,CB2020,085,5,Staten Island,50189011015,205,93,112,8.07
2020,CB2020,085,5,Staten Island,50189011016,93,35,58,3.42
2020,CB2020,085,5,Staten Island,50189011017,207,126,81,14.14
2020,CB2020,085,5,Staten Island,50189011018,18,8,10,0.75
2020,CB2020,085,5,Staten Island,50189011019,10,6,4,3.55
2020,CB2020,085,5,Staten Island,50189011020,80,31,49,3.05
2020,CB2020,085,5,Staten Island,50189011021,19,6,13,1.58
2020,CB2020,085,5,Staten Island,50189011022,0,0,0,0.43
2020,CB2020,085,5,Staten Island,50189011023,9,4,5,2.61
2020,CB2020,085,5,Staten Island,50189011024,0,0,0,0.26
2020,CB2020,085,5,Staten Island,50189011025,61,30,31,3.28
2020,CB2020,085,5,Staten Island,50189011026,109,48,61,3.81
2020,CB2020,085,5,Staten Island,50189011027,84,35,49,3.75
2020,CB2020,085,5,Staten Island,50189011028,0,0,0,4.08
2020,CB2020,085,5,Staten Island,50189011029,0,0,0,2.12
2020,CB2020,085,5,Staten Island,50189011030,78,40,38,2.36
2020,CB2020,085,5,Staten Island,50189011031,25,10,15,1.59
2020,CB2020,085,5,Staten Island,50189012000,98,47,51,4.74
2020,CB2020,085,5,Staten Island,50189012001,111,55,56,4.69
2020,CB2020,085,5,Staten Island,50189012002,97,39,58,4.72
2020,CB2020,085,5,Staten Island,50189012003,93,32,61,4.73
2020,CB2020,085,5,Staten Island,50189012004,91,40,51,3.39
2020,CB2020,085,5,Staten Island,50189012005,178,100,78,7.6
2020,CB2020,085,5,Staten Island,50189012006,109,49,60,3.67
2020,CB2020,085,5,Staten Island,50189012007,86,33,53,3.91
2020,CB2020,085,5,Staten Island,50189012008,89,42,47,3.57
2020,CB2020,085,5,Staten Island,50189012009,88,18,70,3.79
2020,CB2020,085,5,Staten Island,50189012010,87,41,46,3.72
2020,CB2020,085,5,Staten Island,50189012011,102,48,54,3.69
2020,CB2020,085,5,Staten Island,50189012012,102,51,51,3.7
2020,CB2020,085,5,Staten Island,50189012013,0,0,0,5.08
2020,CB2020,085,5,Staten Island,50189012014,104,70,34,3.69
2020,CB2020,085,5,Staten Island,50189012015,107,48,59,3.7
2020,CB2020,085,5,Staten Island,50189012016,66,26,40,3.71
2020,CB2020,085,5,Staten Island,50189012017,109,52,57,3.81
2020,CB2020,085,5,Staten Island,50189012018,0,0,0,5.41
2020,CB2020,085,5,Staten Island,50189012019,0,0,0,0.74
2020,CB2020,085,5,Staten Island,50189013000,117,56,61,2.49
2020,CB2020,085,5,Staten Island,50189013001,61,12,49,2.87
2020,CB2020,085,5,Staten Island,50189013002,211,105,106,14.07
2020,CB2020,085,5,Staten Island,50189013003,100,53,47,3.24
2020,CB2020,085,5,Staten Island,50189013004,112,60,52,5.01
2020,CB2020,085,5,Staten Island,50189013005,36,11,25,1.42
2020,CB2020,085,5,Staten Island,50189013006,40,31,9,1.53
2020,CB2020,085,5,Staten Island,50189013007,108,71,37,3.67
2020,CB2020,085,5,Staten Island,50189013008,91,49,42,3.53
2020,CB2020,085,5,Staten Island,50189013009,35,11,24,1.48
2020,CB2020,085,5,Staten Island,50189013010,63,45,18,2.48
2020,CB2020,085,5,Staten Island,50189013011,105,56,49,3.41
2020,CB2020,085,5,Staten Island,50189013012,80,31,49,2.04
2020,CB2020,085,5,Staten Island,50189013013,52,22,30,2.2
2020,CB2020,085,5,Staten Island,50189013014,78,41,37,3.1
2020,CB2020,085,5,Staten Island,50189013015,50,27,23,1.69
2020,CB2020,085,5,Staten Island,50189013016,202,78,124,7.29
2020,CB2020,085,5,Staten Island,50189013017,63,20,43,3.19
2020,CB2020,085,5,Staten Island,50189013018,60,19,41,2.73
2020,CB2020,085,5,Staten Island,50189013019,0,0,0,1.88
2020,CB2020,085,5,Staten Island,50189021000,0,0,0,2.29
2020,CB2020,085,5,Staten Island,50189021001,0,0,0,2.79
2020,CB2020,085,5,Staten Island,50189021002,52,17,35,2.51
2020,CB2020,085,5,Staten Island,50189021003,139,72,67,4.54
2020,CB2020,085,5,Staten Island,50189021004,321,165,156,8.57
2020,CB2020,085,5,Staten Island,50189021005,212,101,111,4.87
2020,CB2020,085,5,Staten Island,50189021006,149,56,93,3.63
2020,CB2020,085,5,Staten Island,50189021007,219,103,116,4.92
2020,CB2020,085,5,Staten Island,50189021008,108,48,60,4.74
2020,CB2020,085,5,Staten Island,50189021009,119,55,64,3.22
2020,CB2020,085,5,Staten Island,50189021010,41,15,26,1.4
2020,CB2020,085,5,Staten Island,50189021011,467,229,238,9
2020,CB2020,085,5,Staten Island,50189021012,24,16,8,0.69
2020,CB2020,085,5,Staten Island,50189021013,196,107,89,5.36
2020,CB2020,085,5,Staten Island,50189022000,159,101,58,3.79
2020,CB2020,085,5,Staten Island,50189022001,110,55,55,4.19
2020,CB2020,085,5,Staten Island,50189022002,76,40,36,2.34
2020,CB2020,085,5,Staten Island,50189022003,0,0,0,2.54
2020,CB2020,085,5,Staten Island,50189022004,0,0,0,1.6
2020,CB2020,085,5,Staten Island,50189022005,0,0,0,0.5
2020,CB2020,085,5,Staten Island,50189022006,0,0,0,0.65
2020,CB2020,085,5,Staten Island,50189022007,124,75,49,3.67
2020,CB2020,085,5,Staten Island,50189022008,119,66,53,3.63
2020,CB2020,085,5,Staten Island,50189022009,127,71,56,3.61
2020,CB2020,085,5,Staten Island,50189022010,107,38,69,3.59
2020,CB2020,085,5,Staten Island,50189022011,45,26,19,1.86
2020,CB2020,085,5,Staten Island,50189022012,168,65,103,5.18
2020,CB2020,085,5,Staten Island,50189022013,70,10,60,2.24
2020,CB2020,085,5,Staten Island,50189022014,152,73,79,5.51
2020,CB2020,085,5,Staten Island,50189022015,82,39,43,2.55
2020,CB2020,085,5,Staten Island,50189022016,194,80,114,5.69
2020,CB2020,085,5,Staten Island,50189022017,84,36,48,2.98
2020,CB2020,085,5,Staten Island,50189022018,317,169,148,7.08
2020,CB2020,085,5,Staten Island,50189022019,161,89,72,4.28
2020,CB2020,085,5,Staten Island,50189022020,139,51,88,4.13
2020,CB2020,085,5,Staten Island,50189023000,0,0,0,3.6
2020,CB2020,085,5,Staten Island,50189023001,0,0,0,4.24
2020,CB2020,085,5,Staten Island,50189023002,160,74,86,4.31
2020,CB2020,085,5,Staten Island,50189023003,76,56,20,3.08
2020,CB2020,085,5,Staten Island,50189023004,159,80,79,3.92
2020,CB2020,085,5,Staten Island,50189023005,0,0,0,8.5
2020,CB2020,085,5,Staten Island,50189023006,137,57,80,3.85
2020,CB2020,085,5,Staten Island,50189023007,117,61,56,8.29
2020,CB2020,085,5,Staten Island,50189023008,144,77,67,4.3
2020,CB2020,085,5,Staten Island,50189023009,138,69,69,4.7
2020,CB2020,085,5,Staten Island,50189023010,124,26,98,3.43
2020,CB2020,085,5,Staten Island,50189023011,197,119,78,4.2
2020,CB2020,085,5,Staten Island,50197001000,58,39,19,1.48
2020,CB2020,085,5,Staten Island,50197001001,50,9,41,1.66
2020,CB2020,085,5,Staten Island,50197001002,50,38,12,1.79
2020,CB2020,085,5,Staten Island,50197001003,55,24,31,1.92
2020,CB2020,085,5,Staten Island,50197001004,38,19,19,1.72
2020,CB2020,085,5,Staten Island,50197001005,44,16,28,1.6
2020,CB2020,085,5,Staten Island,50197001006,36,24,12,1.48
2020,CB2020,085,5,Staten Island,50197001007,26,14,12,1.42
2020,CB2020,085,5,Staten Island,50197001008,41,20,21,1.7
2020,CB2020,085,5,Staten Island,50197001009,29,16,13,1.42
2020,CB2020,085,5,Staten Island,50197001010,28,7,21,1.22
2020,CB2020,085,5,Staten Island,50197001011,51,30,21,1.22
2020,CB2020,085,5,Staten Island,50197001012,23,5,18,1.28
2020,CB2020,085,5,Staten Island,50197001013,32,20,12,1.38
2020,CB2020,085,5,Staten Island,50197001014,46,16,30,1.48
2020,CB2020,085,5,Staten Island,50197001015,88,58,30,2.92
2020,CB2020,085,5,Staten Island,50197001016,60,23,37,2.55
2020,CB2020,085,5,Staten Island,50197001017,25,2,23,1.28
2020,CB2020,085,5,Staten Island,50197001018,33,16,17,1.09
2020,CB2020,085,5,Staten Island,50197001019,71,44,27,2.3
2020,CB2020,085,5,Staten Island,50197001020,23,7,16,1.25
2020,CB2020,085,5,Staten Island,50197001021,27,15,12,1.07
2020,CB2020,085,5,Staten Island,50197002000,54,25,29,1.45
2020,CB2020,085,5,Staten Island,50197002001,45,13,32,1.45
2020,CB2020,085,5,Staten Island,50197002002,23,20,3,1.25
2020,CB2020,085,5,Staten Island,50197002003,45,34,11,1.26
2020,CB2020,085,5,Staten Island,50197002004,27,6,21,1.26
2020,CB2020,085,5,Staten Island,50197002005,34,25,9,1.25
2020,CB2020,085,5,Staten Island,50197002006,23,17,6,1.22
2020,CB2020,085,5,Staten Island,50197002007,55,32,23,2.08
2020,CB2020,085,5,Staten Island,50197002008,56,33,23,2.4
2020,CB2020,085,5,Staten Island,50197002009,64,41,23,2.39
2020,CB2020,085,5,Staten Island,50197002010,46,25,21,2.35
2020,CB2020,085,5,Staten Island,50197002011,308,142,166,13.88
2020,CB2020,085,5,Staten Island,50197002012,46,21,25,2.16
2020,CB2020,085,5,Staten Island,50197002013,45,29,16,0.46
2020,CB2020,085,5,Staten Island,50197002014,43,3,40,0.6
2020,CB2020,085,5,Staten Island,50197002015,57,26,31,1.74
2020,CB2020,085,5,Staten Island,50197002016,53,17,36,1.75
2020,CB2020,085,5,Staten Island,50198000001,0,0,0,0
2020,CB2020,085,5,Staten Island,50198001000,85,50,35,10.3
2020,CB2020,085,5,Staten Island,50198001001,142,54,88,16.95
2020,CB2020,085,5,Staten Island,50198001002,260,109,151,10.42
2020,CB2020,085,5,Staten Island,50198001003,0,0,0,4.85
2020,CB2020,085,5,Staten Island,50198001004,115,57,58,4.58
2020,CB2020,085,5,Staten Island,50198001005,315,167,148,58.76
2020,CB2020,085,5,Staten Island,50198001006,99,49,50,4.49
2020,CB2020,085,5,Staten Island,50198001007,39,37,2,3.04
2020,CB2020,085,5,Staten Island,50198001008,36,18,18,2.96
2020,CB2020,085,5,Staten Island,50198001009,86,51,35,213.24
2020,CB2020,085,5,Staten Island,50198001010,16,12,4,102.42
2020,CB2020,085,5,Staten Island,50198001011,7,3,4,103.05
2020,CB2020,085,5,Staten Island,50198001012,12,7,5,40.38
2020,CB2020,085,5,Staten Island,50198001013,53,32,21,17.65
2020,CB2020,085,5,Staten Island,50198001014,27,3,24,1.08
2020,CB2020,085,5,Staten Island,50198002000,80,37,43,4.23
2020,CB2020,085,5,Staten Island,50198002001,64,35,29,9.17
2020,CB2020,085,5,Staten Island,50198002002,17,8,9,3.04
2020,CB2020,085,5,Staten Island,50198002003,109,48,61,18.35
2020,CB2020,085,5,Staten Island,50198002004,103,63,40,14.85
2020,CB2020,085,5,Staten Island,50198002005,149,75,74,11.13
2020,CB2020,085,5,Staten Island,50198002006,83,42,41,5.74
2020,CB2020,085,5,Staten Island,50198002007,76,23,53,4.33
2020,CB2020,085,5,Staten Island,50198002008,93,53,40,10.93
2020,CB2020,085,5,Staten Island,50198002009,202,86,116,13.48
2020,CB2020,085,5,Staten Island,50198002010,27,16,11,1.87
2020,CB2020,085,5,Staten Island,50198002011,108,49,59,4.27
2020,CB2020,085,5,Staten Island,50198002012,81,41,40,3.88
2020,CB2020,085,5,Staten Island,50198003000,166,92,74,10.64
2020,CB2020,085,5,Staten Island,50198003001,1,0,1,1.94
2020,CB2020,085,5,Staten Island,50198003002,61,28,33,6.68
2020,CB2020,085,5,Staten Island,50198003003,50,17,33,2.71
2020,CB2020,085,5,Staten Island,50198003004,81,45,36,3.81
2020,CB2020,085,5,Staten Island,50198003005,379,197,182,59
2020,CB2020,085,5,Staten Island,50198003006,43,15,28,4.3
2020,CB2020,085,5,Staten Island,50198003007,63,40,23,4.21
2020,CB2020,085,5,Staten Island,50198003008,85,44,41,4.98
2020,CB2020,085,5,Staten Island,50198003009,52,31,21,15.88
2020,CB2020,085,5,Staten Island,50198003010,0,0,0,0
2020,CB2020,085,5,Staten Island,50198003011,0,0,0,0.24
2020,CB2020,085,5,Staten Island,50198003012,12,11,1,37.67
2020,CB2020,085,5,Staten Island,50198003013,15,3,12,3.05
2020,CB2020,085,5,Staten Island,50198003014,56,21,35,2.25
2020,CB2020,085,5,Staten Island,50198003015,0,0,0,0
2020,CB2020,085,5,Staten Island,50198003016,30,4,26,3.79
2020,CB2020,085,5,Staten Island,50198003017,0,0,0,9.55
2020,CB2020,085,5,Staten Island,50198003018,7,0,7,3.59
2020,CB2020,085,5,Staten Island,50198003019,0,0,0,4.19
2020,CB2020,085,5,Staten Island,50198003020,222,90,132,4.96
2020,CB2020,085,5,Staten Island,50198003021,334,140,194,11.29
2020,CB2020,085,5,Staten Island,50198003022,160,83,77,4.61
2020,CB2020,085,5,Staten Island,50198003023,94,40,54,4.9
2020,CB2020,085,5,Staten Island,50198003024,43,24,19,2.12
2020,CB2020,085,5,Staten Island,50198003025,55,36,19,3.16
2020,CB2020,085,5,Staten Island,50198004000,55,21,34,3.45
2020,CB2020,085,5,Staten Island,50198004001,45,21,24,2.71
2020,CB2020,085,5,Staten Island,50198004002,12,9,3,3.32
2020,CB2020,085,5,Staten Island,50198004003,80,42,38,2.98
2020,CB2020,085,5,Staten Island,50198004004,23,5,18,2.56
2020,CB2020,085,5,Staten Island,50198004005,0,0,0,2.88
2020,CB2020,085,5,Staten Island,50198004006,0,0,0,23.73
2020,CB2020,085,5,Staten Island,50198004007,266,123,143,164.84
2020,CB2020,085,5,Staten Island,50198004008,79,46,33,6.72
2020,CB2020,085,5,Staten Island,50198004009,55,22,33,4.78
2020,CB2020,085,5,Staten Island,50198004010,56,11,45,2.93
2020,CB2020,085,5,Staten Island,50198004011,0,0,0,0
2020,CB2020,085,5,Staten Island,50198004012,64,36,28,4.47
2020,CB2020,085,5,Staten Island,50198004013,30,15,15,2.94
2020,CB2020,085,5,Staten Island,50198004014,45,31,14,2.15
2020,CB2020,085,5,Staten Island,50198004015,16,4,12,5.48
2020,CB2020,085,5,Staten Island,50198004016,56,34,22,2.57
2020,CB2020,085,5,Staten Island,50198004017,50,17,33,2.9
2020,CB2020,085,5,Staten Island,50198004018,77,44,33,2.99
2020,CB2020,085,5,Staten Island,50198004019,72,30,42,4.36
2020,CB2020,085,5,Staten Island,50198004020,52,24,28,1.1
2020,CB2020,085,5,Staten Island,50198004021,56,31,25,2.93
2020,CB2020,085,5,Staten Island,50198004022,69,31,38,4.3
2020,CB2020,085,5,Staten Island,50198004023,55,27,28,5.56
2020,CB2020,085,5,Staten Island,50198004024,24,10,14,2.4
2020,CB2020,085,5,Staten Island,50198004025,29,21,8,2.06
2020,CB2020,085,5,Staten Island,50198004026,43,20,23,2.68
2020,CB2020,085,5,Staten Island,50198004027,48,10,38,3.52
2020,CB2020,085,5,Staten Island,50198004028,29,12,17,3.03
2020,CB2020,085,5,Staten Island,50198004029,13,2,11,3.47
2020,CB2020,085,5,Staten Island,50198004030,0,0,0,73.09
2020,CB2020,085,5,Staten Island,50198004031,27,14,13,5.21
2020,CB2020,085,5,Staten Island,50198004032,45,21,24,24.94
2020,CB2020,085,5,Staten Island,50198004033,72,44,28,10.75
2020,CB2020,085,5,Staten Island,50198004034,40,25,15,5.93
2020,CB2020,085,5,Staten Island,50198004035,19,9,10,4.33
2020,CB2020,085,5,Staten Island,50198004036,0,0,0,25.21
2020,CB2020,085,5,Staten Island,50198004037,110,64,46,5.08
2020,CB2020,085,5,Staten Island,50198004038,75,32,43,3.75
2020,CB2020,085,5,Staten Island,50198004039,100,52,48,2.83
2020,CB2020,085,5,Staten Island,50198004040,67,41,26,8.43
2020,CB2020,085,5,Staten Island,50198004041,0,0,0,5.21
2020,CB2020,085,5,Staten Island,50198004042,80,38,42,16.92
2020,CB2020,085,5,Staten Island,50201001000,196,105,91,3.17
2020,CB2020,085,5,Staten Island,50201001001,78,31,47,1.75
2020,CB2020,085,5,Staten Island,50201001002,250,133,117,6.37
2020,CB2020,085,5,Staten Island,50201001003,92,42,50,3.27
2020,CB2020,085,5,Staten Island,50201001004,132,78,54,3.64
2020,CB2020,085,5,Staten Island,50201001005,130,70,60,5.99
2020,CB2020,085,5,Staten Island,50201001006,55,17,38,5.18
2020,CB2020,085,5,Staten Island,50201001007,113,72,41,4.22
2020,CB2020,085,5,Staten Island,50201001008,264,124,140,19.87
2020,CB2020,085,5,Staten Island,50201001009,58,19,39,1.61
2020,CB2020,085,5,Staten Island,50201001010,195,88,107,7.73
2020,CB2020,085,5,Staten Island,50201001011,83,51,32,3.9
2020,CB2020,085,5,Staten Island,50201001012,168,74,94,5.96
2020,CB2020,085,5,Staten Island,50201002000,382,200,182,23.04
2020,CB2020,085,5,Staten Island,50201002001,33,12,21,0.88
2020,CB2020,085,5,Staten Island,50201002002,46,18,28,1.24
2020,CB2020,085,5,Staten Island,50201002003,44,16,28,1.32
2020,CB2020,085,5,Staten Island,50201002004,28,10,18,1.09
2020,CB2020,085,5,Staten Island,50201002005,92,72,20,2.7
2020,CB2020,085,5,Staten Island,50201002006,130,80,50,3.88
2020,CB2020,085,5,Staten Island,50201002007,77,46,31,2.01
2020,CB2020,085,5,Staten Island,50201002008,52,15,37,1.74
2020,CB2020,085,5,Staten Island,50201002009,0,0,0,1.79
2020,CB2020,085,5,Staten Island,50201002010,88,31,57,1.8
2020,CB2020,085,5,Staten Island,50201002011,39,12,27,1.46
2020,CB2020,085,5,Staten Island,50201003000,158,86,72,6.39
2020,CB2020,085,5,Staten Island,50201003001,64,37,27,2.49
2020,CB2020,085,5,Staten Island,50201003002,99,36,63,3.73
2020,CB2020,085,5,Staten Island,50201003003,54,28,26,2.04
2020,CB2020,085,5,Staten Island,50201003004,70,36,34,2.97
2020,CB2020,085,5,Staten Island,50201003005,46,26,20,2.28
2020,CB2020,085,5,Staten Island,50201003006,37,22,15,1.21
2020,CB2020,085,5,Staten Island,50201003007,23,7,16,1.18
2020,CB2020,085,5,Staten Island,50201003008,38,15,23,1.11
2020,CB2020,085,5,Staten Island,50201003009,62,36,26,2.27
2020,CB2020,085,5,Staten Island,50201003010,69,25,44,2.05
2020,CB2020,085,5,Staten Island,50201003011,0,0,0,3.64
2020,CB2020,085,5,Staten Island,50201003012,72,28,44,2.4
2020,CB2020,085,5,Staten Island,50201003013,34,20,14,1.27
2020,CB2020,085,5,Staten Island,50201003014,56,31,25,1.38
2020,CB2020,085,5,Staten Island,50201003015,25,16,9,1.48
2020,CB2020,085,5,Staten Island,50201003016,64,37,27,1.74
2020,CB2020,085,5,Staten Island,50207010001,0,0,0,0
2020,CB2020,085,5,Staten Island,50207011000,14,5,9,7.45
2020,CB2020,085,5,Staten Island,50207011001,0,0,0,9.19
2020,CB2020,085,5,Staten Island,50207011002,115,50,65,2.26
2020,CB2020,085,5,Staten Island,50207011003,235,119,116,6.42
2020,CB2020,085,5,Staten Island,50207011004,0,0,0,1.69
2020,CB2020,085,5,Staten Island,50207011005,229,127,102,8.3
2020,CB2020,085,5,Staten Island,50207011006,123,53,70,1.69
2020,CB2020,085,5,Staten Island,50207011007,116,53,63,1.78
2020,CB2020,085,5,Staten Island,50207011008,135,75,60,3.5
2020,CB2020,085,5,Staten Island,50207011009,59,42,17,3.09
2020,CB2020,085,5,Staten Island,50207011010,207,103,104,4.07
2020,CB2020,085,5,Staten Island,50207011011,170,66,104,2.7
2020,CB2020,085,5,Staten Island,50207011012,160,78,82,2.94
2020,CB2020,085,5,Staten Island,50207011013,0,0,0,0.36
2020,CB2020,085,5,Staten Island,50207011014,85,27,58,5.17
2020,CB2020,085,5,Staten Island,50207011015,239,114,125,4.47
2020,CB2020,085,5,Staten Island,50207012000,172,81,91,1.99
2020,CB2020,085,5,Staten Island,50207012001,86,43,43,1.52
2020,CB2020,085,5,Staten Island,50207012002,187,104,83,3.3
2020,CB2020,085,5,Staten Island,50207012003,358,191,167,5.79
2020,CB2020,085,5,Staten Island,50207012004,135,79,56,2.47
2020,CB2020,085,5,Staten Island,50207012005,110,62,48,2.84
2020,CB2020,085,5,Staten Island,50207013000,205,126,79,3.79
2020,CB2020,085,5,Staten Island,50207013001,130,51,79,2.78
2020,CB2020,085,5,Staten Island,50207013002,155,77,78,3.79
2020,CB2020,085,5,Staten Island,50207013003,74,46,28,1.35
2020,CB2020,085,5,Staten Island,50207013004,209,114,95,3.56
2020,CB2020,085,5,Staten Island,50207013005,234,114,120,4.97
2020,CB2020,085,5,Staten Island,50207020001,0,0,0,0
2020,CB2020,085,5,Staten Island,50207021000,25,17,8,15
2020,CB2020,085,5,Staten Island,50207021001,0,0,0,1.97
2020,CB2020,085,5,Staten Island,50207021002,61,29,32,16.93
2020,CB2020,085,5,Staten Island,50207021003,67,35,32,6.04
2020,CB2020,085,5,Staten Island,50207021004,59,33,26,2.8
2020,CB2020,085,5,Staten Island,50207021005,172,70,102,5.25
2020,CB2020,085,5,Staten Island,50207021006,69,33,36,2.23
2020,CB2020,085,5,Staten Island,50207021007,0,0,0,3.26
2020,CB2020,085,5,Staten Island,50207021008,79,35,44,2.28
2020,CB2020,085,5,Staten Island,50207021009,53,32,21,2.25
2020,CB2020,085,5,Staten Island,50207021010,9,8,1,2.05
2020,CB2020,085,5,Staten Island,50207021011,70,49,21,2.08
2020,CB2020,085,5,Staten Island,50207021012,83,45,38,3.19
2020,CB2020,085,5,Staten Island,50207021013,79,45,34,2.06
2020,CB2020,085,5,Staten Island,50207021014,77,46,31,2.04
2020,CB2020,085,5,Staten Island,50207022000,43,14,29,9.48
2020,CB2020,085,5,Staten Island,50207022001,197,117,80,4
2020,CB2020,085,5,Staten Island,50207022002,53,20,33,1.63
2020,CB2020,085,5,Staten Island,50207022003,272,139,133,5.79
2020,CB2020,085,5,Staten Island,50207022004,81,49,32,1.67
2020,CB2020,085,5,Staten Island,50207022005,74,45,29,2.03
2020,CB2020,085,5,Staten Island,50207022006,168,68,100,5.03
2020,CB2020,085,5,Staten Island,50207023000,210,128,82,3.2
2020,CB2020,085,5,Staten Island,50207023001,220,116,104,2.65
2020,CB2020,085,5,Staten Island,50207023002,173,96,77,3.04
2020,CB2020,085,5,Staten Island,50207023003,96,38,58,2.18
2020,CB2020,085,5,Staten Island,50207023004,113,61,52,2.54
2020,CB2020,085,5,Staten Island,50207023005,126,63,63,3.34
2020,CB2020,085,5,Staten Island,50207023006,127,82,45,2.61
2020,CB2020,085,5,Staten Island,50207023007,96,32,64,2.7
2020,CB2020,085,5,Staten Island,50207023008,189,85,104,5.34
2020,CB2020,085,5,Staten Island,50207023009,196,110,86,5.63
2020,CB2020,085,5,Staten Island,50207023010,99,39,60,1.66
2020,CB2020,085,5,Staten Island,50208031000,465,210,255,41.04
2020,CB2020,085,5,Staten Island,50208031001,131,71,60,2.8
2020,CB2020,085,5,Staten Island,50208031002,310,127,183,7.02
2020,CB2020,085,5,Staten Island,50208031003,958,471,487,103.2
2020,CB2020,085,5,Staten Island,50208031004,47,22,25,1.73
2020,CB2020,085,5,Staten Island,50208031005,128,46,82,3.11
2020,CB2020,085,5,Staten Island,50208031006,101,44,57,2.16
2020,CB2020,085,5,Staten Island,50208031007,0,0,0,3.76
2020,CB2020,085,5,Staten Island,50208031008,0,0,0,3.15
2020,CB2020,085,5,Staten Island,50208031009,140,74,66,4.34
2020,CB2020,085,5,Staten Island,50208031010,185,105,80,6.08
2020,CB2020,085,5,Staten Island,50208032000,0,0,0,5.23
2020,CB2020,085,5,Staten Island,50208032001,41,15,26,2.14
2020,CB2020,085,5,Staten Island,50208032002,26,4,22,2.25
2020,CB2020,085,5,Staten Island,50208032003,80,38,42,3.85
2020,CB2020,085,5,Staten Island,50208032004,65,17,48,3.88
2020,CB2020,085,5,Staten Island,50208032005,0,0,0,3.69
2020,CB2020,085,5,Staten Island,50208032006,19,10,9,4.02
2020,CB2020,085,5,Staten Island,50208032007,252,119,133,21.57
2020,CB2020,085,5,Staten Island,50208032008,85,49,36,3.49
2020,CB2020,085,5,Staten Island,50208032009,36,18,18,2.59
2020,CB2020,085,5,Staten Island,50208032010,42,30,12,2.92
2020,CB2020,085,5,Staten Island,50208032011,70,42,28,3.48
2020,CB2020,085,5,Staten Island,50208032012,134,47,87,8.78
2020,CB2020,085,5,Staten Island,50208032013,265,144,121,29.86
2020,CB2020,085,5,Staten Island,50208032014,89,31,58,3.55
2020,CB2020,085,5,Staten Island,50208032015,111,65,46,18.48
2020,CB2020,085,5,Staten Island,50208032016,317,207,110,23.42
2020,CB2020,085,5,Staten Island,50208032017,39,27,12,1.4
2020,CB2020,085,5,Staten Island,50208032018,98,53,45,1.26
2020,CB2020,085,5,Staten Island,50208032019,11,9,2,1.93
2020,CB2020,085,5,Staten Island,50208032020,32,9,23,3.63
2020,CB2020,085,5,Staten Island,50208032021,104,35,69,5.15
2020,CB2020,085,5,Staten Island,50208032022,41,20,21,2.32
2020,CB2020,085,5,Staten Island,50208032023,124,69,55,5.59
2020,CB2020,085,5,Staten Island,50208032024,73,47,26,4.19
2020,CB2020,085,5,Staten Island,50208033000,65,24,41,4.92
2020,CB2020,085,5,Staten Island,50208033001,32,21,11,2.84
2020,CB2020,085,5,Staten Island,50208033002,37,29,8,2.84
2020,CB2020,085,5,Staten Island,50208033003,107,71,36,4.7
2020,CB2020,085,5,Staten Island,50208033004,93,26,67,4.72
2020,CB2020,085,5,Staten Island,50208033005,95,39,56,4.68
2020,CB2020,085,5,Staten Island,50208033006,102,33,69,4.73
2020,CB2020,085,5,Staten Island,50208033007,113,66,47,4.79
2020,CB2020,085,5,Staten Island,50208033008,156,74,82,5.04
2020,CB2020,085,5,Staten Island,50208033009,209,116,93,5.24
2020,CB2020,085,5,Staten Island,50208033010,160,77,83,5.67
2020,CB2020,085,5,Staten Island,50208033011,83,52,31,4.85
2020,CB2020,085,5,Staten Island,50208033012,120,70,50,4.76
2020,CB2020,085,5,Staten Island,50208034000,139,58,81,5.16
2020,CB2020,085,5,Staten Island,50208034001,83,39,44,5.39
2020,CB2020,085,5,Staten Island,50208034002,286,143,143,5.66
2020,CB2020,085,5,Staten Island,50208034003,132,71,61,3.16
2020,CB2020,085,5,Staten Island,50208034004,66,26,40,2.35
2020,CB2020,085,5,Staten Island,50208034005,0,0,0,43.28
2020,CB2020,085,5,Staten Island,50208034006,150,90,60,5.63
2020,CB2020,085,5,Staten Island,50208034007,78,39,39,5.78
2020,CB2020,085,5,Staten Island,50208034008,107,48,59,5.9
2020,CB2020,085,5,Staten Island,50208034009,91,46,45,6.15
2020,CB2020,085,5,Staten Island,50208034010,96,49,47,6.26
2020,CB2020,085,5,Staten Island,50208034011,93,41,52,4.62
2020,CB2020,085,5,Staten Island,50208034012,36,12,24,1.99
2020,CB2020,085,5,Staten Island,50208034013,0,0,0,5.54
2020,CB2020,085,5,Staten Island,50208034014,0,0,0,4.72
2020,CB2020,085,5,Staten Island,50208041000,38,18,20,3.24
2020,CB2020,085,5,Staten Island,50208041001,101,46,55,4.4
2020,CB2020,085,5,Staten Island,50208041002,13,6,7,1.49
2020,CB2020,085,5,Staten Island,50208041003,101,46,55,4
2020,CB2020,085,5,Staten Island,50208041004,95,30,65,4.13
2020,CB2020,085,5,Staten Island,50208041005,108,41,67,4.53
2020,CB2020,085,5,Staten Island,50208041006,151,74,77,4.64
2020,CB2020,085,5,Staten Island,50208041007,138,49,89,4.66
2020,CB2020,085,5,Staten Island,50208041008,114,45,69,4.09
2020,CB2020,085,5,Staten Island,50208041009,101,52,49,4.03
2020,CB2020,085,5,Staten Island,50208041010,133,47,86,4.46
2020,CB2020,085,5,Staten Island,50208041011,131,64,67,4.44
2020,CB2020,085,5,Staten Island,50208041012,124,63,61,4.18
2020,CB2020,085,5,Staten Island,50208041013,106,69,37,4.26
2020,CB2020,085,5,Staten Island,50208041014,122,83,39,4.39
2020,CB2020,085,5,Staten Island,50208041015,76,50,26,4.24
2020,CB2020,085,5,Staten Island,50208041016,113,53,60,4.26
2020,CB2020,085,5,Staten Island,50208041017,54,40,14,4.33
2020,CB2020,085,5,Staten Island,50208041018,61,42,19,4.22
2020,CB2020,085,5,Staten Island,50208041019,81,44,37,4.34
2020,CB2020,085,5,Staten Island,50208041020,50,20,30,4.26
2020,CB2020,085,5,Staten Island,50208041021,54,27,27,4.23
2020,CB2020,085,5,Staten Island,50208041022,64,31,33,4.26
2020,CB2020,085,5,Staten Island,50208041023,113,58,55,4.22
2020,CB2020,085,5,Staten Island,50208041024,79,39,40,4.25
2020,CB2020,085,5,Staten Island,50208041025,0,0,0,2.16
2020,CB2020,085,5,Staten Island,50208041026,16,13,3,4.07
2020,CB2020,085,5,Staten Island,50208042000,72,19,53,3.63
2020,CB2020,085,5,Staten Island,50208042001,59,12,47,3.62
2020,CB2020,085,5,Staten Island,50208042002,84,54,30,3.9
2020,CB2020,085,5,Staten Island,50208042003,99,54,45,4.07
2020,CB2020,085,5,Staten Island,50208042004,55,30,25,3.26
2020,CB2020,085,5,Staten Island,50208042005,23,16,7,1.71
2020,CB2020,085,5,Staten Island,50208042006,52,31,21,2.2
2020,CB2020,085,5,Staten Island,50208042007,59,31,28,4.11
2020,CB2020,085,5,Staten Island,50208042008,96,70,26,4.1
2020,CB2020,085,5,Staten Island,50208042009,92,39,53,4.07
2020,CB2020,085,5,Staten Island,50208042010,90,35,55,4.18
2020,CB2020,085,5,Staten Island,50208042011,68,46,22,4.1
2020,CB2020,085,5,Staten Island,50208042012,42,18,24,1.85
2020,CB2020,085,5,Staten Island,50208042013,66,31,35,4.26
2020,CB2020,085,5,Staten Island,50208042014,79,25,54,4.27
2020,CB2020,085,5,Staten Island,50208042015,46,17,29,4.12
2020,CB2020,085,5,Staten Island,50208042016,70,35,35,4.82
2020,CB2020,085,5,Staten Island,50208042017,62,26,36,3.45
2020,CB2020,085,5,Staten Island,50208042018,76,47,29,4.15
2020,CB2020,085,5,Staten Island,50208042019,90,58,32,4.35
2020,CB2020,085,5,Staten Island,50208042020,74,35,39,4.23
2020,CB2020,085,5,Staten Island,50208042021,78,43,35,4.15
2020,CB2020,085,5,Staten Island,50208042022,96,57,39,4.21
2020,CB2020,085,5,Staten Island,50208042023,81,50,31,4.23
2020,CB2020,085,5,Staten Island,50208042024,81,14,67,4.31
2020,CB2020,085,5,Staten Island,50208042025,47,27,20,2.76
2020,CB2020,085,5,Staten Island,50208042026,0,0,0,14.03
2020,CB2020,085,5,Staten Island,50208042027,0,0,0,5.5
2020,CB2020,085,5,Staten Island,50208043000,0,0,0,15.97
2020,CB2020,085,5,Staten Island,50208043001,0,0,0,0.51
2020,CB2020,085,5,Staten Island,50208043002,17,2,15,1.62
2020,CB2020,085,5,Staten Island,50208043003,108,49,59,4.34
2020,CB2020,085,5,Staten Island,50208043004,138,69,69,9.12
2020,CB2020,085,5,Staten Island,50208043005,35,14,21,2.7
2020,CB2020,085,5,Staten Island,50208043006,144,101,43,9.59
2020,CB2020,085,5,Staten Island,50208043007,71,16,55,14.71
2020,CB2020,085,5,Staten Island,50208043008,87,43,44,3.92
2020,CB2020,085,5,Staten Island,50208043009,78,40,38,3.88
2020,CB2020,085,5,Staten Island,50208043010,122,60,62,7.32
2020,CB2020,085,5,Staten Island,50208043011,8,3,5,5.61
2020,CB2020,085,5,Staten Island,50208043012,83,41,42,3.54
2020,CB2020,085,5,Staten Island,50208043013,57,32,25,4.62
2020,CB2020,085,5,Staten Island,50208043014,60,40,20,2.96
2020,CB2020,085,5,Staten Island,50208043015,54,33,21,4.59
2020,CB2020,085,5,Staten Island,50208043016,38,16,22,2.53
2020,CB2020,085,5,Staten Island,50208043017,90,33,57,3.87
2020,CB2020,085,5,Staten Island,50208051000,0,0,0,1.27
2020,CB2020,085,5,Staten Island,50208051001,14,5,9,8.45
2020,CB2020,085,5,Staten Island,50208051002,0,0,0,2.64
2020,CB2020,085,5,Staten Island,50208051003,23,11,12,3.39
2020,CB2020,085,5,Staten Island,50208051004,0,0,0,9.88
2020,CB2020,085,5,Staten Island,50208051005,0,0,0,5.3
2020,CB2020,085,5,Staten Island,50208051006,0,0,0,9.7
2020,CB2020,085,5,Staten Island,50208051007,153,72,81,6.97
2020,CB2020,085,5,Staten Island,50208051008,0,0,0,0.71
2020,CB2020,085,5,Staten Island,50208051009,62,37,25,2.06
2020,CB2020,085,5,Staten Island,50208051010,124,62,62,3.74
2020,CB2020,085,5,Staten Island,50208051011,234,114,120,9.31
2020,CB2020,085,5,Staten Island,50208051012,13,3,10,6.73
2020,CB2020,085,5,Staten Island,50208051013,0,0,0,0.64
2020,CB2020,085,5,Staten Island,50208051014,460,193,267,21.07
2020,CB2020,085,5,Staten Island,50208051015,23,14,9,0.32
2020,CB2020,085,5,Staten Island,50208051016,411,186,225,10.04
2020,CB2020,085,5,Staten Island,50208051017,243,118,125,5.22
2020,CB2020,085,5,Staten Island,50208052000,46,16,30,1.32
2020,CB2020,085,5,Staten Island,50208052001,375,173,202,13.69
2020,CB2020,085,5,Staten Island,50208052002,59,23,36,1.42
2020,CB2020,085,5,Staten Island,50208052003,52,35,17,1.33
2020,CB2020,085,5,Staten Island,50208052004,48,22,26,1.36
2020,CB2020,085,5,Staten Island,50208052005,66,31,35,1.27
2020,CB2020,085,5,Staten Island,50208052006,58,35,23,1.34
2020,CB2020,085,5,Staten Island,50208052007,26,6,20,0.81
2020,CB2020,085,5,Staten Island,50208052008,29,15,14,0.77
2020,CB2020,085,5,Staten Island,50208052009,212,63,149,7.32
2020,CB2020,085,5,Staten Island,50208052010,669,287,382,17.96
2020,CB2020,085,5,Staten Island,50208052011,76,42,34,1.68
2020,CB2020,085,5,Staten Island,50208052012,213,126,87,4.48
2020,CB2020,085,5,Staten Island,50208052013,201,100,101,4.17
2020,CB2020,085,5,Staten Island,50208052014,76,34,42,1.15
2020,CB2020,085,5,Staten Island,50208052015,455,233,222,9.29
2020,CB2020,085,5,Staten Island,50208052016,59,20,39,0.8
2020,CB2020,085,5,Staten Island,50208052017,36,17,19,0.39
2020,CB2020,085,5,Staten Island,50208053000,466,223,243,14.74
2020,CB2020,085,5,Staten Island,50208053001,234,107,127,13.93
2020,CB2020,085,5,Staten Island,50208053002,177,80,97,4.29
2020,CB2020,085,5,Staten Island,50208053003,183,105,78,5.35
2020,CB2020,085,5,Staten Island,50208053004,124,61,63,4.89
2020,CB2020,085,5,Staten Island,50208053005,82,38,44,5.11
2020,CB2020,085,5,Staten Island,50208053006,121,60,61,5.31
2020,CB2020,085,5,Staten Island,50208053007,155,73,82,5.81
2020,CB2020,085,5,Staten Island,50208053008,56,34,22,4.68
2020,CB2020,085,5,Staten Island,50208053009,202,80,122,27.18
2020,CB2020,085,5,Staten Island,50208053010,52,12,40,4.19
2020,CB2020,085,5,Staten Island,50208053011,65,39,26,5.09
2020,CB2020,085,5,Staten Island,50208061000,72,42,30,1.74
2020,CB2020,085,5,Staten Island,50208061001,113,54,59,2.32
2020,CB2020,085,5,Staten Island,50208061002,76,50,26,1.97
2020,CB2020,085,5,Staten Island,50208061003,88,40,48,3.33
2020,CB2020,085,5,Staten Island,50208061004,110,42,68,4.08
2020,CB2020,085,5,Staten Island,50208061005,17,2,15,1.35
2020,CB2020,085,5,Staten Island,50208061006,68,35,33,3.15
2020,CB2020,085,5,Staten Island,50208061007,61,19,42,2.88
2020,CB2020,085,5,Staten Island,50208061008,29,8,21,1.21
2020,CB2020,085,5,Staten Island,50208061009,109,52,57,4.88
2020,CB2020,085,5,Staten Island,50208061010,77,46,31,4.04
2020,CB2020,085,5,Staten Island,50208061011,113,52,61,4.11
2020,CB2020,085,5,Staten Island,50208061012,184,94,90,4.9
2020,CB2020,085,5,Staten Island,50208061013,246,114,132,9.79
2020,CB2020,085,5,Staten Island,50208061014,85,41,44,6.24
2020,CB2020,085,5,Staten Island,50208061015,69,35,34,4.19
2020,CB2020,085,5,Staten Island,50208061016,70,47,23,13.19
2020,CB2020,085,5,Staten Island,50208062000,0,0,0,7.92
2020,CB2020,085,5,Staten Island,50208062001,17,6,11,8.9
2020,CB2020,085,5,Staten Island,50208062002,0,0,0,4.16
2020,CB2020,085,5,Staten Island,50208062003,201,112,89,208.65
2020,CB2020,085,5,Staten Island,50208062004,118,51,67,6.36
2020,CB2020,085,5,Staten Island,50208062005,95,51,44,2.96
2020,CB2020,085,5,Staten Island,50208062006,71,36,35,2.77
2020,CB2020,085,5,Staten Island,50208062007,21,3,18,2.28
2020,CB2020,085,5,Staten Island,50208062008,68,17,51,5.73
2020,CB2020,085,5,Staten Island,50208062009,119,69,50,5.83
2020,CB2020,085,5,Staten Island,50208062010,66,32,34,5.04
2020,CB2020,085,5,Staten Island,50208062011,79,54,25,5.2
2020,CB2020,085,5,Staten Island,50208062012,20,13,7,2.4
2020,CB2020,085,5,Staten Island,50208062013,36,10,26,2.64
2020,CB2020,085,5,Staten Island,50208062014,90,46,44,3.44
2020,CB2020,085,5,Staten Island,50208062015,56,39,17,8.27
2020,CB2020,085,5,Staten Island,50208062016,70,44,26,7.26
2020,CB2020,085,5,Staten Island,50213001000,105,63,42,4.84
2020,CB2020,085,5,Staten Island,50213001001,194,98,96,4.49
2020,CB2020,085,5,Staten Island,50213001002,165,87,78,4.12
2020,CB2020,085,5,Staten Island,50213001003,106,60,46,2.36
2020,CB2020,085,5,Staten Island,50213001004,148,66,82,2.97
2020,CB2020,085,5,Staten Island,50213001005,99,57,42,3.41
2020,CB2020,085,5,Staten Island,50213001006,205,106,99,3.71
2020,CB2020,085,5,Staten Island,50213001007,29,10,19,1.92
2020,CB2020,085,5,Staten Island,50213001008,175,93,82,3.53
2020,CB2020,085,5,Staten Island,50213002000,47,30,17,2.59
2020,CB2020,085,5,Staten Island,50213002001,196,111,85,3.94
2020,CB2020,085,5,Staten Island,50213002002,200,106,94,3.94
2020,CB2020,085,5,Staten Island,50213002003,93,60,33,2.1
2020,CB2020,085,5,Staten Island,50213002004,217,74,143,6.3
2020,CB2020,085,5,Staten Island,50213002005,102,50,52,3.32
2020,CB2020,085,5,Staten Island,50213002006,67,18,49,2.19
2020,CB2020,085,5,Staten Island,50213002007,28,12,16,1.9
2020,CB2020,085,5,Staten Island,50213003000,117,47,70,4.2
2020,CB2020,085,5,Staten Island,50213003001,152,72,80,4.4
2020,CB2020,085,5,Staten Island,50213003002,96,72,24,4.62
2020,CB2020,085,5,Staten Island,50213003003,113,50,63,4.12
2020,CB2020,085,5,Staten Island,50213003004,138,67,71,4.47
2020,CB2020,085,5,Staten Island,50213003005,301,161,140,11.05
2020,CB2020,085,5,Staten Island,50213003006,324,171,153,11.07
2020,CB2020,085,5,Staten Island,50213003007,178,75,103,4.19
2020,CB2020,085,5,Staten Island,50213004000,120,68,52,3.08
2020,CB2020,085,5,Staten Island,50213004001,246,106,140,6.07
2020,CB2020,085,5,Staten Island,50213004002,292,125,167,7.82
2020,CB2020,085,5,Staten Island,50213004003,224,130,94,7.2
2020,CB2020,085,5,Staten Island,50213004004,146,80,66,2.92
2020,CB2020,085,5,Staten Island,50213004005,116,64,52,2.8
2020,CB2020,085,5,Staten Island,50213004006,126,52,74,2.82
2020,CB2020,085,5,Staten Island,50213005000,302,151,151,20.69
2020,CB2020,085,5,Staten Island,50213005001,15,6,9,0.56
2020,CB2020,085,5,Staten Island,50213005002,196,102,94,2.94
2020,CB2020,085,5,Staten Island,50213005003,0,0,0,0.95
2020,CB2020,085,5,Staten Island,50213005004,38,23,15,1.47
2020,CB2020,085,5,Staten Island,50213005005,122,55,67,6.27
2020,CB2020,085,5,Staten Island,50213005006,0,0,0,1.23
2020,CB2020,085,5,Staten Island,50213005007,54,37,17,18.22
2020,CB2020,085,5,Staten Island,50213005008,145,56,89,3.09
2020,CB2020,085,5,Staten Island,50223000001,0,0,0,0
2020,CB2020,085,5,Staten Island,50223001000,30,24,6,37.43
2020,CB2020,085,5,Staten Island,50223001001,242,126,116,6.97
2020,CB2020,085,5,Staten Island,50223001002,124,61,63,1.89
2020,CB2020,085,5,Staten Island,50223001003,77,30,47,0.88
2020,CB2020,085,5,Staten Island,50223001004,315,139,176,9.62
2020,CB2020,085,5,Staten Island,50223001005,0,0,0,0.57
2020,CB2020,085,5,Staten Island,50223001006,116,49,67,2.83
2020,CB2020,085,5,Staten Island,50223001007,253,125,128,9
2020,CB2020,085,5,Staten Island,50223001008,109,29,80,4.68
2020,CB2020,085,5,Staten Island,50223001009,325,158,167,6.82
2020,CB2020,085,5,Staten Island,50223001010,104,56,48,4.23
2020,CB2020,085,5,Staten Island,50223002000,0,0,0,18.75
2020,CB2020,085,5,Staten Island,50223002001,167,88,79,6.92
2020,CB2020,085,5,Staten Island,50223002002,67,45,22,4.48
2020,CB2020,085,5,Staten Island,50223002003,48,43,5,4.15
2020,CB2020,085,5,Staten Island,50223002004,268,122,146,6.29
2020,CB2020,085,5,Staten Island,50223002005,84,39,45,1.87
2020,CB2020,085,5,Staten Island,50223002006,0,0,0,2.8
2020,CB2020,085,5,Staten Island,50223002007,205,74,131,10.48
2020,CB2020,085,5,Staten Island,50223002008,0,0,0,13.61
2020,CB2020,085,5,Staten Island,50223002009,69,48,21,1.96
2020,CB2020,085,5,Staten Island,50223002010,246,118,128,6.3
2020,CB2020,085,5,Staten Island,50223002011,50,25,25,0.76
2020,CB2020,085,5,Staten Island,50223002012,235,94,141,6.67
2020,CB2020,085,5,Staten Island,50223003000,0,0,0,19.41
2020,CB2020,085,5,Staten Island,50226011000,0,0,0,4.69
2020,CB2020,085,5,Staten Island,50226011001,552,264,288,42.55
2020,CB2020,085,5,Staten Island,50226011002,257,93,164,5.4
2020,CB2020,085,5,Staten Island,50226011003,147,87,60,5.11
2020,CB2020,085,5,Staten Island,50226011004,50,24,26,1.04
2020,CB2020,085,5,Staten Island,50226011005,148,80,68,3.56
2020,CB2020,085,5,Staten Island,50226011006,50,30,20,4.7
2020,CB2020,085,5,Staten Island,50226011007,238,135,103,6.96
2020,CB2020,085,5,Staten Island,50226011008,63,30,33,3.26
2020,CB2020,085,5,Staten Island,50226011009,0,0,0,4.24
2020,CB2020,085,5,Staten Island,50226011010,0,0,0,2.07
2020,CB2020,085,5,Staten Island,50226011011,383,171,212,9.79
2020,CB2020,085,5,Staten Island,50226011012,97,54,43,1.42
2020,CB2020,085,5,Staten Island,50226011013,83,58,25,1.52
2020,CB2020,085,5,Staten Island,50226011014,414,207,207,19.3
2020,CB2020,085,5,Staten Island,50226011015,39,13,26,0.82
2020,CB2020,085,5,Staten Island,50226011016,76,31,45,1.88
2020,CB2020,085,5,Staten Island,50226012000,874,440,434,54.26
2020,CB2020,085,5,Staten Island,50226012001,98,29,69,2.26
2020,CB2020,085,5,Staten Island,50226012002,101,59,42,2.9
2020,CB2020,085,5,Staten Island,50226012003,118,63,55,2.81
2020,CB2020,085,5,Staten Island,50226012004,153,76,77,1.86
2020,CB2020,085,5,Staten Island,50226012005,98,45,53,1.75
2020,CB2020,085,5,Staten Island,50226012006,62,24,38,1.19
2020,CB2020,085,5,Staten Island,50226012007,91,36,55,1.43
2020,CB2020,085,5,Staten Island,50226012008,0,0,0,6.22
2020,CB2020,085,5,Staten Island,50226012009,0,0,0,3.31
2020,CB2020,085,5,Staten Island,50226012010,27,6,21,3.28
2020,CB2020,085,5,Staten Island,50226013000,295,157,138,7.77
2020,CB2020,085,5,Staten Island,50226013001,43,13,30,1.76
2020,CB2020,085,5,Staten Island,50226013002,0,0,0,28.7
2020,CB2020,085,5,Staten Island,50226013003,323,159,164,9.16
2020,CB2020,085,5,Staten Island,50226013004,83,23,60,3.63
2020,CB2020,085,5,Staten Island,50226013005,62,36,26,2.79
2020,CB2020,085,5,Staten Island,50226013006,0,0,0,3.77
2020,CB2020,085,5,Staten Island,50226013007,0,0,0,0.14
2020,CB2020,085,5,Staten Island,50226013008,0,0,0,3.58
2020,CB2020,085,5,Staten Island,50226013009,128,80,48,4.13
2020,CB2020,085,5,Staten Island,50226013010,255,115,140,4.88
2020,CB2020,085,5,Staten Island,50226013011,50,17,33,1.69
2020,CB2020,085,5,Staten Island,50226014000,226,120,106,32.85
2020,CB2020,085,5,Staten Island,50226014001,0,0,0,8.49
2020,CB2020,085,5,Staten Island,50226014002,0,0,0,0.57
2020,CB2020,085,5,Staten Island,50226014003,82,51,31,2.13
2020,CB2020,085,5,Staten Island,50226014004,120,62,58,11.9
2020,CB2020,085,5,Staten Island,50226014005,123,37,86,9.2
2020,CB2020,085,5,Staten Island,50226014006,126,56,70,10.28
2020,CB2020,085,5,Staten Island,50226014007,48,21,27,3.74
2020,CB2020,085,5,Staten Island,50226014008,95,44,51,8.04
2020,CB2020,085,5,Staten Island,50226014009,35,5,30,2.68
2020,CB2020,085,5,Staten Island,50226014010,276,143,133,13.12
2020,CB2020,085,5,Staten Island,50226014011,140,83,57,5.66
2020,CB2020,085,5,Staten Island,50226014012,52,34,18,2.86
2020,CB2020,085,5,Staten Island,50226014013,61,34,27,2.78
2020,CB2020,085,5,Staten Island,50226014014,25,6,19,7.42
2020,CB2020,085,5,Staten Island,50226014015,78,32,46,38.59
2020,CB2020,085,5,Staten Island,50226020001,0,0,0,0
2020,CB2020,085,5,Staten Island,50226021000,0,0,0,33.58
2020,CB2020,085,5,Staten Island,50226021001,131,49,82,37.42
2020,CB2020,085,5,Staten Island,50226021002,87,43,44,5.1
2020,CB2020,085,5,Staten Island,50226021003,0,0,0,9.62
2020,CB2020,085,5,Staten Island,50226021004,13,2,11,11.53
2020,CB2020,085,5,Staten Island,50226021005,0,0,0,3.11
2020,CB2020,085,5,Staten Island,50226021006,8,2,6,0.65
2020,CB2020,085,5,Staten Island,50226021007,169,86,83,36.48
2020,CB2020,085,5,Staten Island,50226021008,91,55,36,11.15
2020,CB2020,085,5,Staten Island,50226021009,11,1,10,41.25
2020,CB2020,085,5,Staten Island,50226022000,6,2,4,153.85
2020,CB2020,085,5,Staten Island,50226022001,11,5,6,211.52
2020,CB2020,085,5,Staten Island,50226022002,0,0,0,4.09
2020,CB2020,085,5,Staten Island,50226022003,46,7,39,108.41
2020,CB2020,085,5,Staten Island,50226022004,41,28,13,11.56
2020,CB2020,085,5,Staten Island,50226022005,186,96,90,169.31
2020,CB2020,085,5,Staten Island,50226022006,55,18,37,4.8
2020,CB2020,085,5,Staten Island,50226022007,103,48,55,5.81
2020,CB2020,085,5,Staten Island,50226022008,55,16,39,2.5
2020,CB2020,085,5,Staten Island,50226022009,90,46,44,243.22
2020,CB2020,085,5,Staten Island,50226022010,23,15,8,2.64
2020,CB2020,085,5,Staten Island,50226022011,0,0,0,6.1
2020,CB2020,085,5,Staten Island,50226022012,0,0,0,29.57
2020,CB2020,085,5,Staten Island,50226022013,25,15,10,35.46
2020,CB2020,085,5,Staten Island,50226022014,0,0,0,3.64
2020,CB2020,085,5,Staten Island,50226022015,0,0,0,15.62
2020,CB2020,085,5,Staten Island,50226022016,0,0,0,24.38
2020,CB2020,085,5,Staten Island,50226022017,11,8,3,25.84
2020,CB2020,085,5,Staten Island,50226022018,0,0,0,4.26
2020,CB2020,085,5,Staten Island,50226022019,31,19,12,14.44
2020,CB2020,085,5,Staten Island,50226022020,8,3,5,7.65
2020,CB2020,085,5,Staten Island,50226023000,7,4,3,19.32
2020,CB2020,085,5,Staten Island,50226023001,7,4,3,194.23
2020,CB2020,085,5,Staten Island,50226023002,4,2,2,18.35
2020,CB2020,085,5,Staten Island,50226023003,4,1,3,45.05
2020,CB2020,085,5,Staten Island,50228010001,0,0,0,0
2020,CB2020,085,5,Staten Island,50228011000,5,2,3,79.14
2020,CB2020,085,5,Staten Island,50228011001,0,0,0,10.97
2020,CB2020,085,5,Staten Island,50228011002,0,0,0,3.33
2020,CB2020,085,5,Staten Island,50228011003,0,0,0,2.66
2020,CB2020,085,5,Staten Island,50228011004,0,0,0,13.62
2020,CB2020,085,5,Staten Island,50228011005,0,0,0,202.64
2020,CB2020,085,5,Staten Island,50228011006,0,0,0,4.64
2020,CB2020,085,5,Staten Island,50228011007,90,52,38,29.77
2020,CB2020,085,5,Staten Island,50228011008,0,0,0,12.32
2020,CB2020,085,5,Staten Island,50228012000,0,0,0,0
2020,CB2020,085,5,Staten Island,50228012001,0,0,0,0
2020,CB2020,085,5,Staten Island,50228012002,0,0,0,0
2020,CB2020,085,5,Staten Island,50228012003,0,0,0,76.97
2020,CB2020,085,5,Staten Island,50228012004,0,0,0,568.45
2020,CB2020,085,5,Staten Island,50228021000,2,0,2,118.76
2020,CB2020,085,5,Staten Island,50228021001,6,3,3,204.2
2020,CB2020,085,5,Staten Island,50228021002,0,0,0,0
2020,CB2020,085,5,Staten Island,50228021003,0,0,0,3.13
2020,CB2020,085,5,Staten Island,50228021004,0,0,0,3.84
2020,CB2020,085,5,Staten Island,50228021005,0,0,0,253.28
2020,CB2020,085,5,Staten Island,50228021006,0,0,0,10.69
2020,CB2020,085,5,Staten Island,50228021007,0,0,0,5.93
2020,CB2020,085,5,Staten Island,50228021008,0,0,0,15.38
2020,CB2020,085,5,Staten Island,50228021009,0,0,0,78.78
2020,CB2020,085,5,Staten Island,50228021010,0,0,0,0
2020,CB2020,085,5,Staten Island,50228021011,0,0,0,0
2020,CB2020,085,5,Staten Island,50228021012,0,0,0,0
2020,CB2020,085,5,Staten Island,50228021013,0,0,0,0
2020,CB2020,085,5,Staten Island,50228021014,0,0,0,37.08
2020,CB2020,085,5,Staten Island,50228021015,0,0,0,0
2020,CB2020,085,5,Staten Island,50228021016,0,0,0,0
2020,CB2020,085,5,Staten Island,50228021017,0,0,0,0
2020,CB2020,085,5,Staten Island,50228021018,0,0,0,65.74
2020,CB2020,085,5,Staten Island,50228021019,0,0,0,0
2020,CB2020,085,5,Staten Island,50228021020,0,0,0,19.8
2020,CB2020,085,5,Staten Island,50228021021,0,0,0,0
2020,CB2020,085,5,Staten Island,50228021022,7,5,2,104.27
2020,CB2020,085,5,Staten Island,50228021023,0,0,0,434.21
2020,CB2020,085,5,Staten Island,50228021024,0,0,0,5.9
2020,CB2020,085,5,Staten Island,50231001000,88,51,37,3.52
2020,CB2020,085,5,Staten Island,50231001001,137,73,64,3.48
2020,CB2020,085,5,Staten Island,50231001002,26,22,4,4.93
2020,CB2020,085,5,Staten Island,50231001003,219,88,131,7.16
2020,CB2020,085,5,Staten Island,50231001004,175,95,80,8.49
2020,CB2020,085,5,Staten Island,50231001005,250,112,138,6.77
2020,CB2020,085,5,Staten Island,50231001006,245,117,128,6.89
2020,CB2020,085,5,Staten Island,50231001007,90,35,55,2.61
2020,CB2020,085,5,Staten Island,50231001008,105,50,55,2.34
2020,CB2020,085,5,Staten Island,50231001009,93,30,63,3.57
2020,CB2020,085,5,Staten Island,50231001010,96,41,55,3.51
2020,CB2020,085,5,Staten Island,50231001011,103,48,55,1.79
2020,CB2020,085,5,Staten Island,50231001012,167,78,89,3.81
2020,CB2020,085,5,Staten Island,50231001013,92,62,30,2.36
2020,CB2020,085,5,Staten Island,50231002000,314,187,127,6.06
2020,CB2020,085,5,Staten Island,50231002001,95,51,44,1.77
2020,CB2020,085,5,Staten Island,50231002002,596,354,242,14.35
2020,CB2020,085,5,Staten Island,50231002003,262,129,133,6.31
2020,CB2020,085,5,Staten Island,50231003000,14,9,5,1.57
2020,CB2020,085,5,Staten Island,50231003001,0,0,0,1.51
2020,CB2020,085,5,Staten Island,50231003002,202,113,89,6.74
2020,CB2020,085,5,Staten Island,50231003003,174,81,93,5.86
2020,CB2020,085,5,Staten Island,50231003004,721,363,358,20.4
2020,CB2020,085,5,Staten Island,50231003005,416,212,204,12.28
2020,CB2020,085,5,Staten Island,50231003006,279,125,154,8.44
2020,CB2020,085,5,Staten Island,50239001000,197,108,89,13.04
2020,CB2020,085,5,Staten Island,50239001001,60,16,44,1.51
2020,CB2020,085,5,Staten Island,50239001002,24,19,5,15.29
2020,CB2020,085,5,Staten Island,50239001003,169,80,89,5.6
2020,CB2020,085,5,Staten Island,50239001004,263,141,122,6.22
2020,CB2020,085,5,Staten Island,50239001005,125,48,77,13.01
2020,CB2020,085,5,Staten Island,50239001006,97,40,57,1.97
2020,CB2020,085,5,Staten Island,50239001007,408,222,186,8.23
2020,CB2020,085,5,Staten Island,50239001008,110,56,54,2.89
2020,CB2020,085,5,Staten Island,50239001009,149,94,55,1.72
2020,CB2020,085,5,Staten Island,50239001010,167,73,94,3.51
2020,CB2020,085,5,Staten Island,50239001011,221,82,139,4.85
2020,CB2020,085,5,Staten Island,50239002000,0,0,0,1.12
2020,CB2020,085,5,Staten Island,50239002001,36,20,16,2.43
2020,CB2020,085,5,Staten Island,50239002002,111,50,61,3.64
2020,CB2020,085,5,Staten Island,50239002003,229,101,128,5.91
2020,CB2020,085,5,Staten Island,50239002004,137,80,57,3.28
2020,CB2020,085,5,Staten Island,50239002005,124,45,79,0.98
2020,CB2020,085,5,Staten Island,50239002006,76,37,39,4.09
2020,CB2020,085,5,Staten Island,50239002007,64,33,31,1.88
2020,CB2020,085,5,Staten Island,50239002008,202,97,105,6.31
2020,CB2020,085,5,Staten Island,50239002009,72,39,33,2.23
2020,CB2020,085,5,Staten Island,50239002010,60,24,36,1.39
2020,CB2020,085,5,Staten Island,50239002011,67,39,28,2.19
2020,CB2020,085,5,Staten Island,50239002012,129,51,78,3.56
2020,CB2020,085,5,Staten Island,50239002013,71,41,30,2.35
2020,CB2020,085,5,Staten Island,50239002014,57,24,33,1.44
2020,CB2020,085,5,Staten Island,50239002015,180,89,91,8.43
2020,CB2020,085,5,Staten Island,50239002016,0,0,0,2.41
2020,CB2020,085,5,Staten Island,50244010001,0,0,0,0
2020,CB2020,085,5,Staten Island,50244011000,166,69,97,6.37
2020,CB2020,085,5,Staten Island,50244011001,111,66,45,5.26
2020,CB2020,085,5,Staten Island,50244011002,71,29,42,5.14
2020,CB2020,085,5,Staten Island,50244011003,87,46,41,4.74
2020,CB2020,085,5,Staten Island,50244011004,158,77,81,10.81
2020,CB2020,085,5,Staten Island,50244011005,90,56,34,5.52
2020,CB2020,085,5,Staten Island,50244011006,107,67,40,5.6
2020,CB2020,085,5,Staten Island,50244011007,91,43,48,5.61
2020,CB2020,085,5,Staten Island,50244011008,92,58,34,5.87
2020,CB2020,085,5,Staten Island,50244011009,417,186,231,22.76
2020,CB2020,085,5,Staten Island,50244011010,40,11,29,2.76
2020,CB2020,085,5,Staten Island,50244011011,21,3,18,1.46
2020,CB2020,085,5,Staten Island,50244011012,32,3,29,1.47
2020,CB2020,085,5,Staten Island,50244011013,86,45,41,3.09
2020,CB2020,085,5,Staten Island,50244011014,75,50,25,2.51
2020,CB2020,085,5,Staten Island,50244011015,41,20,21,1.85
2020,CB2020,085,5,Staten Island,50244011016,90,28,62,3.92
2020,CB2020,085,5,Staten Island,50244011017,53,17,36,25.03
2020,CB2020,085,5,Staten Island,50244011018,30,10,20,2.13
2020,CB2020,085,5,Staten Island,50244011019,87,54,33,3.09
2020,CB2020,085,5,Staten Island,50244011020,82,37,45,5.56
2020,CB2020,085,5,Staten Island,50244011021,46,26,20,1.81
2020,CB2020,085,5,Staten Island,50244012000,202,76,126,10.61
2020,CB2020,085,5,Staten Island,50244012001,498,258,240,33.28
2020,CB2020,085,5,Staten Island,50244012002,44,25,19,1.58
2020,CB2020,085,5,Staten Island,50244012003,138,77,61,7.02
2020,CB2020,085,5,Staten Island,50244012004,40,17,23,2.77
2020,CB2020,085,5,Staten Island,50244012005,437,198,239,24.07
2020,CB2020,085,5,Staten Island,50244012006,30,8,22,1.64
2020,CB2020,085,5,Staten Island,50244012007,296,137,159,16.52
2020,CB2020,085,5,Staten Island,50244012008,23,12,11,2.45
2020,CB2020,085,5,Staten Island,50244012009,0,0,0,7.23
2020,CB2020,085,5,Staten Island,50244012010,58,34,24,4.06
2020,CB2020,085,5,Staten Island,50244012011,75,36,39,3.94
2020,CB2020,085,5,Staten Island,50244012012,124,49,75,5.64
2020,CB2020,085,5,Staten Island,50244012013,129,68,61,5.76
2020,CB2020,085,5,Staten Island,50244013000,237,135,102,150.13
2020,CB2020,085,5,Staten Island,50244013001,102,45,57,4.03
2020,CB2020,085,5,Staten Island,50244013002,0,0,0,3.82
2020,CB2020,085,5,Staten Island,50244013003,260,124,136,31.69
2020,CB2020,085,5,Staten Island,50244013004,34,19,15,0.5
2020,CB2020,085,5,Staten Island,50244013005,114,70,44,8.49
2020,CB2020,085,5,Staten Island,50244013006,96,30,66,7.39
2020,CB2020,085,5,Staten Island,50244013007,129,76,53,6.58
2020,CB2020,085,5,Staten Island,50244013008,205,98,107,27.36
2020,CB2020,085,5,Staten Island,50244013009,38,30,8,3.48
2020,CB2020,085,5,Staten Island,50244013010,74,39,35,3.83
2020,CB2020,085,5,Staten Island,50244013011,32,21,11,0.77
2020,CB2020,085,5,Staten Island,50244013012,119,63,56,8.17
2020,CB2020,085,5,Staten Island,50244013013,40,19,21,1.5
2020,CB2020,085,5,Staten Island,50244013014,40,4,36,2.74
2020,CB2020,085,5,Staten Island,50244020001,0,0,0,0
2020,CB2020,085,5,Staten Island,50244020002,0,0,0,0
2020,CB2020,085,5,Staten Island,50244020003,0,0,0,0
2020,CB2020,085,5,Staten Island,50244021000,115,49,66,88.02
2020,CB2020,085,5,Staten Island,50244021001,35,18,17,2.89
2020,CB2020,085,5,Staten Island,50244021002,30,16,14,3.6
2020,CB2020,085,5,Staten Island,50244021003,85,32,53,3.3
2020,CB2020,085,5,Staten Island,50244021004,22,11,11,0.8
2020,CB2020,085,5,Staten Island,50244021005,110,54,56,14.78
2020,CB2020,085,5,Staten Island,50244021006,74,48,26,8.35
2020,CB2020,085,5,Staten Island,50244021007,172,84,88,73.68
2020,CB2020,085,5,Staten Island,50244021008,67,20,47,2.01
2020,CB2020,085,5,Staten Island,50244021009,72,12,60,2.41
2020,CB2020,085,5,Staten Island,50244021010,142,72,70,2.75
2020,CB2020,085,5,Staten Island,50244021011,113,46,67,5.65
2020,CB2020,085,5,Staten Island,50244021012,106,59,47,5.6
2020,CB2020,085,5,Staten Island,50244021013,151,71,80,5.61
2020,CB2020,085,5,Staten Island,50244021014,134,74,60,5.64
2020,CB2020,085,5,Staten Island,50244021015,153,67,86,6.86
2020,CB2020,085,5,Staten Island,50244021016,97,60,37,2.55
2020,CB2020,085,5,Staten Island,50244021017,66,28,38,0.86
2020,CB2020,085,5,Staten Island,50244021018,34,23,11,0.74
2020,CB2020,085,5,Staten Island,50244021019,27,16,11,1.24
2020,CB2020,085,5,Staten Island,50244021020,69,50,19,1.62
2020,CB2020,085,5,Staten Island,50244021021,159,65,94,2.38
2020,CB2020,085,5,Staten Island,50244021022,48,17,31,1.03
2020,CB2020,085,5,Staten Island,50244021023,54,30,24,1.8
2020,CB2020,085,5,Staten Island,50244021024,39,21,18,1.94
2020,CB2020,085,5,Staten Island,50244021025,58,24,34,1.01
2020,CB2020,085,5,Staten Island,50244022000,92,60,32,5.59
2020,CB2020,085,5,Staten Island,50244022001,173,78,95,5.63
2020,CB2020,085,5,Staten Island,50244022002,111,38,73,5.47
2020,CB2020,085,5,Staten Island,50244022003,115,72,43,5.39
2020,CB2020,085,5,Staten Island,50244022004,142,89,53,5.44
2020,CB2020,085,5,Staten Island,50244022005,130,83,47,5.74
2020,CB2020,085,5,Staten Island,50244022006,93,40,53,5.61
2020,CB2020,085,5,Staten Island,50244022007,133,64,69,5.47
2020,CB2020,085,5,Staten Island,50244022008,117,44,73,5.43
2020,CB2020,085,5,Staten Island,50244022009,102,52,50,19.85
2020,CB2020,085,5,Staten Island,50244022010,187,100,87,106.12
2020,CB2020,085,5,Staten Island,50244022011,142,69,73,5.64
2020,CB2020,085,5,Staten Island,50244022012,202,122,80,5.48
2020,CB2020,085,5,Staten Island,50244022013,150,52,98,5.62
2020,CB2020,085,5,Staten Island,50244022014,139,49,90,5.38
2020,CB2020,085,5,Staten Island,50244022015,121,53,68,5.51
2020,CB2020,085,5,Staten Island,50247001000,356,184,172,11.57
2020,CB2020,085,5,Staten Island,50247001001,316,165,151,8.29
2020,CB2020,085,5,Staten Island,50247001002,200,94,106,8.66
2020,CB2020,085,5,Staten Island,50247001003,0,0,0,1.38
2020,CB2020,085,5,Staten Island,50247001004,68,21,47,6.88
2020,CB2020,085,5,Staten Island,50247001005,130,50,80,4.79
2020,CB2020,085,5,Staten Island,50247001006,110,65,45,4.36
2020,CB2020,085,5,Staten Island,50247001007,0,0,0,2.57
2020,CB2020,085,5,Staten Island,50247001008,236,118,118,3.87
2020,CB2020,085,5,Staten Island,50247002000,89,27,62,4.16
2020,CB2020,085,5,Staten Island,50247002001,302,150,152,8.51
2020,CB2020,085,5,Staten Island,50247002002,114,65,49,2.61
2020,CB2020,085,5,Staten Island,50247002003,122,58,64,2.86
2020,CB2020,085,5,Staten Island,50247002004,191,108,83,5.52
2020,CB2020,085,5,Staten Island,50247002005,110,58,52,21.88
2020,CB2020,085,5,Staten Island,50247002006,311,185,126,12.16
2020,CB2020,085,5,Staten Island,50247002007,0,0,0,0.81
2020,CB2020,085,5,Staten Island,50247002008,122,77,45,3.87
2020,CB2020,085,5,Staten Island,50247002009,116,40,76,3.85
2020,CB2020,085,5,Staten Island,50248000001,0,0,0,0
2020,CB2020,085,5,Staten Island,50248001000,127,73,54,6.96
2020,CB2020,085,5,Staten Island,50248001001,75,45,30,1.72
2020,CB2020,085,5,Staten Island,50248001002,29,17,12,1.02
2020,CB2020,085,5,Staten Island,50248001003,194,91,103,6.8
2020,CB2020,085,5,Staten Island,50248001004,118,49,69,3.12
2020,CB2020,085,5,Staten Island,50248001005,26,18,8,1.02
2020,CB2020,085,5,Staten Island,50248001006,202,115,87,9.66
2020,CB2020,085,5,Staten Island,50248001007,116,61,55,7.36
2020,CB2020,085,5,Staten Island,50248001008,139,68,71,4.87
2020,CB2020,085,5,Staten Island,50248001009,80,41,39,3.96
2020,CB2020,085,5,Staten Island,50248001010,69,29,40,3.13
2020,CB2020,085,5,Staten Island,50248001011,83,34,49,4.95
2020,CB2020,085,5,Staten Island,50248001012,90,33,57,13.56
2020,CB2020,085,5,Staten Island,50248001013,95,57,38,6.38
2020,CB2020,085,5,Staten Island,50248001014,108,57,51,6.71
2020,CB2020,085,5,Staten Island,50248002000,162,90,72,4.94
2020,CB2020,085,5,Staten Island,50248002001,43,19,24,1.53
2020,CB2020,085,5,Staten Island,50248002002,128,38,90,6.29
2020,CB2020,085,5,Staten Island,50248002003,205,115,90,9.11
2020,CB2020,085,5,Staten Island,50248002004,97,44,53,4.15
2020,CB2020,085,5,Staten Island,50248002005,123,47,76,6.98
2020,CB2020,085,5,Staten Island,50248002006,153,74,79,9.36
2020,CB2020,085,5,Staten Island,50248002007,80,53,27,3.38
2020,CB2020,085,5,Staten Island,50248002008,104,33,71,7.49
2020,CB2020,085,5,Staten Island,50248002009,120,70,50,6.78
2020,CB2020,085,5,Staten Island,50248002010,89,41,48,3.8
2020,CB2020,085,5,Staten Island,50248002011,169,103,66,8.77
2020,CB2020,085,5,Staten Island,50248002012,115,50,65,6.59
2020,CB2020,085,5,Staten Island,50248003000,20,2,18,35.91
2020,CB2020,085,5,Staten Island,50248003001,0,0,0,14.69
2020,CB2020,085,5,Staten Island,50248003002,19,6,13,19.41
2020,CB2020,085,5,Staten Island,50248003003,73,23,50,16.67
2020,CB2020,085,5,Staten Island,50248003004,27,18,9,23.15
2020,CB2020,085,5,Staten Island,50248003005,101,58,43,2.55
2020,CB2020,085,5,Staten Island,50248003006,41,14,27,1
2020,CB2020,085,5,Staten Island,50248003007,49,11,38,1.85
2020,CB2020,085,5,Staten Island,50248003008,114,70,44,3.56
2020,CB2020,085,5,Staten Island,50248003009,88,36,52,2.4
2020,CB2020,085,5,Staten Island,50248003010,20,5,15,20.9
2020,CB2020,085,5,Staten Island,50248003011,0,0,0,0.9
2020,CB2020,085,5,Staten Island,50248003012,0,0,0,0
2020,CB2020,085,5,Staten Island,50248003013,0,0,0,1.06
2020,CB2020,085,5,Staten Island,50248003014,0,0,0,3.72
2020,CB2020,085,5,Staten Island,50248003015,67,49,18,44.31
2020,CB2020,085,5,Staten Island,50248003016,0,0,0,5.51
2020,CB2020,085,5,Staten Island,50248003017,176,94,82,7.21
2020,CB2020,085,5,Staten Island,50248003018,111,44,67,3.41
2020,CB2020,085,5,Staten Island,50248003019,143,83,60,4.33
2020,CB2020,085,5,Staten Island,50248003020,96,50,46,3.24
2020,CB2020,085,5,Staten Island,50248003021,47,34,13,1.23
2020,CB2020,085,5,Staten Island,50248003022,157,75,82,13.33
2020,CB2020,085,5,Staten Island,50248003023,106,59,47,6.23
2020,CB2020,085,5,Staten Island,50248003024,94,39,55,4.13
2020,CB2020,085,5,Staten Island,50248003025,110,54,56,6.55
2020,CB2020,085,5,Staten Island,50251001000,145,65,80,11.95
2020,CB2020,085,5,Staten Island,50251001001,38,29,9,2.14
2020,CB2020,085,5,Staten Island,50251001002,29,10,19,2.26
2020,CB2020,085,5,Staten Island,50251001003,51,22,29,2.55
2020,CB2020,085,5,Staten Island,50251001004,82,39,43,12.26
2020,CB2020,085,5,Staten Island,50251001005,0,0,0,3.38
2020,CB2020,085,5,Staten Island,50251001006,403,185,218,12.11
2020,CB2020,085,5,Staten Island,50251001007,118,73,45,4.55
2020,CB2020,085,5,Staten Island,50251001008,231,111,120,8.77
2020,CB2020,085,5,Staten Island,50251001009,126,62,64,5.45
2020,CB2020,085,5,Staten Island,50251001010,87,58,29,4.34
2020,CB2020,085,5,Staten Island,50251001011,79,25,54,4.53
2020,CB2020,085,5,Staten Island,50251001012,22,14,8,1.33
2020,CB2020,085,5,Staten Island,50251001013,54,36,18,3.05
2020,CB2020,085,5,Staten Island,50251001014,73,44,29,2.83
2020,CB2020,085,5,Staten Island,50251001015,57,31,26,2.47
2020,CB2020,085,5,Staten Island,50251001016,43,8,35,1.61
2020,CB2020,085,5,Staten Island,50251001017,51,19,32,1.63
2020,CB2020,085,5,Staten Island,50251001018,48,30,18,2.1
2020,CB2020,085,5,Staten Island,50251001019,54,20,34,2.08
2020,CB2020,085,5,Staten Island,50251001020,45,32,13,1.87
2020,CB2020,085,5,Staten Island,50251001021,29,4,25,1.08
2020,CB2020,085,5,Staten Island,50251001022,26,8,18,1.24
2020,CB2020,085,5,Staten Island,50251001023,13,8,5,1.03
2020,CB2020,085,5,Staten Island,50251001024,14,6,8,0.79
2020,CB2020,085,5,Staten Island,50251001025,42,17,25,1.59
2020,CB2020,085,5,Staten Island,50251001026,45,22,23,1.61
2020,CB2020,085,5,Staten Island,50251001027,29,12,17,1.87
2020,CB2020,085,5,Staten Island,50251001028,38,19,19,1.62
2020,CB2020,085,5,Staten Island,50251001029,55,21,34,3.11
2020,CB2020,085,5,Staten Island,50251001030,34,28,6,1.59
2020,CB2020,085,5,Staten Island,50251001031,22,2,20,1.56
2020,CB2020,085,5,Staten Island,50251001032,38,30,8,1.61
2020,CB2020,085,5,Staten Island,50251002000,52,31,21,2.4
2020,CB2020,085,5,Staten Island,50251002001,39,16,23,2.5
2020,CB2020,085,5,Staten Island,50251002002,47,23,24,2.5
2020,CB2020,085,5,Staten Island,50251002003,106,57,49,2.92
2020,CB2020,085,5,Staten Island,50251002004,78,35,43,2.57
2020,CB2020,085,5,Staten Island,50251002005,0,0,0,3.68
2020,CB2020,085,5,Staten Island,50251002006,82,42,40,2.75
2020,CB2020,085,5,Staten Island,50251002007,62,7,55,3.22
2020,CB2020,085,5,Staten Island,50251002008,49,13,36,3.28
2020,CB2020,085,5,Staten Island,50251002009,89,47,42,3.37
2020,CB2020,085,5,Staten Island,50251002010,42,21,21,2.53
2020,CB2020,085,5,Staten Island,50251002011,86,42,44,2.92
2020,CB2020,085,5,Staten Island,50251002012,157,73,84,5.95
2020,CB2020,085,5,Staten Island,50251002013,68,35,33,2.22
2020,CB2020,085,5,Staten Island,50251002014,59,29,30,4.73
2020,CB2020,085,5,Staten Island,50251002015,50,44,6,1.2
2020,CB2020,085,5,Staten Island,50251002016,93,43,50,7.59
2020,CB2020,085,5,Staten Island,50251002017,54,13,41,2.63
2020,CB2020,085,5,Staten Island,50251002018,62,27,35,2.75
2020,CB2020,085,5,Staten Island,50251002019,47,35,12,2.65
2020,CB2020,085,5,Staten Island,50251002020,34,14,20,2.41
2020,CB2020,085,5,Staten Island,50251002021,49,15,34,2.33
2020,CB2020,085,5,Staten Island,50251002022,36,13,23,2.2
2020,CB2020,085,5,Staten Island,50251003000,151,70,81,7.12
2020,CB2020,085,5,Staten Island,50251003001,161,94,67,5.28
2020,CB2020,085,5,Staten Island,50251003002,179,68,111,5.3
2020,CB2020,085,5,Staten Island,50251003003,153,72,81,4.72
2020,CB2020,085,5,Staten Island,50251003004,118,55,63,4.92
2020,CB2020,085,5,Staten Island,50251003005,88,38,50,4.89
2020,CB2020,085,5,Staten Island,50251003006,0,0,0,15.39
2020,CB2020,085,5,Staten Island,50251003007,872,423,449,29.41
2020,CB2020,085,5,Staten Island,50251003008,93,47,46,4.27
2020,CB2020,085,5,Staten Island,50251003009,74,30,44,3.59
2020,CB2020,085,5,Staten Island,50251003010,145,72,73,5.04
2020,CB2020,085,5,Staten Island,50251003011,110,53,57,4.71
2020,CB2020,085,5,Staten Island,50251003012,60,47,13,3
2020,CB2020,085,5,Staten Island,50251003013,107,55,52,3.02
2020,CB2020,085,5,Staten Island,50251003014,57,15,42,3.09
2020,CB2020,085,5,Staten Island,50251003015,0,0,0,2.51
2020,CB2020,085,5,Staten Island,50273011000,0,0,0,38.61
2020,CB2020,085,5,Staten Island,50273012000,8,3,5,59.6
2020,CB2020,085,5,Staten Island,50273012001,0,0,0,14.16
2020,CB2020,085,5,Staten Island,50273012002,0,0,0,6.35
2020,CB2020,085,5,Staten Island,50273012003,0,0,0,16.3
2020,CB2020,085,5,Staten Island,50273012004,396,148,248,75.37
2020,CB2020,085,5,Staten Island,50273012005,0,0,0,12.74
2020,CB2020,085,5,Staten Island,50273012006,0,0,0,0.93
2020,CB2020,085,5,Staten Island,50273012007,0,0,0,7.23
2020,CB2020,085,5,Staten Island,50273012008,119,72,47,14.7
2020,CB2020,085,5,Staten Island,50273012009,0,0,0,9.92
2020,CB2020,085,5,Staten Island,50273012010,0,0,0,1.37
2020,CB2020,085,5,Staten Island,50273012011,0,0,0,0.42
2020,CB2020,085,5,Staten Island,50273012012,0,0,0,64.33
2020,CB2020,085,5,Staten Island,50273012013,0,0,0,2.77
2020,CB2020,085,5,Staten Island,50273012014,0,0,0,6.14
2020,CB2020,085,5,Staten Island,50273012015,0,0,0,34.45
2020,CB2020,085,5,Staten Island,50273013000,84,28,56,12.45
2020,CB2020,085,5,Staten Island,50273013001,120,46,74,3.73
2020,CB2020,085,5,Staten Island,50273013002,129,66,63,3.98
2020,CB2020,085,5,Staten Island,50273013003,218,104,114,7.27
2020,CB2020,085,5,Staten Island,50273013004,111,64,47,3.37
2020,CB2020,085,5,Staten Island,50273013005,103,45,58,3.46
2020,CB2020,085,5,Staten Island,50273013006,126,86,40,4.15
2020,CB2020,085,5,Staten Island,50273013007,32,9,23,0.94
2020,CB2020,085,5,Staten Island,50273013008,402,166,236,16.55
2020,CB2020,085,5,Staten Island,50273013009,75,39,36,1.56
2020,CB2020,085,5,Staten Island,50273013010,50,13,37,1.4
2020,CB2020,085,5,Staten Island,50273013011,63,26,37,1.67
2020,CB2020,085,5,Staten Island,50273013012,142,68,74,5.7
2020,CB2020,085,5,Staten Island,50273013013,239,118,121,7.41
2020,CB2020,085,5,Staten Island,50273013014,154,78,76,5.09
2020,CB2020,085,5,Staten Island,50273013015,204,108,96,8.87
2020,CB2020,085,5,Staten Island,50273013016,59,18,41,0.87
2020,CB2020,085,5,Staten Island,50273013017,206,120,86,3.8
2020,CB2020,085,5,Staten Island,50273013018,116,63,53,1.79
2020,CB2020,085,5,Staten Island,50273013019,45,27,18,1
2020,CB2020,085,5,Staten Island,50273014000,0,0,0,13.18
2020,CB2020,085,5,Staten Island,50273014001,217,101,116,196.07
2020,CB2020,085,5,Staten Island,50273014002,244,120,124,5.66
2020,CB2020,085,5,Staten Island,50273014003,174,92,82,4.19
2020,CB2020,085,5,Staten Island,50273014004,82,36,46,8.56
2020,CB2020,085,5,Staten Island,50273015000,0,0,0,1.84
2020,CB2020,085,5,Staten Island,50273015001,0,0,0,3.91
2020,CB2020,085,5,Staten Island,50273015002,147,84,63,6.13
2020,CB2020,085,5,Staten Island,50273015003,416,196,220,37.59
2020,CB2020,085,5,Staten Island,50273015004,138,65,73,5.21
2020,CB2020,085,5,Staten Island,50273015005,32,13,19,0.41
2020,CB2020,085,5,Staten Island,50273015006,160,64,96,4.27
2020,CB2020,085,5,Staten Island,50273015007,0,0,0,1.23
2020,CB2020,085,5,Staten Island,50273021000,265,137,128,11.5
2020,CB2020,085,5,Staten Island,50273021001,177,99,78,4.35
2020,CB2020,085,5,Staten Island,50273021002,79,28,51,2.76
2020,CB2020,085,5,Staten Island,50273021003,64,46,18,2
2020,CB2020,085,5,Staten Island,50273021004,80,15,65,3.38
2020,CB2020,085,5,Staten Island,50273021005,102,41,61,2.98
2020,CB2020,085,5,Staten Island,50273021006,162,105,57,4.08
2020,CB2020,085,5,Staten Island,50273021007,170,96,74,4.04
2020,CB2020,085,5,Staten Island,50273021008,115,59,56,4.05
2020,CB2020,085,5,Staten Island,50273021009,194,106,88,4.21
2020,CB2020,085,5,Staten Island,50273021010,159,79,80,3.88
2020,CB2020,085,5,Staten Island,50273021011,116,56,60,3.73
2020,CB2020,085,5,Staten Island,50273021012,140,61,79,6.8
2020,CB2020,085,5,Staten Island,50273021013,105,44,61,2.97
2020,CB2020,085,5,Staten Island,50273021014,111,31,80,3.14
2020,CB2020,085,5,Staten Island,50273021015,136,80,56,3
2020,CB2020,085,5,Staten Island,50273021016,234,92,142,5.46
2020,CB2020,085,5,Staten Island,50273021017,129,65,64,3.31
2020,CB2020,085,5,Staten Island,50273021018,120,66,54,4.05
2020,CB2020,085,5,Staten Island,50273022000,160,82,78,3.32
2020,CB2020,085,5,Staten Island,50273022001,141,76,65,3.79
2020,CB2020,085,5,Staten Island,50273022002,86,39,47,3.22
2020,CB2020,085,5,Staten Island,50273022003,372,161,211,142.92
2020,CB2020,085,5,Staten Island,50273022004,115,55,60,3.15
2020,CB2020,085,5,Staten Island,50273022005,141,69,72,3.26
2020,CB2020,085,5,Staten Island,50273022006,146,89,57,2.9
2020,CB2020,085,5,Staten Island,50273022007,120,63,57,3.09
2020,CB2020,085,5,Staten Island,50273022008,55,36,19,1.78
2020,CB2020,085,5,Staten Island,50273022009,248,123,125,5.19
2020,CB2020,085,5,Staten Island,50277021000,39,23,16,0.49
2020,CB2020,085,5,Staten Island,50277021001,1148,505,643,33.82
2020,CB2020,085,5,Staten Island,50277021002,62,24,38,2.18
2020,CB2020,085,5,Staten Island,50277021003,82,55,27,0.64
2020,CB2020,085,5,Staten Island,50277021004,350,147,203,9.49
2020,CB2020,085,5,Staten Island,50277022000,402,212,190,19.08
2020,CB2020,085,5,Staten Island,50277022001,0,0,0,0.77
2020,CB2020,085,5,Staten Island,50277022002,428,179,249,4.35
2020,CB2020,085,5,Staten Island,50277022003,63,21,42,1.17
2020,CB2020,085,5,Staten Island,50277022004,65,31,34,1.06
2020,CB2020,085,5,Staten Island,50277022005,77,46,31,1.66
2020,CB2020,085,5,Staten Island,50277022006,83,39,44,0.96
2020,CB2020,085,5,Staten Island,50277022007,65,34,31,3.85
2020,CB2020,085,5,Staten Island,50277022008,79,43,36,0.83
2020,CB2020,085,5,Staten Island,50277022009,0,0,0,64.97
2020,CB2020,085,5,Staten Island,50277022010,0,0,0,12.78
2020,CB2020,085,5,Staten Island,50277022011,0,0,0,8.08
2020,CB2020,085,5,Staten Island,50277022012,0,0,0,9.33
2020,CB2020,085,5,Staten Island,50277022013,0,0,0,18.03
2020,CB2020,085,5,Staten Island,50277022014,234,129,105,15.77
2020,CB2020,085,5,Staten Island,50277022015,0,0,0,9.31
2020,CB2020,085,5,Staten Island,50277022016,0,0,0,8.14
2020,CB2020,085,5,Staten Island,50277022017,125,54,71,4.65
2020,CB2020,085,5,Staten Island,50277022018,0,0,0,29.15
2020,CB2020,085,5,Staten Island,50277022019,0,0,0,13.9
2020,CB2020,085,5,Staten Island,50277023000,146,74,72,2.85
2020,CB2020,085,5,Staten Island,50277023001,683,320,363,19.79
2020,CB2020,085,5,Staten Island,50277023002,76,35,41,0.66
2020,CB2020,085,5,Staten Island,50277023003,45,24,21,0.5
2020,CB2020,085,5,Staten Island,50277023004,66,24,42,0.47
2020,CB2020,085,5,Staten Island,50277023005,121,67,54,4.16
2020,CB2020,085,5,Staten Island,50277023006,413,177,236,6.57
2020,CB2020,085,5,Staten Island,50277024000,75,53,22,1.7
2020,CB2020,085,5,Staten Island,50277024001,108,44,64,1.92
2020,CB2020,085,5,Staten Island,50277024002,371,172,199,26.78
2020,CB2020,085,5,Staten Island,50277024003,102,55,47,2.41
2020,CB2020,085,5,Staten Island,50277024004,165,56,109,3.69
2020,CB2020,085,5,Staten Island,50277024005,58,16,42,1.33
2020,CB2020,085,5,Staten Island,50277024006,626,297,329,10.06
2020,CB2020,085,5,Staten Island,50277024007,32,17,15,0.48
2020,CB2020,085,5,Staten Island,50277024008,90,38,52,1.74
2020,CB2020,085,5,Staten Island,50277041000,249,114,135,5.88
2020,CB2020,085,5,Staten Island,50277041001,263,116,147,5.42
2020,CB2020,085,5,Staten Island,50277041002,240,134,106,5.22
2020,CB2020,085,5,Staten Island,50277041003,280,140,140,7.77
2020,CB2020,085,5,Staten Island,50277041004,417,200,217,31.3
2020,CB2020,085,5,Staten Island,50277041005,145,65,80,4.9
2020,CB2020,085,5,Staten Island,50277041006,288,120,168,5.54
2020,CB2020,085,5,Staten Island,50277042000,1224,577,647,32.17
2020,CB2020,085,5,Staten Island,50277042001,237,125,112,4.55
2020,CB2020,085,5,Staten Island,50277042002,207,97,110,4.58
2020,CB2020,085,5,Staten Island,50277042003,246,130,116,4.44
2020,CB2020,085,5,Staten Island,50277042004,382,186,196,9.86
2020,CB2020,085,5,Staten Island,50277042005,271,114,157,5.94
2020,CB2020,085,5,Staten Island,50277042006,163,78,85,2.91
2020,CB2020,085,5,Staten Island,50277051000,108,65,43,7.47
2020,CB2020,085,5,Staten Island,50277051001,581,297,284,11.02
2020,CB2020,085,5,Staten Island,50277051002,321,165,156,5.06
2020,CB2020,085,5,Staten Island,50277051003,330,137,193,5.21
2020,CB2020,085,5,Staten Island,50277051004,292,136,156,5.24
2020,CB2020,085,5,Staten Island,50277051005,236,97,139,6.81
2020,CB2020,085,5,Staten Island,50277051006,192,108,84,4.16
2020,CB2020,085,5,Staten Island,50277051007,131,67,64,2.43
2020,CB2020,085,5,Staten Island,50277051008,119,80,39,2.37
2020,CB2020,085,5,Staten Island,50277051009,85,44,41,2.41
2020,CB2020,085,5,Staten Island,50277051010,91,48,43,2.42
2020,CB2020,085,5,Staten Island,50277051011,116,73,43,3.12
2020,CB2020,085,5,Staten Island,50277052000,183,110,73,5.68
2020,CB2020,085,5,Staten Island,50277052001,304,154,150,8.48
2020,CB2020,085,5,Staten Island,50277052002,232,114,118,6.16
2020,CB2020,085,5,Staten Island,50277052003,298,133,165,6.17
2020,CB2020,085,5,Staten Island,50277052004,302,147,155,7.77
2020,CB2020,085,5,Staten Island,50277052005,217,85,132,5.8
2020,CB2020,085,5,Staten Island,50277053000,290,134,156,4.71
2020,CB2020,085,5,Staten Island,50277053001,290,163,127,4.79
2020,CB2020,085,5,Staten Island,50277053002,308,163,145,4.74
2020,CB2020,085,5,Staten Island,50277053003,383,173,210,9.61
2020,CB2020,085,5,Staten Island,50277053004,214,112,102,4.7
2020,CB2020,085,5,Staten Island,50277053005,243,106,137,4.99
2020,CB2020,085,5,Staten Island,50277061000,170,95,75,7.33
2020,CB2020,085,5,Staten Island,50277061001,200,98,102,4.95
2020,CB2020,085,5,Staten Island,50277061002,193,83,110,4.61
2020,CB2020,085,5,Staten Island,50277061003,40,21,19,4.34
2020,CB2020,085,5,Staten Island,50277061004,24,14,10,2.22
2020,CB2020,085,5,Staten Island,50277061005,338,176,162,8.26
2020,CB2020,085,5,Staten Island,50277061006,0,0,0,8.64
2020,CB2020,085,5,Staten Island,50277061007,23,9,14,0.55
2020,CB2020,085,5,Staten Island,50277061008,0,0,0,1.29
2020,CB2020,085,5,Staten Island,50277061009,125,53,72,3.83
2020,CB2020,085,5,Staten Island,50277062000,26,19,7,6.9
2020,CB2020,085,5,Staten Island,50277062001,293,137,156,6.77
2020,CB2020,085,5,Staten Island,50277062002,390,210,180,11.12
2020,CB2020,085,5,Staten Island,50277062003,256,123,133,6.92
2020,CB2020,085,5,Staten Island,50277062004,55,19,36,1.03
2020,CB2020,085,5,Staten Island,50277063000,193,95,98,17.94
2020,CB2020,085,5,Staten Island,50277063001,527,240,287,8.02
2020,CB2020,085,5,Staten Island,50277063002,190,95,95,3.67
2020,CB2020,085,5,Staten Island,50279001000,124,64,60,413.17
2020,CB2020,085,5,Staten Island,50279001001,0,0,0,0.44
2020,CB2020,085,5,Staten Island,50279001002,67,30,37,7.79
2020,CB2020,085,5,Staten Island,50279001003,120,57,63,13.33
2020,CB2020,085,5,Staten Island,50279001004,45,16,29,4.57
2020,CB2020,085,5,Staten Island,50279001005,57,11,46,4.31
2020,CB2020,085,5,Staten Island,50279001006,33,10,23,34.08
2020,CB2020,085,5,Staten Island,50279001007,68,25,43,4.68
2020,CB2020,085,5,Staten Island,50279001008,51,36,15,9.86
2020,CB2020,085,5,Staten Island,50279001009,97,71,26,11.64
2020,CB2020,085,5,Staten Island,50279001010,23,15,8,2.81
2020,CB2020,085,5,Staten Island,50279001011,31,26,5,8.35
2020,CB2020,085,5,Staten Island,50279001012,22,14,8,4.75
2020,CB2020,085,5,Staten Island,50279001013,88,52,36,16.89
2020,CB2020,085,5,Staten Island,50279001014,50,9,41,3.18
2020,CB2020,085,5,Staten Island,50279001015,12,11,1,345.28
2020,CB2020,085,5,Staten Island,50279001016,93,44,49,9.51
2020,CB2020,085,5,Staten Island,50279001017,0,0,0,0.6
2020,CB2020,085,5,Staten Island,50279001018,0,0,0,2.4
2020,CB2020,085,5,Staten Island,50279001019,0,0,0,2.92
2020,CB2020,085,5,Staten Island,50279001020,0,0,0,5.58
2020,CB2020,085,5,Staten Island,50279001021,0,0,0,2.55
2020,CB2020,085,5,Staten Island,50279001022,80,25,55,3.58
2020,CB2020,085,5,Staten Island,50279001023,45,33,12,1.13
2020,CB2020,085,5,Staten Island,50279002000,370,104,266,59.12
2020,CB2020,085,5,Staten Island,50279002001,19,8,11,2.46
2020,CB2020,085,5,Staten Island,50279002002,26,9,17,2.58
2020,CB2020,085,5,Staten Island,50279002003,97,48,49,9.78
2020,CB2020,085,5,Staten Island,50279002004,67,45,22,8.53
2020,CB2020,085,5,Staten Island,50279002005,45,21,24,4.06
2020,CB2020,085,5,Staten Island,50279002006,0,0,0,3.4
2020,CB2020,085,5,Staten Island,50279002007,187,88,99,24.02
2020,CB2020,085,5,Staten Island,50279002008,45,24,21,2.83
2020,CB2020,085,5,Staten Island,50279002009,44,13,31,5.17
2020,CB2020,085,5,Staten Island,50279002010,35,23,12,8.17
2020,CB2020,085,5,Staten Island,50279002011,52,21,31,2.9
2020,CB2020,085,5,Staten Island,50279002012,0,0,0,2.86
2020,CB2020,085,5,Staten Island,50279003000,17,8,9,147.38
2020,CB2020,085,5,Staten Island,50279003001,0,0,0,0
2020,CB2020,085,5,Staten Island,50279004000,0,0,0,41.37
2020,CB2020,085,5,Staten Island,50279004001,0,0,0,0
2020,CB2020,085,5,Staten Island,50279004002,0,0,0,57.68
2020,CB2020,085,5,Staten Island,50279004003,0,0,0,0
2020,CB2020,085,5,Staten Island,50291020001,0,0,0,0
2020,CB2020,085,5,Staten Island,50291020002,0,0,0,0
2020,CB2020,085,5,Staten Island,50291021000,0,0,0,82.64
2020,CB2020,085,5,Staten Island,50291021001,0,0,0,3.58
2020,CB2020,085,5,Staten Island,50291021002,0,0,0,22.05
2020,CB2020,085,5,Staten Island,50291021003,0,0,0,18.5
2020,CB2020,085,5,Staten Island,50291021004,0,0,0,0
2020,CB2020,085,5,Staten Island,50291021005,0,0,0,36.82
2020,CB2020,085,5,Staten Island,50291021006,0,0,0,120.24
2020,CB2020,085,5,Staten Island,50291021007,0,0,0,4.27
2020,CB2020,085,5,Staten Island,50291021008,0,0,0,23.09
2020,CB2020,085,5,Staten Island,50291021009,0,0,0,23.2
2020,CB2020,085,5,Staten Island,50291021010,0,0,0,22.1
2020,CB2020,085,5,Staten Island,50291021011,0,0,0,33.82
2020,CB2020,085,5,Staten Island,50291021012,0,0,0,0
2020,CB2020,085,5,Staten Island,50291021013,0,0,0,5.32
2020,CB2020,085,5,Staten Island,50291021014,0,0,0,3.1
2020,CB2020,085,5,Staten Island,50291021015,0,0,0,5.1
2020,CB2020,085,5,Staten Island,50291021016,0,0,0,17.31
2020,CB2020,085,5,Staten Island,50291021017,0,0,0,0
2020,CB2020,085,5,Staten Island,50291021018,0,0,0,0
2020,CB2020,085,5,Staten Island,50291021019,31,18,13,161.69
2020,CB2020,085,5,Staten Island,50291021020,0,0,0,0
2020,CB2020,085,5,Staten Island,50291021021,0,0,0,33.2
2020,CB2020,085,5,Staten Island,50291021022,0,0,0,6.13
2020,CB2020,085,5,Staten Island,50291021023,0,0,0,12.34
2020,CB2020,085,5,Staten Island,50291021024,0,0,0,5.01
2020,CB2020,085,5,Staten Island,50291021025,0,0,0,31.97
2020,CB2020,085,5,Staten Island,50291021026,0,0,0,0
2020,CB2020,085,5,Staten Island,50291021027,0,0,0,2.49
2020,CB2020,085,5,Staten Island,50291021028,17,11,6,66.58
2020,CB2020,085,5,Staten Island,50291021029,0,0,0,41.43
2020,CB2020,085,5,Staten Island,50291021030,0,0,0,25.18
2020,CB2020,085,5,Staten Island,50291021031,0,0,0,26.4
2020,CB2020,085,5,Staten Island,50291021032,0,0,0,74.18
2020,CB2020,085,5,Staten Island,50291021033,0,0,0,67.76
2020,CB2020,085,5,Staten Island,50291021034,0,0,0,3.99
2020,CB2020,085,5,Staten Island,50291021035,0,0,0,61.14
2020,CB2020,085,5,Staten Island,50291021036,0,0,0,0
2020,CB2020,085,5,Staten Island,50291021037,0,0,0,60.06
2020,CB2020,085,5,Staten Island,50291021038,0,0,0,94.9
2020,CB2020,085,5,Staten Island,50291021039,0,0,0,0
2020,CB2020,085,5,Staten Island,50291021040,0,0,0,0
2020,CB2020,085,5,Staten Island,50291021041,0,0,0,29.39
2020,CB2020,085,5,Staten Island,50291021042,0,0,0,108.04
2020,CB2020,085,5,Staten Island,50291021043,0,0,0,40.61
2020,CB2020,085,5,Staten Island,50291021044,0,0,0,8.94
2020,CB2020,085,5,Staten Island,50291021045,0,0,0,26.22
2020,CB2020,085,5,Staten Island,50291021046,0,0,0,54.72
2020,CB2020,085,5,Staten Island,50291021047,0,0,0,5.74
2020,CB2020,085,5,Staten Island,50291021048,0,0,0,3.24
2020,CB2020,085,5,Staten Island,50291021049,0,0,0,11.05
2020,CB2020,085,5,Staten Island,50291021050,0,0,0,26.56
2020,CB2020,085,5,Staten Island,50291021051,0,0,0,55.2
2020,CB2020,085,5,Staten Island,50291021052,0,0,0,31.56
2020,CB2020,085,5,Staten Island,50291021053,0,0,0,24.18
2020,CB2020,085,5,Staten Island,50291021054,0,0,0,0
2020,CB2020,085,5,Staten Island,50291021055,0,0,0,4.59
2020,CB2020,085,5,Staten Island,50291021056,0,0,0,5.08
2020,CB2020,085,5,Staten Island,50291021057,0,0,0,0
2020,CB2020,085,5,Staten Island,50291021058,91,33,58,131.18
2020,CB2020,085,5,Staten Island,50291021059,0,0,0,4.71
2020,CB2020,085,5,Staten Island,50291021060,0,0,0,46.66
2020,CB2020,085,5,Staten Island,50291021061,0,0,0,1.98
2020,CB2020,085,5,Staten Island,50291021062,53,21,32,1.91
2020,CB2020,085,5,Staten Island,50291021063,143,64,79,17.28
2020,CB2020,085,5,Staten Island,50291021064,0,0,0,134.39
2020,CB2020,085,5,Staten Island,50291021065,0,0,0,4.42
2020,CB2020,085,5,Staten Island,50291021066,172,74,98,7.51
2020,CB2020,085,5,Staten Island,50291021067,171,93,78,6.22
2020,CB2020,085,5,Staten Island,50291021068,108,54,54,4.52
2020,CB2020,085,5,Staten Island,50291021069,110,69,41,4.03
2020,CB2020,085,5,Staten Island,50291021070,48,32,16,4.69
2020,CB2020,085,5,Staten Island,50291022000,905,443,462,51.25
2020,CB2020,085,5,Staten Island,50291022001,37,19,18,0.39
2020,CB2020,085,5,Staten Island,50291022002,60,29,31,1.17
2020,CB2020,085,5,Staten Island,50291022003,230,96,134,34.48
2020,CB2020,085,5,Staten Island,50291022004,80,50,30,4.25
2020,CB2020,085,5,Staten Island,50291022005,127,61,66,3.43
2020,CB2020,085,5,Staten Island,50291022006,122,64,58,4.96
2020,CB2020,085,5,Staten Island,50291022007,201,99,102,3.54
2020,CB2020,085,5,Staten Island,50291022008,137,65,72,3.6
2020,CB2020,085,5,Staten Island,50291022009,114,49,65,3.62
2020,CB2020,085,5,Staten Island,50291022010,91,51,40,8.3
2020,CB2020,085,5,Staten Island,50291022011,0,0,0,5.43
2020,CB2020,085,5,Staten Island,50291022012,17,6,11,11.34
2020,CB2020,085,5,Staten Island,50291022013,70,41,29,5.21
2020,CB2020,085,5,Staten Island,50291022014,154,60,94,5.47
2020,CB2020,085,5,Staten Island,50291022015,0,0,0,3.26
2020,CB2020,085,5,Staten Island,50291022016,0,0,0,5.42
2020,CB2020,085,5,Staten Island,50291022017,87,49,38,28.05
2020,CB2020,085,5,Staten Island,50291022018,18,8,10,74.11
2020,CB2020,085,5,Staten Island,50291022019,0,0,0,26.23
2020,CB2020,085,5,Staten Island,50291022020,0,0,0,0
2020,CB2020,085,5,Staten Island,50291041000,0,0,0,7.3
2020,CB2020,085,5,Staten Island,50291041001,0,0,0,26.87
2020,CB2020,085,5,Staten Island,50291041002,228,108,120,5.63
2020,CB2020,085,5,Staten Island,50291041003,325,162,163,5.09
2020,CB2020,085,5,Staten Island,50291041004,129,56,73,4.33
2020,CB2020,085,5,Staten Island,50291041005,283,133,150,4.7
2020,CB2020,085,5,Staten Island,50291041006,143,84,59,3.36
2020,CB2020,085,5,Staten Island,50291041007,164,88,76,4.63
2020,CB2020,085,5,Staten Island,50291041008,144,82,62,3.27
2020,CB2020,085,5,Staten Island,50291041009,218,120,98,4.17
2020,CB2020,085,5,Staten Island,50291042000,309,126,183,88.78
2020,CB2020,085,5,Staten Island,50291042001,121,70,51,3.46
2020,CB2020,085,5,Staten Island,50291042002,143,92,51,4.87
2020,CB2020,085,5,Staten Island,50291042003,167,76,91,4.65
2020,CB2020,085,5,Staten Island,50291042004,183,95,88,6.21
2020,CB2020,085,5,Staten Island,50291042005,258,113,145,9.16
2020,CB2020,085,5,Staten Island,50291042006,137,76,61,4.29
2020,CB2020,085,5,Staten Island,50291042007,362,182,180,12.65
2020,CB2020,085,5,Staten Island,50291042008,151,74,77,4.44
2020,CB2020,085,5,Staten Island,50291042009,160,78,82,4.41
2020,CB2020,085,5,Staten Island,50291043000,174,92,82,8.97
2020,CB2020,085,5,Staten Island,50291043001,77,31,46,2.34
2020,CB2020,085,5,Staten Island,50291043002,35,20,15,2.48
2020,CB2020,085,5,Staten Island,50291043003,48,25,23,3.09
2020,CB2020,085,5,Staten Island,50291043004,68,27,41,3.03
2020,CB2020,085,5,Staten Island,50291043005,30,27,3,2.62
2020,CB2020,085,5,Staten Island,50291043006,67,34,33,4.59
2020,CB2020,085,5,Staten Island,50291043007,417,184,233,11.05
2020,CB2020,085,5,Staten Island,50291043008,132,59,73,3.79
2020,CB2020,085,5,Staten Island,50291043009,163,102,61,3.73
2020,CB2020,085,5,Staten Island,50291043010,105,41,64,4.15
2020,CB2020,085,5,Staten Island,50291043011,196,74,122,4.27
2020,CB2020,085,5,Staten Island,50291043012,219,102,117,4.53
2020,CB2020,085,5,Staten Island,50291043013,38,29,9,7.83
2020,CB2020,085,5,Staten Island,50291044000,0,0,0,2.91
2020,CB2020,085,5,Staten Island,50291044001,7,4,3,35.55
2020,CB2020,085,5,Staten Island,50291044002,38,23,15,17.02
2020,CB2020,085,5,Staten Island,50291044003,254,105,149,7.37
2020,CB2020,085,5,Staten Island,50291044004,58,27,31,1.45
2020,CB2020,085,5,Staten Island,50291044005,149,63,86,8.33
2020,CB2020,085,5,Staten Island,50291044006,144,66,78,2.45
2020,CB2020,085,5,Staten Island,50291044007,303,153,150,4.23
2020,CB2020,085,5,Staten Island,50291044008,165,69,96,3.39
2020,CB2020,085,5,Staten Island,50291044009,418,199,219,11.96
2020,CB2020,085,5,Staten Island,50291044010,212,104,108,4.25
2020,CB2020,085,5,Staten Island,50291044011,36,23,13,0.54
2020,CB2020,085,5,Staten Island,50291044012,0,0,0,2.74
2020,CB2020,085,5,Staten Island,50291051000,179,86,93,5.21
2020,CB2020,085,5,Staten Island,50291051001,374,168,206,41.59
2020,CB2020,085,5,Staten Island,50291051002,188,92,96,4.67
2020,CB2020,085,5,Staten Island,50291051003,103,61,42,3.99
2020,CB2020,085,5,Staten Island,50291051004,141,69,72,4.63
2020,CB2020,085,5,Staten Island,50291051005,91,54,37,3.93
2020,CB2020,085,5,Staten Island,50291051006,114,63,51,4.21
2020,CB2020,085,5,Staten Island,50291051007,376,186,190,10.57
2020,CB2020,085,5,Staten Island,50291051008,117,46,71,2.8
2020,CB2020,085,5,Staten Island,50291051009,24,12,12,159.87
2020,CB2020,085,5,Staten Island,50291051010,0,0,0,30.04
2020,CB2020,085,5,Staten Island,50291051011,63,30,33,3.14
2020,CB2020,085,5,Staten Island,50291051012,0,0,0,0.58
2020,CB2020,085,5,Staten Island,50291052000,221,129,92,4.48
2020,CB2020,085,5,Staten Island,50291052001,287,132,155,9.59
2020,CB2020,085,5,Staten Island,50291052002,102,55,47,4.08
2020,CB2020,085,5,Staten Island,50291052003,74,28,46,5.01
2020,CB2020,085,5,Staten Island,50291052004,35,26,9,8.96
2020,CB2020,085,5,Staten Island,50291052005,435,186,249,12.17
2020,CB2020,085,5,Staten Island,50291052006,0,0,0,2.57
2020,CB2020,085,5,Staten Island,50291052007,64,18,46,2.45
2020,CB2020,085,5,Staten Island,50291053000,125,56,69,16.08
2020,CB2020,085,5,Staten Island,50291053001,119,31,88,11.79
2020,CB2020,085,5,Staten Island,50291053002,143,68,75,4.26
2020,CB2020,085,5,Staten Island,50291053003,26,12,14,2.43
2020,CB2020,085,5,Staten Island,50291053004,45,19,26,3.54
2020,CB2020,085,5,Staten Island,50291053005,279,147,132,12.97
2020,CB2020,085,5,Staten Island,50291053006,138,63,75,6.94
2020,CB2020,085,5,Staten Island,50291053007,325,180,145,11.41
2020,CB2020,085,5,Staten Island,50291053008,69,27,42,3.37
2020,CB2020,085,5,Staten Island,50291061000,116,45,71,3.64
2020,CB2020,085,5,Staten Island,50291061001,99,52,47,4.93
2020,CB2020,085,5,Staten Island,50291061002,118,48,70,4.92
2020,CB2020,085,5,Staten Island,50291061003,391,195,196,10.14
2020,CB2020,085,5,Staten Island,50291061004,107,45,62,2.87
2020,CB2020,085,5,Staten Island,50291061005,255,97,158,7.68
2020,CB2020,085,5,Staten Island,50291061006,130,80,50,4.19
2020,CB2020,085,5,Staten Island,50291061007,131,81,50,9.87
2020,CB2020,085,5,Staten Island,50291062000,253,93,160,10.31
2020,CB2020,085,5,Staten Island,50291062001,422,217,205,11.46
2020,CB2020,085,5,Staten Island,50291062002,266,117,149,8.01
2020,CB2020,085,5,Staten Island,50291062003,200,114,86,4.63
2020,CB2020,085,5,Staten Island,50291062004,236,124,112,5.65
2020,CB2020,085,5,Staten Island,50291062005,179,83,96,5.6
2020,CB2020,085,5,Staten Island,50291062006,244,124,120,5.88
2020,CB2020,085,5,Staten Island,50291062007,84,41,43,2.79
2020,CB2020,085,5,Staten Island,50291062008,0,0,0,3.1
2020,CB2020,085,5,Staten Island,50291062009,0,0,0,0.82
2020,CB2020,085,5,Staten Island,50303011000,192,105,87,4.12
2020,CB2020,085,5,Staten Island,50303011001,213,98,115,4.73
2020,CB2020,085,5,Staten Island,50303011002,262,129,133,5.49
2020,CB2020,085,5,Staten Island,50303011003,228,133,95,5.04
2020,CB2020,085,5,Staten Island,50303011004,244,127,117,5.73
2020,CB2020,085,5,Staten Island,50303011005,0,0,0,5.38
2020,CB2020,085,5,Staten Island,50303011006,0,0,0,11.74
2020,CB2020,085,5,Staten Island,50303011007,272,123,149,6.81
2020,CB2020,085,5,Staten Island,50303011008,162,73,89,2.79
2020,CB2020,085,5,Staten Island,50303011009,109,51,58,2.14
2020,CB2020,085,5,Staten Island,50303011010,510,235,275,10.44
2020,CB2020,085,5,Staten Island,50303011011,146,62,84,3.58
2020,CB2020,085,5,Staten Island,50303011012,179,76,103,4.71
2020,CB2020,085,5,Staten Island,50303011013,236,111,125,5.48
2020,CB2020,085,5,Staten Island,50303011014,357,179,178,6.52
2020,CB2020,085,5,Staten Island,50303012000,0,0,0,3.62
2020,CB2020,085,5,Staten Island,50303012001,0,0,0,6.56
2020,CB2020,085,5,Staten Island,50303012002,263,116,147,7.24
2020,CB2020,085,5,Staten Island,50303012003,97,31,66,3.01
2020,CB2020,085,5,Staten Island,50303012004,32,17,15,13.22
2020,CB2020,085,5,Staten Island,50303012005,377,192,185,11.3
2020,CB2020,085,5,Staten Island,50303012006,85,30,55,2.24
2020,CB2020,085,5,Staten Island,50303012007,112,51,61,1.91
2020,CB2020,085,5,Staten Island,50303012008,78,34,44,1.61
2020,CB2020,085,5,Staten Island,50303012009,69,41,28,1.66
2020,CB2020,085,5,Staten Island,50303012010,83,29,54,1.9
2020,CB2020,085,5,Staten Island,50303012011,0,0,0,2.13
2020,CB2020,085,5,Staten Island,50303012012,0,0,0,12.35
2020,CB2020,085,5,Staten Island,50303012013,92,33,59,3.18
2020,CB2020,085,5,Staten Island,50303012014,111,63,48,3.18
2020,CB2020,085,5,Staten Island,50303012015,98,55,43,2.95
2020,CB2020,085,5,Staten Island,50303012016,62,43,19,2.27
2020,CB2020,085,5,Staten Island,50303012017,116,79,37,3.23
2020,CB2020,085,5,Staten Island,50303012018,345,182,163,9.49
2020,CB2020,085,5,Staten Island,50303021000,44,10,34,10.8
2020,CB2020,085,5,Staten Island,50303021001,339,175,164,6.44
2020,CB2020,085,5,Staten Island,50303021002,190,99,91,2.19
2020,CB2020,085,5,Staten Island,50303021003,163,95,68,2.74
2020,CB2020,085,5,Staten Island,50303021004,395,201,194,7.23
2020,CB2020,085,5,Staten Island,50303021005,138,66,72,2.9
2020,CB2020,085,5,Staten Island,50303021006,134,88,46,2.29
2020,CB2020,085,5,Staten Island,50303021007,247,112,135,4.71
2020,CB2020,085,5,Staten Island,50303021008,294,133,161,4.96
2020,CB2020,085,5,Staten Island,50303022000,745,374,371,13.64
2020,CB2020,085,5,Staten Island,50303022001,543,299,244,10.3
2020,CB2020,085,5,Staten Island,50303022002,218,106,112,4.26
2020,CB2020,085,5,Staten Island,50303022003,316,144,172,7
2020,CB2020,085,5,Staten Island,50303022004,205,81,124,2.82
2020,CB2020,085,5,Staten Island,50303023000,21,12,9,5.59
2020,CB2020,085,5,Staten Island,50303023001,118,40,78,2.99
2020,CB2020,085,5,Staten Island,50303023002,99,51,48,8.87
2020,CB2020,085,5,Staten Island,50303023003,57,17,40,14.36
2020,CB2020,085,5,Staten Island,50303023004,47,26,21,0.75
2020,CB2020,085,5,Staten Island,50303023005,160,79,81,3.52
2020,CB2020,085,5,Staten Island,50303023006,146,77,69,3.67
2020,CB2020,085,5,Staten Island,50303023007,262,132,130,4.87
2020,CB2020,085,5,Staten Island,50303023008,191,113,78,2.9
2020,CB2020,085,5,Staten Island,50303023009,160,77,83,2.74
2020,CB2020,085,5,Staten Island,50303023010,105,47,58,2.46
2020,CB2020,085,5,Staten Island,50303023011,159,65,94,2.67
2020,CB2020,085,5,Staten Island,50303023012,141,87,54,2.65
2020,CB2020,085,5,Staten Island,50303023013,403,159,244,7.67
2020,CB2020,085,5,Staten Island,50303023014,49,31,18,0.76
2020,CB2020,085,5,Staten Island,50303023015,169,99,70,9.66
2020,CB2020,085,5,Staten Island,50303023016,59,16,43,1.31
2020,CB2020,085,5,Staten Island,50303023017,17,10,7,0.4
2020,CB2020,085,5,Staten Island,50303023018,43,15,28,1.27
2020,CB2020,085,5,Staten Island,50303023019,208,100,108,3.97
2020,CB2020,085,5,Staten Island,50303024000,65,38,27,37.37
2020,CB2020,085,5,Staten Island,50303024001,19,11,8,18.35
2020,CB2020,085,5,Staten Island,50303024002,0,0,0,3.48
2020,CB2020,085,5,Staten Island,50319011000,399,190,209,11.67
2020,CB2020,085,5,Staten Island,50319011001,921,354,567,13.01
2020,CB2020,085,5,Staten Island,50319011002,66,34,32,0.58
2020,CB2020,085,5,Staten Island,50319011003,42,30,12,0.65
2020,CB2020,085,5,Staten Island,50319011004,715,288,427,13.56
2020,CB2020,085,5,Staten Island,50319012000,260,133,127,8.95
2020,CB2020,085,5,Staten Island,50319012001,241,125,116,24.69
2020,CB2020,085,5,Staten Island,50319012002,126,76,50,3.28
2020,CB2020,085,5,Staten Island,50319012003,85,37,48,2.04
2020,CB2020,085,5,Staten Island,50319012004,70,32,38,3.15
2020,CB2020,085,5,Staten Island,50319012005,155,81,74,4.67
2020,CB2020,085,5,Staten Island,50319012006,11,2,9,4.55
2020,CB2020,085,5,Staten Island,50319012007,85,32,53,2.6
2020,CB2020,085,5,Staten Island,50319012008,86,27,59,2.48
2020,CB2020,085,5,Staten Island,50319020001,0,0,0,0
2020,CB2020,085,5,Staten Island,50319020002,0,0,0,0
2020,CB2020,085,5,Staten Island,50319021000,0,0,0,7.69
2020,CB2020,085,5,Staten Island,50319021001,415,180,235,4.93
2020,CB2020,085,5,Staten Island,50319021002,241,99,142,4.91
2020,CB2020,085,5,Staten Island,50319021003,236,113,123,7.19
2020,CB2020,085,5,Staten Island,50319021004,994,406,588,7.87
2020,CB2020,085,5,Staten Island,50319022000,0,0,0,11.97
2020,CB2020,085,5,Staten Island,50319022001,224,134,90,6.36
2020,CB2020,085,5,Staten Island,50319022002,523,237,286,14.11
2020,CB2020,085,5,Staten Island,50319022003,569,280,289,10.62
2020,CB2020,085,5,Staten Island,50319022004,44,17,27,0.42
2020,CB2020,085,5,Staten Island,50319022005,120,59,61,2.33
2020,CB2020,085,5,Staten Island,50319022006,179,75,104,4.9
2020,CB2020,085,5,Staten Island,50319022007,123,68,55,4.95
2020,CB2020,085,5,Staten Island,50319023000,0,0,0,25.21
2020,CB2020,085,5,Staten Island,50319023001,217,108,109,3.13
2020,CB2020,085,5,Staten Island,50319023002,260,123,137,6.5
2020,CB2020,085,5,Staten Island,50319023003,187,96,91,5.25
2020,CB2020,085,5,Staten Island,50319023004,327,165,162,19.34
2020,CB2020,085,5,Staten Island,50319023005,189,105,84,4.42
2020,CB2020,085,5,Staten Island,50319023006,180,78,102,3.44
2020,CB2020,085,5,Staten Island,50319023007,319,158,161,9.46
2020,CB2020,085,5,Staten Island,50319023008,153,102,51,5.63
2020,CB2020,085,5,Staten Island,50323000001,0,0,0,0
2020,CB2020,085,5,Staten Island,50323000002,0,0,0,0
2020,CB2020,085,5,Staten Island,50323000003,0,0,0,0
2020,CB2020,085,5,Staten Island,50323001000,0,0,0,103.86
2020,CB2020,085,5,Staten Island,50323001001,496,208,288,181.54
2020,CB2020,085,5,Staten Island,50323001002,180,93,87,2.71
2020,CB2020,085,5,Staten Island,50323001003,80,43,37,1.42
2020,CB2020,085,5,Staten Island,50323001004,7,3,4,108.51
2020,CB2020,085,5,Staten Island,50323001005,0,0,0,87.05
2020,CB2020,085,5,Staten Island,50323001006,0,0,0,23.12
2020,CB2020,085,5,Staten Island,50323001007,0,0,0,0
2020,CB2020,085,5,Staten Island,50323001008,0,0,0,8.38
2020,CB2020,085,5,Staten Island,50323001009,0,0,0,0.64
2020,CB2020,085,5,Staten Island,50323001010,0,0,0,1.52
2020,CB2020,085,5,Staten Island,50323001011,0,0,0,52.66
2020,CB2020,085,5,Staten Island,50323001012,0,0,0,15.58
2020,CB2020,085,5,Staten Island,50323001013,0,0,0,49.61
2020,CB2020,085,5,Staten Island,50323001014,79,36,43,6.85
2020,CB2020,085,5,Staten Island,50323001015,281,134,147,173.78
2020,CB2020,085,5,Staten Island,50323001016,34,26,8,11.93
2020,CB2020,085,5,Staten Island,50323001017,0,0,0,1.54
2020,CB2020,085,5,Staten Island,50323001018,32,19,13,3.48
2020,CB2020,085,5,Staten Island,50323001019,0,0,0,6.3
2020,CB2020,085,5,Staten Island,50323001020,0,0,0,2.58
2020,CB2020,085,5,Staten Island,50323001021,11,4,7,9.38
2020,CB2020,085,5,Staten Island,50323001022,33,15,18,74.93
2020,CB2020,085,5,Staten Island,50323001023,0,0,0,0.93
2020,CB2020,085,5,Staten Island,50323001024,0,0,0,1.64
2020,CB2020,085,5,Staten Island,50323001025,0,0,0,25.84
2020,CB2020,085,5,Staten Island,59901000001,0,0,0,0
2020,CB2020,085,5,Staten Island,59901000002,0,0,0,0
2020,CB2020,085,5,Staten Island,59901000003,0,0,0,0
2020,CB2020,085,5,Staten Island,59901000004,0,0,0,0
2020,CB2020,085,5,Staten Island,59901000005,0,0,0,0
2020,CB2020,085,5,Staten Island,59901000006,0,0,0,0
2020,CB2020,085,5,Staten Island,59901000007,0,0,0,0
2020,CB2020,085,5,Staten Island,59901000008,0,0,0,0
2020,CB2020,085,5,Staten Island,59901000009,0,0,0,0
2020,CB2020,085,5,Staten Island,59901000010,0,0,0,0
